WORD	FAVOR	AGAINST	NONE	FREQ	SUPPORT
底层	0	18	0	18	1.0
生存	0	16	0	16	1.0
单手	16	0	0	16	1.0
环保局	0	11	0	11	1.0
单手操作	10	0	0	10	1.0
从我做起	0	10	0	10	1.0
超女	0	0	9	9	1.0
美少女	0	0	9	9	1.0
时间表	0	0	9	9	1.0
无敌	0	0	9	9	1.0
红绿灯	8	0	0	8	1.0
红绿	8	0	0	8	1.0
正好	8	0	0	8	1.0
备	8	0	0	8	1.0
危害	0	8	0	8	1.0
节约	0	7	0	7	1.0
腐败	0	7	0	7	1.0
生就	0	7	0	7	1.0
婚假	0	7	0	7	1.0
大宝	7	0	0	7	1.0
口号	0	7	0	7	1.0
九件	7	0	0	7	1.0
中秋	7	0	0	7	1.0
解决问题	0	6	0	6	1.0
秋节	6	0	0	6	1.0
浓度	0	6	0	6	1.0
延迟	0	6	0	6	1.0
布	6	0	0	6	1.0
巫术	6	0	0	6	1.0
嫌弃	6	0	0	6	1.0
吉	6	0	0	6	1.0
刹车	6	0	0	6	1.0
公	6	0	0	6	1.0
儿时	6	0	0	6	1.0
人力	0	6	0	6	1.0
买车	0	6	0	6	1.0
中秋节	6	0	0	6	1.0
锅铲	0	0	5	5	1.0
逊尼派	0	5	0	5	1.0
逊尼	0	5	0	5	1.0
车尾	5	0	0	5	1.0
老伴	0	0	5	5	1.0
罗斯国	5	0	0	5	1.0
纳	5	0	0	5	1.0
端午节	5	0	0	5	1.0
端午	5	0	0	5	1.0
盼望	5	0	0	5	1.0
淡	5	0	0	5	1.0
汽车尾气	5	0	0	5	1.0
月饼	5	0	0	5	1.0
抢劫	0	5	0	5	1.0
情景	5	0	0	5	1.0
差点	5	0	0	5	1.0
屁用	0	5	0	5	1.0
安全事故	0	5	0	5	1.0
士兵	5	0	0	5	1.0
团圆饭	5	0	0	5	1.0
原始	0	5	0	5	1.0
俄罗斯国防部	5	0	0	5	1.0
乱窜	5	0	0	5	1.0
买得起	0	5	0	5	1.0
买得	0	5	0	5	1.0
下滑	0	5	0	5	1.0
青	4	0	0	4	1.0
霸道	0	4	0	4	1.0
长龙	4	0	0	4	1.0
锻炼	4	0	0	4	1.0
这部	4	0	0	4	1.0
超人	0	4	0	4	1.0
赡养	0	4	0	4	1.0
赖以生存	0	4	0	4	1.0
赖以	0	4	0	4	1.0
许子	0	0	4	4	1.0
觉	0	4	0	4	1.0
萝卜	4	0	0	4	1.0
莫斯科	4	0	0	4	1.0
胜	4	0	0	4	1.0
聊聊	0	0	4	4	1.0
老太	0	4	0	4	1.0
罗拉	0	0	4	4	1.0
组	0	4	0	4	1.0
纳税人	0	4	0	4	1.0
纯属	4	0	0	4	1.0
粮食	0	4	0	4	1.0
科夫	4	0	0	4	1.0
祭灶	4	0	0	4	1.0
祝贺	4	0	0	4	1.0
瞎	4	0	0	4	1.0
看上去	4	0	0	4	1.0
看上	4	0	0	4	1.0
白云	0	4	0	4	1.0
疏导	0	4	0	4	1.0
疏	0	4	0	4	1.0
申	4	0	0	4	1.0
济南市	0	4	0	4	1.0
污染物	0	4	0	4	1.0
民百	0	4	0	4	1.0
条例	0	4	0	4	1.0
杀人	0	4	0	4	1.0
有钱人	0	4	0	4	1.0
有害	0	4	0	4	1.0
最底层	0	4	0	4	1.0
普特	0	4	0	4	1.0
无人	4	0	0	4	1.0
放下	0	4	0	4	1.0
摩托罗拉	0	0	4	4	1.0
扰民	0	4	0	4	1.0
托罗	0	0	4	4	1.0
心想	4	0	0	4	1.0
循环	0	4	0	4	1.0
彼此	4	0	0	4	1.0
强调	4	0	0	4	1.0
开除	4	0	0	4	1.0
幕后	4	0	0	4	1.0
帽	4	0	0	4	1.0
屌丝	0	4	0	4	1.0
封杀	0	4	0	4	1.0
对内	0	4	0	4	1.0
实现	4	0	0	4	1.0
夫	0	4	0	4	1.0
太贵	0	4	0	4	1.0
太太	0	4	0	4	1.0
培训	4	0	0	4	1.0
城管	0	4	0	4	1.0
回老家	4	0	0	4	1.0
发扬	4	0	0	4	1.0
原始社会	0	4	0	4	1.0
压	0	4	0	4	1.0
南市	0	4	0	4	1.0
千多	0	4	0	4	1.0
十足	4	0	0	4	1.0
势必	0	4	0	4	1.0
到时候	0	4	0	4	1.0
充分	0	4	0	4	1.0
傻子	0	4	0	4	1.0
做饭	0	4	0	4	1.0
做点事	0	4	0	4	1.0
侨报	4	0	0	4	1.0
低收入	0	4	0	4	1.0
代管	0	4	0	4	1.0
五千	4	0	0	4	1.0
争论	0	0	4	4	1.0
买卖	0	4	0	4	1.0
乖	4	0	0	4	1.0
主力	0	4	0	4	1.0
中国式	0	4	0	4	1.0
专用	0	0	4	4	1.0
上涨	0	4	0	4	1.0
一面	4	0	0	4	1.0
一家亲	4	0	0	4	1.0
r46hp1p	0	0	4	4	1.0
鲜血	0	3	0	3	1.0
高价	0	3	0	3	1.0
香味	3	0	0	3	1.0
革命	0	3	0	3	1.0
雪上加霜	0	3	0	3	1.0
雪上	0	3	0	3	1.0
雨水	0	0	3	3	1.0
降	0	3	0	3	1.0
闻到	3	0	0	3	1.0
邪教	3	0	0	3	1.0
那里	0	3	0	3	1.0
遇上	0	3	0	3	1.0
通人	0	3	0	3	1.0
送给	3	0	0	3	1.0
迫不及待	3	0	0	3	1.0
迪拜	0	3	0	3	1.0
这部分	3	0	0	3	1.0
近来	0	0	3	3	1.0
运输	0	3	0	3	1.0
边境地区	0	3	0	3	1.0
辞旧迎新	3	0	0	3	1.0
输出	0	0	3	3	1.0
辆车	0	0	3	3	1.0
走过	3	0	0	3	1.0
走向	0	3	0	3	1.0
资金	0	0	3	3	1.0
谈判	0	3	0	3	1.0
调皮	3	0	0	3	1.0
说到底	0	3	0	3	1.0
蛋糕	0	0	3	3	1.0
蓝天白云	0	3	0	3	1.0
蓝	0	3	0	3	1.0
蒙蒙	0	3	0	3	1.0
著名	3	0	0	3	1.0
草泥马	0	3	0	3	1.0
茶	3	0	0	3	1.0
脚踏	3	0	0	3	1.0
联想	0	0	3	3	1.0
老祖宗	3	0	0	3	1.0
老祖	3	0	0	3	1.0
老太太	0	3	0	3	1.0
耀	3	0	0	3	1.0
美食	3	0	0	3	1.0
美德	3	0	0	3	1.0
罚钱	0	3	0	3	1.0
绝大	3	0	0	3	1.0
结扎	0	3	0	3	1.0
纸屑	0	3	0	3	1.0
粽子	3	0	0	3	1.0
第二次	0	0	3	3	1.0
穿行	3	0	0	3	1.0
科	3	0	0	3	1.0
种种	0	0	3	3	1.0
私人	0	3	0	3	1.0
神马	3	0	0	3	1.0
神奇	0	3	0	3	1.0
社会底层	0	3	0	3	1.0
社会关系	0	3	0	3	1.0
破坏	3	0	0	3	1.0
直闯	3	0	0	3	1.0
直至	3	0	0	3	1.0
直升机	0	3	0	3	1.0
直升	0	3	0	3	1.0
病人	0	3	0	3	1.0
疙瘩	3	0	0	3	1.0
生死	0	3	0	3	1.0
玩意儿	0	3	0	3	1.0
猛	3	0	0	3	1.0
独自	3	0	0	3	1.0
物价上涨	0	3	0	3	1.0
爱情	3	0	0	3	1.0
爆发	0	3	0	3	1.0
焦点	0	0	3	3	1.0
灰蒙蒙	0	3	0	3	1.0
火烧	3	0	0	3	1.0
满大街	3	0	0	3	1.0
消防安全	0	3	0	3	1.0
海外	3	0	0	3	1.0
洗衣服	0	3	0	3	1.0
洗衣	0	3	0	3	1.0
汤圆	3	0	0	3	1.0
氧化	0	3	0	3	1.0
气象	0	3	0	3	1.0
毫无疑问	0	3	0	3	1.0
毒瘤	0	3	0	3	1.0
毁灭	3	0	0	3	1.0
步伐	3	0	0	3	1.0
横冲直闯	3	0	0	3	1.0
榜样	0	3	0	3	1.0
楼房	0	3	0	3	1.0
格局	3	0	0	3	1.0
本土	0	0	3	3	1.0
朗德	3	0	0	3	1.0
有限	0	3	0	3	1.0
有权	0	3	0	3	1.0
有害物质	0	3	0	3	1.0
有害物	0	3	0	3	1.0
有名	0	3	0	3	1.0
普通人	0	3	0	3	1.0
时光	3	0	0	3	1.0
旧迎新	3	0	0	3	1.0
无耻	0	3	0	3	1.0
新文化	0	0	3	3	1.0
新文	0	0	3	3	1.0
敲锣	0	0	3	3	1.0
收费	0	3	0	3	1.0
收获	3	0	0	3	1.0
支出	0	3	0	3	1.0
撤	0	3	0	3	1.0
搂	3	0	0	3	1.0
拯救	0	3	0	3	1.0
抗议	0	3	0	3	1.0
扩大	3	0	0	3	1.0
手足	3	0	0	3	1.0
成效	0	3	0	3	1.0
戈尔	3	0	0	3	1.0
想干什么	0	3	0	3	1.0
惊	0	3	0	3	1.0
情结	0	3	0	3	1.0
恩	3	0	0	3	1.0
思路	0	3	0	3	1.0
快捷	0	3	0	3	1.0
待产	3	0	0	3	1.0
征求	0	0	3	3	1.0
当权	0	3	0	3	1.0
开火	3	0	0	3	1.0
建宇	3	0	0	3	1.0
度蜜月	0	3	0	3	1.0
废气	3	0	0	3	1.0
床	3	0	0	3	1.0
广告	0	3	0	3	1.0
平民百姓	0	3	0	3	1.0
干的事	3	0	0	3	1.0
干涉	3	0	0	3	1.0
帝都	0	3	0	3	1.0
局长	0	3	0	3	1.0
尚	0	0	3	3	1.0
小宝贝	3	0	0	3	1.0
导弹	0	3	0	3	1.0
家门口	0	3	0	3	1.0
家门	0	3	0	3	1.0
家族	3	0	0	3	1.0
害苦	0	3	0	3	1.0
害	0	3	0	3	1.0
客人	0	3	0	3	1.0
宁	0	3	0	3	1.0
孕期	3	0	0	3	1.0
嫁	0	3	0	3	1.0
姨妈	3	0	0	3	1.0
委员	0	3	0	3	1.0
妥协	0	3	0	3	1.0
妇科	3	0	0	3	1.0
如果说	0	3	0	3	1.0
如意	3	0	0	3	1.0
好几	3	0	0	3	1.0
大气污染	0	3	0	3	1.0
大批	0	0	3	3	1.0
外地人	0	3	0	3	1.0
夏天	3	0	0	3	1.0
备货	0	0	3	3	1.0
境地	0	3	0	3	1.0
堂	3	0	0	3	1.0
基层	0	3	0	3	1.0
坐等	3	0	0	3	1.0
地狱	0	3	0	3	1.0
固然	0	3	0	3	1.0
回国	3	0	0	3	1.0
四季	0	0	3	3	1.0
嗨	3	0	0	3	1.0
喷子	3	0	0	3	1.0
售	0	3	0	3	1.0
唠	3	0	0	3	1.0
哭声	3	0	0	3	1.0
吓死	3	0	0	3	1.0
后代	0	3	0	3	1.0
各自	0	3	0	3	1.0
发声	0	3	0	3	1.0
压迫	0	3	0	3	1.0
卫星	3	0	0	3	1.0
升机	0	3	0	3	1.0
北京市	0	0	3	3	1.0
勇气	0	3	0	3	1.0
加以	0	0	3	3	1.0
前面	3	0	0	3	1.0
初衷	3	0	0	3	1.0
出去玩	3	0	0	3	1.0
几点	3	0	0	3	1.0
凑个	3	0	0	3	1.0
况且	0	0	3	3	1.0
冯	3	0	0	3	1.0
军事行动	3	0	0	3	1.0
冒充	3	0	0	3	1.0
内政	3	0	0	3	1.0
共享	3	0	0	3	1.0
公斤	0	3	0	3	1.0
公主	3	0	0	3	1.0
全责	3	0	0	3	1.0
倡议书	0	3	0	3	1.0
便利	0	3	0	3	1.0
侵略战争	0	3	0	3	1.0
作业	0	0	3	3	1.0
体谅	0	0	3	3	1.0
低估	3	0	0	3	1.0
传统美德	3	0	0	3	1.0
优雅	3	0	0	3	1.0
伊戈尔	3	0	0	3	1.0
以人为本	0	3	0	3	1.0
亲属	3	0	0	3	1.0
亲友	3	0	0	3	1.0
京市	0	0	3	3	1.0
享有	0	3	0	3	1.0
产后	3	0	0	3	1.0
交流	0	3	0	3	1.0
五毛	0	3	0	3	1.0
五岁	3	0	0	3	1.0
五千年	3	0	0	3	1.0
二次	0	0	3	3	1.0
买房	0	3	0	3	1.0
乐趣	3	0	0	3	1.0
乐乐	0	3	0	3	1.0
主人	0	3	0	3	1.0
丹	3	0	0	3	1.0
中文	0	3	0	3	1.0
中国政府	0	3	0	3	1.0
不负责任	0	3	0	3	1.0
不负	0	3	0	3	1.0
不妨	3	0	0	3	1.0
不值	0	0	3	3	1.0
不便	0	3	0	3	1.0
三亚	0	3	0	3	1.0
万件	0	3	0	3	1.0
一年一度	3	0	0	3	1.0
一劳永逸	0	3	0	3	1.0
xx	0	3	0	3	1.0
mini	0	0	3	3	1.0
ls	3	0	0	3	1.0
ip6	0	3	0	3	1.0
bb	3	0	0	3	1.0
龙舟	2	0	0	2	1.0
黔驴技穷	0	2	0	2	1.0
黔驴	0	2	0	2	1.0
黑白	2	0	0	2	1.0
鲜	0	0	2	2	1.0
魔	2	0	0	2	1.0
高高	0	2	0	2	1.0
高速	0	2	0	2	1.0
高血压	2	0	0	2	1.0
高手	2	0	0	2	1.0
高峰期	2	0	0	2	1.0
高层	0	2	0	2	1.0
高价位	0	2	0	2	1.0
骨	0	2	0	2	1.0
骚	0	0	2	2	1.0
骗钱	0	2	0	2	1.0
骑行	0	2	0	2	1.0
骂声	0	2	0	2	1.0
驾驶证	2	0	0	2	1.0
驼	2	0	0	2	1.0
饮食	0	2	0	2	1.0
饭碗	0	2	0	2	1.0
食	0	2	0	2	1.0
飞速	2	0	0	2	1.0
风情	2	0	0	2	1.0
颠倒黑白	2	0	0	2	1.0
颠倒	2	0	0	2	1.0
颗粒物	0	2	0	2	1.0
颇	2	0	0	2	1.0
预报	0	2	0	2	1.0
颁布	2	0	0	2	1.0
顺眼	2	0	0	2	1.0
顺手	2	0	0	2	1.0
顺	2	0	0	2	1.0
顶部	0	2	0	2	1.0
靠拢	0	2	0	2	1.0
霸占	2	0	0	2	1.0
霉运	2	0	0	2	1.0
霉	2	0	0	2	1.0
震	0	2	0	2	1.0
零零	2	0	0	2	1.0
零点	2	0	0	2	1.0
雅	0	0	2	2	1.0
难说	0	2	0	2	1.0
难忘	2	0	0	2	1.0
陕西	0	2	0	2	1.0
阿勒颇	2	0	0	2	1.0
阿勒	2	0	0	2	1.0
阻碍	2	0	0	2	1.0
阶层	0	2	0	2	1.0
阵风	2	0	0	2	1.0
阴影	0	2	0	2	1.0
阳	0	2	0	2	1.0
防御	2	0	0	2	1.0
闹心	0	2	0	2	1.0
问卷	0	0	2	2	1.0
闪烁	0	2	0	2	1.0
门店	0	2	0	2	1.0
长年	0	0	2	2	1.0
销售额	0	0	2	2	1.0
铁血	2	0	0	2	1.0
钢筋水泥	0	2	0	2	1.0
钢筋	0	2	0	2	1.0
金属	2	0	0	2	1.0
重拳	2	0	0	2	1.0
重担	0	2	0	2	1.0
酿成	2	0	0	2	1.0
酒肉	0	2	0	2	1.0
部份	0	2	0	2	1.0
郑渊洁	0	2	0	2	1.0
郑	0	0	2	2	1.0
那时	0	2	0	2	1.0
那天	2	0	0	2	1.0
遗传	0	2	0	2	1.0
逼死	0	2	0	2	1.0
逛	0	0	2	2	1.0
通行	0	0	2	2	1.0
通病	0	2	0	2	1.0
途	2	0	0	2	1.0
逐步	0	2	0	2	1.0
透露	0	0	2	2	1.0
适宜	0	2	0	2	1.0
送货	0	0	2	2	1.0
退回	0	2	0	2	1.0
追杀	0	2	0	2	1.0
迷你	0	2	0	2	1.0
迫切需要	0	2	0	2	1.0
连绵不断	2	0	0	2	1.0
连绵	2	0	0	2	1.0
违背	0	0	2	2	1.0
违	2	0	0	2	1.0
进产房	2	0	0	2	1.0
这边	2	0	0	2	1.0
这么久	2	0	0	2	1.0
近几年	0	2	0	2	1.0
运河	2	0	0	2	1.0
迎面	2	0	0	2	1.0
迎春	2	0	0	2	1.0
迈	0	2	0	2	1.0
过渡	0	2	0	2	1.0
过来人	0	2	0	2	1.0
辞退	0	0	2	2	1.0
辞	2	0	0	2	1.0
辛勤	0	2	0	2	1.0
较大	0	0	2	2	1.0
载重	0	0	2	2	1.0
软	2	0	0	2	1.0
转悠	2	0	0	2	1.0
转型	2	0	0	2	1.0
车长	0	0	2	2	1.0
车子	0	2	0	2	1.0
身为	2	0	0	2	1.0
踏板	2	0	0	2	1.0
践行	0	2	0	2	1.0
跳槽	0	2	0	2	1.0
路途	2	0	0	2	1.0
路线	0	0	2	2	1.0
路有冻死骨	0	2	0	2	1.0
路子	0	2	0	2	1.0
跟随	0	0	2	2	1.0
跟前	2	0	0	2	1.0
跑步	2	0	0	2	1.0
越过	2	0	0	2	1.0
起眼	0	0	2	2	1.0
起义	0	2	0	2	1.0
赶来	2	0	0	2	1.0
走霉运	2	0	0	2	1.0
走走停停	2	0	0	2	1.0
走上	0	2	0	2	1.0
赤	0	2	0	2	1.0
赌	0	2	0	2	1.0
赋予	0	2	0	2	1.0
资金来源	0	0	2	2	1.0
资产	2	0	0	2	1.0
费时费力	0	2	0	2	1.0
费时	0	2	0	2	1.0
费力	0	2	0	2	1.0
贴心	2	0	0	2	1.0
贩卖	2	0	0	2	1.0
货车	0	2	0	2	1.0
责人	0	2	0	2	1.0
财运	2	0	0	2	1.0
负责人	0	2	0	2	1.0
象	0	2	0	2	1.0
谴责	0	2	0	2	1.0
谨慎	0	2	0	2	1.0
调侃	0	2	0	2	1.0
说说话	2	0	0	2	1.0
说好听	0	2	0	2	1.0
话费	0	0	2	2	1.0
话说回来	0	2	0	2	1.0
试想	0	2	0	2	1.0
评判	2	0	0	2	1.0
评价	2	0	0	2	1.0
证据	0	2	0	2	1.0
证书	0	0	2	2	1.0
论证	0	2	0	2	1.0
议论	0	0	2	2	1.0
训练	2	0	0	2	1.0
讨生活	0	2	0	2	1.0
计委	0	0	2	2	1.0
警报	0	0	2	2	1.0
触犯	0	2	0	2	1.0
规避	0	2	0	2	1.0
规范化	2	0	0	2	1.0
要紧	2	0	0	2	1.0
要命	0	2	0	2	1.0
西班牙	2	0	0	2	1.0
西斯	0	2	0	2	1.0
襄阳	2	0	0	2	1.0
表姐	0	0	2	2	1.0
行货	0	2	0	2	1.0
行径	0	2	0	2	1.0
行不通	2	0	0	2	1.0
血脉相连	2	0	0	2	1.0
血脉	2	0	0	2	1.0
血压	2	0	0	2	1.0
蠢	2	0	0	2	1.0
蜗居	2	0	0	2	1.0
蛾子	0	2	0	2	1.0
虚荣	0	2	0	2	1.0
蕾	2	0	0	2	1.0
蔑视	0	2	0	2	1.0
蓄电池	0	0	2	2	1.0
蓄电	0	0	2	2	1.0
蓄意	2	0	0	2	1.0
葵	0	2	0	2	1.0
落实	0	2	0	2	1.0
落地	0	0	2	2	1.0
落到	0	2	0	2	1.0
营养	2	0	0	2	1.0
莫过于	0	0	2	2	1.0
莫过	0	0	2	2	1.0
莫名	2	0	0	2	1.0
药味	0	2	0	2	1.0
荔	0	0	2	2	1.0
茜	0	0	2	2	1.0
范化	2	0	0	2	1.0
英勇	2	0	0	2	1.0
花费	0	2	0	2	1.0
花生	2	0	0	2	1.0
花灯	0	0	2	2	1.0
节食	0	2	0	2	1.0
节约粮食	0	2	0	2	1.0
节约用电	0	2	0	2	1.0
节约用水	0	2	0	2	1.0
节省	0	2	0	2	1.0
舆情	0	0	2	2	1.0
致敬	2	0	0	2	1.0
臭	0	2	0	2	1.0
自有	2	0	0	2	1.0
自家	2	0	0	2	1.0
自取	0	2	0	2	1.0
脱身	0	2	0	2	1.0
脚踏板	2	0	0	2	1.0
脐带	0	0	2	2	1.0
能比	2	0	0	2	1.0
胡同	2	0	0	2	1.0
胆	0	2	0	2	1.0
肥	2	0	0	2	1.0
聚众	0	0	2	2	1.0
联手	2	0	0	2	1.0
耳光	0	2	0	2	1.0
考虑一下	0	0	2	2	1.0
老金	0	2	0	2	1.0
老老实实	0	0	2	2	1.0
老老	0	0	2	2	1.0
老王	2	0	0	2	1.0
老爷	0	2	0	2	1.0
老人家	0	2	0	2	1.0
翻译	2	0	0	2	1.0
羔羊	0	2	0	2	1.0
美金	0	2	0	2	1.0
美感	2	0	0	2	1.0
美味	2	0	0	2	1.0
罗刹	0	0	2	2	1.0
网开一面	2	0	0	2	1.0
缩衣节食	0	2	0	2	1.0
缩小	0	2	0	2	1.0
缤纷	2	0	0	2	1.0
编队	2	0	0	2	1.0
编制	2	0	0	2	1.0
续	0	2	0	2	1.0
继承	2	0	0	2	1.0
绝望	0	2	0	2	1.0
绝大部分	2	0	0	2	1.0
绘	2	0	0	2	1.0
结果显示	2	0	0	2	1.0
结构	2	0	0	2	1.0
绑架	0	2	0	2	1.0
绑	0	2	0	2	1.0
经济特区	0	2	0	2	1.0
组成部分	2	0	0	2	1.0
纸条	0	2	0	2	1.0
纯粹	2	0	0	2	1.0
纪念	0	2	0	2	1.0
红星	0	2	0	2	1.0
繁衍	0	2	0	2	1.0
繁星	0	2	0	2	1.0
繁华	2	0	0	2	1.0
紧	0	2	0	2	1.0
糖尿病	2	0	0	2	1.0
糖尿	2	0	0	2	1.0
精致	2	0	0	2	1.0
粗	0	0	2	2	1.0
类型	0	0	2	2	1.0
篇	2	0	0	2	1.0
箩	0	2	0	2	1.0
管理水平	0	2	0	2	1.0
管理手段	0	2	0	2	1.0
管制	0	2	0	2	1.0
简单化	0	2	0	2	1.0
签证	0	2	0	2	1.0
答应	0	0	2	2	1.0
等一等	2	0	0	2	1.0
第四季度	0	0	2	2	1.0
第四季	0	0	2	2	1.0
笔者	0	0	2	2	1.0
笑话	2	0	0	2	1.0
竹头	2	0	0	2	1.0
章	2	0	0	2	1.0
窦文涛	0	0	2	2	1.0
空白	2	0	0	2	1.0
稿	0	0	2	2	1.0
稻	0	2	0	2	1.0
税收	0	2	0	2	1.0
稍稍	0	0	2	2	1.0
稍	2	0	0	2	1.0
稀饭	2	0	0	2	1.0
移交	2	0	0	2	1.0
称快	0	0	2	2	1.0
积极参与	0	2	0	2	1.0
秦皇岛	2	0	0	2	1.0
秦皇	2	0	0	2	1.0
租车	0	2	0	2	1.0
科技园	2	0	0	2	1.0
私自	2	0	0	2	1.0
禾	0	0	2	2	1.0
祸及	2	0	0	2	1.0
祸	2	0	0	2	1.0
祭拜	2	0	0	2	1.0
社工	0	2	0	2	1.0
礼让	2	0	0	2	1.0
礼拜	0	0	2	2	1.0
礼	2	0	0	2	1.0
确有此事	0	0	2	2	1.0
确有	0	0	2	2	1.0
硬逼	0	2	0	2	1.0
硬汉	0	2	0	2	1.0
硬伤	0	2	0	2	1.0
硝烟弥漫	0	0	2	2	1.0
硝烟	0	0	2	2	1.0
砸烂	0	2	0	2	1.0
短缺	2	0	0	2	1.0
知足	2	0	0	2	1.0
知名人士	0	2	0	2	1.0
着手	0	0	2	2	1.0
眼镜	2	0	0	2	1.0
眼球	0	0	2	2	1.0
眼中钉	2	0	0	2	1.0
真他妈	2	0	0	2	1.0
真主党	0	2	0	2	1.0
真不错	2	0	0	2	1.0
看重	2	0	0	2	1.0
看管	0	2	0	2	1.0
看样子	0	2	0	2	1.0
看样	0	2	0	2	1.0
盼望着	2	0	0	2	1.0
相连	2	0	0	2	1.0
相聚	2	0	0	2	1.0
相爱	2	0	0	2	1.0
直言	0	2	0	2	1.0
直行	2	0	0	2	1.0
目前为止	2	0	0	2	1.0
盖戳	2	0	0	2	1.0
监测站	0	0	2	2	1.0
皇恩浩荡	2	0	0	2	1.0
皇恩	2	0	0	2	1.0
癸巳	2	0	0	2	1.0
病狂	0	2	0	2	1.0
画	2	0	0	2	1.0
男权	0	2	0	2	1.0
男女平等	0	2	0	2	1.0
男同胞	0	0	2	2	1.0
电量	2	0	0	2	1.0
用途	2	0	0	2	1.0
用水	0	2	0	2	1.0
用人	0	2	0	2	1.0
生辉	0	2	0	2	1.0
生态环境	0	2	0	2	1.0
生动	2	0	0	2	1.0
生儿	2	0	0	2	1.0
生人	0	0	2	2	1.0
生产厂家	0	2	0	2	1.0
生产厂	0	2	0	2	1.0
甚者	2	0	0	2	1.0
瓦	2	0	0	2	1.0
瑞雪	2	0	0	2	1.0
理事长	0	2	0	2	1.0
王爷	2	0	0	2	1.0
猪油	0	2	0	2	1.0
狭窄	2	0	0	2	1.0
独苗	0	2	0	2	1.0
犯法	0	2	0	2	1.0
特勒	0	2	0	2	1.0
物资	2	0	0	2	1.0
物流	2	0	0	2	1.0
物品	0	2	0	2	1.0
物力	0	2	0	2	1.0
物业	0	2	0	2	1.0
牡	2	0	0	2	1.0
爽快	2	0	0	2	1.0
爆料	0	0	2	2	1.0
燕窝	2	0	0	2	1.0
燃烧	0	2	0	2	1.0
熠熠生辉	0	2	0	2	1.0
熠熠	0	2	0	2	1.0
煽动	2	0	0	2	1.0
烦人	2	0	0	2	1.0
烤	2	0	0	2	1.0
点心	2	0	0	2	1.0
灶王爷	2	0	0	2	1.0
灯	2	0	0	2	1.0
灭族	2	0	0	2	1.0
火险	0	2	0	2	1.0
火药味	0	2	0	2	1.0
火星	0	0	2	2	1.0
激增	0	2	0	2	1.0
澄清	2	0	0	2	1.0
演唱	2	0	0	2	1.0
滨江	2	0	0	2	1.0
满怀	2	0	0	2	1.0
滋味	0	0	2	2	1.0
游玩	2	0	0	2	1.0
渴望	2	0	0	2	1.0
清洁	0	2	0	2	1.0
清晰	2	0	0	2	1.0
混蛋	2	0	0	2	1.0
混战	0	2	0	2	1.0
深夜	2	0	0	2	1.0
涨工资	2	0	0	2	1.0
消极	0	2	0	2	1.0
消停	0	2	0	2	1.0
海底	2	0	0	2	1.0
浪费资源	0	2	0	2	1.0
浩荡	2	0	0	2	1.0
浓郁	0	2	0	2	1.0
测站	0	0	2	2	1.0
流产	2	0	0	2	1.0
派送	0	2	0	2	1.0
活路	0	2	0	2	1.0
活跃	0	0	2	2	1.0
洗洗	0	2	0	2	1.0
洁净	0	2	0	2	1.0
注意力	2	0	0	2	1.0
注入	0	2	0	2	1.0
波澜	0	0	2	2	1.0
波及	0	0	2	2	1.0
法西斯	0	2	0	2	1.0
法西	0	2	0	2	1.0
法定	0	2	0	2	1.0
法人	0	2	0	2	1.0
沿袭	2	0	0	2	1.0
沾	0	0	2	2	1.0
治标不治本	0	2	0	2	1.0
治本	0	2	0	2	1.0
治安	0	2	0	2	1.0
没有勇气	0	2	0	2	1.0
没意思	2	0	0	2	1.0
没完	2	0	0	2	1.0
没吃过	0	2	0	2	1.0
没动静	0	2	0	2	1.0
没动	0	2	0	2	1.0
沙井	0	0	2	2	1.0
沉默	0	2	0	2	1.0
沈	0	0	2	2	1.0
水军	2	0	0	2	1.0
氧化硫	0	2	0	2	1.0
气象条件	0	2	0	2	1.0
气象台	0	2	0	2	1.0
气温	0	2	0	2	1.0
气压计	0	2	0	2	1.0
气压	0	2	0	2	1.0
气体	0	2	0	2	1.0
民选总统	2	0	0	2	1.0
民选	2	0	0	2	1.0
民心	0	2	0	2	1.0
民主联盟	0	0	2	2	1.0
毛病	0	2	0	2	1.0
毙	2	0	0	2	1.0
毒	2	0	0	2	1.0
每天晚上	2	0	0	2	1.0
母	0	2	0	2	1.0
残酷	0	0	2	2	1.0
残忍	0	2	0	2	1.0
殊不知	2	0	0	2	1.0
歼击机	2	0	0	2	1.0
歼击	2	0	0	2	1.0
死哦	0	2	0	2	1.0
武术	2	0	0	2	1.0
此前	0	0	2	2	1.0
正如	2	0	0	2	1.0
正名	0	2	0	2	1.0
歌会	0	0	2	2	1.0
欧美	2	0	0	2	1.0
欢聚	2	0	0	2	1.0
欢欢乐乐	0	2	0	2	1.0
欢欢	0	2	0	2	1.0
欢庆	2	0	0	2	1.0
欢	2	0	0	2	1.0
欠缺	0	2	0	2	1.0
楼道	0	2	0	2	1.0
楼下	0	2	0	2	1.0
森林	0	2	0	2	1.0
棍子	0	2	0	2	1.0
棉花	0	0	2	2	1.0
梅林	2	0	0	2	1.0
桂林	0	2	0	2	1.0
根结	0	0	2	2	1.0
根性	0	2	0	2	1.0
树立	0	2	0	2	1.0
查出	2	0	0	2	1.0
某国	0	2	0	2	1.0
极度	0	2	0	2	1.0
极了	0	2	0	2	1.0
板车	0	0	2	2	1.0
板凳	2	0	0	2	1.0
条款	0	2	0	2	1.0
杆	0	2	0	2	1.0
权贵	0	2	0	2	1.0
杀伤性	0	2	0	2	1.0
杀人放火	0	2	0	2	1.0
机制	0	2	0	2	1.0
朱门酒肉臭	0	2	0	2	1.0
朱门	0	2	0	2	1.0
本月	0	0	2	2	1.0
本报	0	2	0	2	1.0
本市	0	2	0	2	1.0
未免	0	2	0	2	1.0
服务行业	0	2	0	2	1.0
有限公司	0	2	0	2	1.0
有理有节	2	0	0	2	1.0
有毒	0	2	0	2	1.0
有此	0	0	2	2	1.0
有声	2	0	0	2	1.0
最最	0	2	0	2	1.0
最新款	0	0	2	2	1.0
最出色	2	0	0	2	1.0
曹	2	0	0	2	1.0
更有甚者	2	0	0	2	1.0
更何况	2	0	0	2	1.0
普通百姓	0	2	0	2	1.0
晚年	0	2	0	2	1.0
显现	0	0	2	2	1.0
是非题	0	0	2	2	1.0
昨天晚上	0	0	2	2	1.0
明知	0	2	0	2	1.0
明目张胆	2	0	0	2	1.0
明目	2	0	0	2	1.0
明日	0	0	2	2	1.0
时分	0	0	2	2	1.0
时事	2	0	0	2	1.0
日记	2	0	0	2	1.0
日照	0	2	0	2	1.0
既有	0	0	2	2	1.0
无视	0	2	0	2	1.0
无感	0	2	0	2	1.0
无声	2	0	0	2	1.0
旗鼓相当	0	2	0	2	1.0
旗鼓	0	2	0	2	1.0
族人	0	2	0	2	1.0
旋律	2	0	0	2	1.0
旅途	2	0	0	2	1.0
方方	2	0	0	2	1.0
新高	0	0	2	2	1.0
新闻网	2	0	0	2	1.0
新生儿	2	0	0	2	1.0
新潮	0	0	2	2	1.0
新兴	0	0	2	2	1.0
斌	2	0	0	2	1.0
文明办	0	2	0	2	1.0
敲锣打鼓	0	0	2	2	1.0
敲诈	2	0	0	2	1.0
教徒	0	2	0	2	1.0
救援	0	2	0	2	1.0
效应	0	0	2	2	1.0
政策法规	0	2	0	2	1.0
政局	0	0	2	2	1.0
放爆竹	0	2	0	2	1.0
攻略	2	0	0	2	1.0
攻	2	0	0	2	1.0
改用	0	2	0	2	1.0
改名字	0	2	0	2	1.0
改名	0	2	0	2	1.0
收藏	0	2	0	2	1.0
收入者	0	2	0	2	1.0
播出	0	0	2	2	1.0
撩	2	0	0	2	1.0
撂	0	2	0	2	1.0
摔倒	0	2	0	2	1.0
摆摊	0	2	0	2	1.0
携	2	0	0	2	1.0
搜救	2	0	0	2	1.0
揪心	2	0	0	2	1.0
提到	0	2	0	2	1.0
提价	0	2	0	2	1.0
推波助澜	0	2	0	2	1.0
推手	2	0	0	2	1.0
推卸	0	2	0	2	1.0
接着	2	0	0	2	1.0
排除	0	0	2	2	1.0
掏出	0	0	2	2	1.0
据调查	0	0	2	2	1.0
换新	2	0	0	2	1.0
换位	0	2	0	2	1.0
捕鲸	0	2	0	2	1.0
捋	0	2	0	2	1.0
振振有词	2	0	0	2	1.0
振振	2	0	0	2	1.0
挥手	0	0	2	2	1.0
挥之不去	0	2	0	2	1.0
拿出	2	0	0	2	1.0
拿不出	0	2	0	2	1.0
拜拜	2	0	0	2	1.0
拓展	0	0	2	2	1.0
拐卖	0	2	0	2	1.0
拍手称快	0	0	2	2	1.0
拍卖	0	2	0	2	1.0
拉登	2	0	0	2	1.0
拉升	0	2	0	2	1.0
担惊受怕	0	2	0	2	1.0
担惊	0	2	0	2	1.0
抽奖	0	2	0	2	1.0
抹黑	2	0	0	2	1.0
抵抗	2	0	0	2	1.0
披露	2	0	0	2	1.0
报仇	2	0	0	2	1.0
护航	2	0	0	2	1.0
投靠	0	0	2	2	1.0
投资者	0	0	2	2	1.0
抓狂	0	2	0	2	1.0
技穷	0	2	0	2	1.0
扶植	0	2	0	2	1.0
扯	0	2	0	2	1.0
扩展	0	2	0	2	1.0
执法人员	0	2	0	2	1.0
执政	0	2	0	2	1.0
打鼓	0	0	2	2	1.0
打气	0	2	0	2	1.0
打架	2	0	0	2	1.0
打工	0	2	0	2	1.0
打头	2	0	0	2	1.0
打嘴仗	0	2	0	2	1.0
打嘴	0	2	0	2	1.0
打劫	0	2	0	2	1.0
打下	0	2	0	2	1.0
手机卡	0	0	2	2	1.0
手指	0	0	2	2	1.0
手持	2	0	0	2	1.0
所说	2	0	0	2	1.0
所在	2	0	0	2	1.0
户口	0	2	0	2	1.0
或是	0	2	0	2	1.0
我心	2	0	0	2	1.0
成本增加	0	2	0	2	1.0
成就感	2	0	0	2	1.0
成就	2	0	0	2	1.0
成功率	2	0	0	2	1.0
成分	2	0	0	2	1.0
成倍	0	2	0	2	1.0
戍	2	0	0	2	1.0
慈悲	0	2	0	2	1.0
感恩	2	0	0	2	1.0
感叹	0	0	2	2	1.0
愁	2	0	0	2	1.0
惹不起	0	2	0	2	1.0
想当初	0	2	0	2	1.0
惰	0	2	0	2	1.0
惊受	0	2	0	2	1.0
情节	2	0	0	2	1.0
情形	0	0	2	2	1.0
悟空	2	0	0	2	1.0
悄然	2	0	0	2	1.0
悄无声息	2	0	0	2	1.0
恩怨	0	2	0	2	1.0
恢复	0	2	0	2	1.0
恒定	0	0	2	2	1.0
总会	2	0	0	2	1.0
怨不得	2	0	0	2	1.0
性别比	0	0	2	2	1.0
怠惰	0	2	0	2	1.0
思	0	2	0	2	1.0
念头	0	2	0	2	1.0
快车道	2	0	0	2	1.0
快车	2	0	0	2	1.0
忘记	0	2	0	2	1.0
志愿军	0	2	0	2	1.0
必须品	0	2	0	2	1.0
心酸	0	2	0	2	1.0
心跳	2	0	0	2	1.0
心病	0	2	0	2	1.0
心态	0	2	0	2	1.0
心形	0	0	2	2	1.0
心向往之	0	2	0	2	1.0
心向	0	2	0	2	1.0
循环往复	0	2	0	2	1.0
很难说	0	2	0	2	1.0
待转	2	0	0	2	1.0
征求意见	0	0	2	2	1.0
往常	0	0	2	2	1.0
往复	0	2	0	2	1.0
彻底改变	0	0	2	2	1.0
形态	2	0	0	2	1.0
形势严峻	0	2	0	2	1.0
当权者	0	2	0	2	1.0
当头	2	0	0	2	1.0
归根结底	0	0	2	2	1.0
归根	0	0	2	2	1.0
归于	0	2	0	2	1.0
归	0	2	0	2	1.0
强奸	0	2	0	2	1.0
弱者	0	2	0	2	1.0
弱小	0	2	0	2	1.0
弱国	0	0	2	2	1.0
弥补	2	0	0	2	1.0
弥漫着	0	2	0	2	1.0
引诱	0	0	2	2	1.0
开封	0	0	2	2	1.0
开学	2	0	0	2	1.0
座	0	2	0	2	1.0
废除	0	2	0	2	1.0
废话	2	0	0	2	1.0
庞大	0	2	0	2	1.0
店里	2	0	0	2	1.0
应聘	0	0	2	2	1.0
幸福感	0	2	0	2	1.0
幸好	2	0	0	2	1.0
年底	2	0	0	2	1.0
平静	2	0	0	2	1.0
平民化	2	0	0	2	1.0
平台	0	0	2	2	1.0
干吗	2	0	0	2	1.0
常见	2	0	0	2	1.0
常常	2	0	0	2	1.0
带领	2	0	0	2	1.0
带回家	2	0	0	2	1.0
带回	2	0	0	2	1.0
希特勒	0	2	0	2	1.0
希特	0	2	0	2	1.0
币	0	2	0	2	1.0
巿	0	2	0	2	1.0
巴萨	0	2	0	2	1.0
已是	2	0	0	2	1.0
巨	2	0	0	2	1.0
左边	0	2	0	2	1.0
工作量	0	2	0	2	1.0
工作思路	0	2	0	2	1.0
崩盘	0	2	0	2	1.0
崩	2	0	0	2	1.0
崛起	0	2	0	2	1.0
崇拜	0	2	0	2	1.0
层出不穷	0	2	0	2	1.0
屁眼	0	2	0	2	1.0
尽可能	2	0	0	2	1.0
尽可	2	0	0	2	1.0
尼	2	0	0	2	1.0
尸体	2	0	0	2	1.0
就业率	0	2	0	2	1.0
尘	2	0	0	2	1.0
少将	2	0	0	2	1.0
小龄童	2	0	0	2	1.0
小萝卜	2	0	0	2	1.0
小汽车	0	2	0	2	1.0
小巧	2	0	0	2	1.0
小女	2	0	0	2	1.0
小事	0	2	0	2	1.0
导演	2	0	0	2	1.0
导向	0	2	0	2	1.0
对着干	0	2	0	2	1.0
对着	0	2	0	2	1.0
富阳市	0	2	0	2	1.0
富阳	0	2	0	2	1.0
富强	0	2	0	2	1.0
容量	0	0	2	2	1.0
家园	0	2	0	2	1.0
宴请	2	0	0	2	1.0
室内外	0	2	0	2	1.0
室内	0	2	0	2	1.0
宣	0	0	2	2	1.0
客服	0	2	0	2	1.0
宠	2	0	0	2	1.0
实用	0	2	0	2	1.0
实战	2	0	0	2	1.0
实惠	0	2	0	2	1.0
宜昌市	0	2	0	2	1.0
定律	0	0	2	2	1.0
宗教界	0	2	0	2	1.0
宗	2	0	0	2	1.0
安详	0	2	0	2	1.0
安置	2	0	0	2	1.0
安慰	2	0	0	2	1.0
安全隐患	0	2	0	2	1.0
守规矩	2	0	0	2	1.0
守恒定律	0	0	2	2	1.0
守恒	0	0	2	2	1.0
宁可	0	2	0	2	1.0
学者	2	0	0	2	1.0
学业	2	0	0	2	1.0
字眼	0	2	0	2	1.0
字母	0	2	0	2	1.0
字样	0	0	2	2	1.0
子孙后代	0	2	0	2	1.0
婚礼	0	2	0	2	1.0
婚后	0	2	0	2	1.0
婚前	0	2	0	2	1.0
婊	2	0	0	2	1.0
娃娃	2	0	0	2	1.0
姓	0	2	0	2	1.0
妥	0	0	2	2	1.0
妇人	0	0	2	2	1.0
如今已是	2	0	0	2	1.0
好感	2	0	0	2	1.0
好奇	2	0	0	2	1.0
好几年	2	0	0	2	1.0
好事者	0	0	2	2	1.0
好久没	2	0	0	2	1.0
奶	2	0	0	2	1.0
女性朋友	2	0	0	2	1.0
女同事	2	0	0	2	1.0
女友	2	0	0	2	1.0
奥斯曼帝国	2	0	0	2	1.0
奥斯曼	2	0	0	2	1.0
奔	2	0	0	2	1.0
夹缝	0	2	0	2	1.0
夸	2	0	0	2	1.0
头等大事	2	0	0	2	1.0
头等	2	0	0	2	1.0
太小	0	2	0	2	1.0
天朝	2	0	0	2	1.0
天价	0	2	0	2	1.0
天下太平	0	2	0	2	1.0
大选	0	2	0	2	1.0
大连市	0	2	0	2	1.0
大视野	2	0	0	2	1.0
大气环境	0	2	0	2	1.0
大户	2	0	0	2	1.0
大悟	2	0	0	2	1.0
大年夜	0	2	0	2	1.0
大局	2	0	0	2	1.0
大家伙	0	2	0	2	1.0
大姨妈	2	0	0	2	1.0
大姨	2	0	0	2	1.0
大奖	2	0	0	2	1.0
大半	0	2	0	2	1.0
大力提倡	0	2	0	2	1.0
大使馆	2	0	0	2	1.0
夜晚	2	0	0	2	1.0
多着呢	2	0	0	2	1.0
多着	2	0	0	2	1.0
多方	2	0	0	2	1.0
多亏	2	0	0	2	1.0
外表	2	0	0	2	1.0
外籍	2	0	0	2	1.0
处置	0	2	0	2	1.0
声息	2	0	0	2	1.0
壮大	0	2	0	2	1.0
壮	0	2	0	2	1.0
境界	0	2	0	2	1.0
堵车	0	2	0	2	1.0
堵截	0	2	0	2	1.0
基数	0	2	0	2	1.0
城管局	0	2	0	2	1.0
坦率	2	0	0	2	1.0
坦	2	0	0	2	1.0
坚守岗位	2	0	0	2	1.0
坐下	2	0	0	2	1.0
坏蛋	2	0	0	2	1.0
坏处	2	0	0	2	1.0
坊	2	0	0	2	1.0
均匀	0	0	2	2	1.0
地痞	0	2	0	2	1.0
在我看来	2	0	0	2	1.0
在意	0	2	0	2	1.0
在内	0	0	2	2	1.0
土方	2	0	0	2	1.0
图片库	2	0	0	2	1.0
国民	0	2	0	2	1.0
国欢庆	2	0	0	2	1.0
国庆节	2	0	0	2	1.0
国庆	2	0	0	2	1.0
固	2	0	0	2	1.0
囧	2	0	0	2	1.0
回复	0	0	2	2	1.0
四辆	0	2	0	2	1.0
四类	2	0	0	2	1.0
四年	0	2	0	2	1.0
四季度	0	0	2	2	1.0
四处	2	0	0	2	1.0
四十多	0	0	2	2	1.0
四六	2	0	0	2	1.0
噎	0	2	0	2	1.0
嘲笑	2	0	0	2	1.0
嘉宾	0	0	2	2	1.0
喷出	2	0	0	2	1.0
喉	0	2	0	2	1.0
啊啊啊	2	0	0	2	1.0
唱歌	2	0	0	2	1.0
唠嗑	2	0	0	2	1.0
哪有什么	2	0	0	2	1.0
哪一条	0	2	0	2	1.0
哟	2	0	0	2	1.0
哈哈哈哈	2	0	0	2	1.0
品味	2	0	0	2	1.0
哀	0	2	0	2	1.0
咩	2	0	0	2	1.0
咎由自取	0	2	0	2	1.0
和蔼	2	0	0	2	1.0
呼吸道	0	2	0	2	1.0
味十足	2	0	0	2	1.0
周岁	0	0	2	2	1.0
周一	0	0	2	2	1.0
呦	2	0	0	2	1.0
呀呀	2	0	0	2	1.0
吵闹	0	2	0	2	1.0
否定	2	0	0	2	1.0
君子	0	2	0	2	1.0
向往	0	2	0	2	1.0
后面	2	0	0	2	1.0
后背	0	0	2	2	1.0
名人	0	2	0	2	1.0
同房	0	0	2	2	1.0
同归于尽	0	2	0	2	1.0
同归	0	2	0	2	1.0
同学聚会	2	0	0	2	1.0
同伙	2	0	0	2	1.0
吉利	0	2	0	2	1.0
合法性	0	0	2	2	1.0
合格证	0	2	0	2	1.0
各项政策	0	0	2	2	1.0
各项	0	0	2	2	1.0
各路	0	0	2	2	1.0
各类	2	0	0	2	1.0
各族人民	0	2	0	2	1.0
各族	0	2	0	2	1.0
司法	0	2	0	2	1.0
叫做	0	2	0	2	1.0
只管	0	0	2	2	1.0
只不过	0	2	0	2	1.0
古	2	0	0	2	1.0
口中	0	2	0	2	1.0
叙利亚人	0	0	2	2	1.0
变奏	0	2	0	2	1.0
受益	0	2	0	2	1.0
受损	0	2	0	2	1.0
发送	0	0	2	2	1.0
发回	2	0	0	2	1.0
反问	2	0	0	2	1.0
反过来	0	2	0	2	1.0
反过	0	2	0	2	1.0
反腐	0	2	0	2	1.0
反华	2	0	0	2	1.0
反动派	2	0	0	2	1.0
反动	2	0	0	2	1.0
双语	2	0	0	2	1.0
又称	2	0	0	2	1.0
去向	0	2	0	2	1.0
原生	0	2	0	2	1.0
压感	0	2	0	2	1.0
压制	0	2	0	2	1.0
卫	0	0	2	2	1.0
卡片	0	0	2	2	1.0
卖钱	0	2	0	2	1.0
卖点	0	0	2	2	1.0
协会	0	2	0	2	1.0
华夏	2	0	0	2	1.0
半月	2	0	0	2	1.0
半岁	2	0	0	2	1.0
半天	0	2	0	2	1.0
午饭	2	0	0	2	1.0
千门	2	0	0	2	1.0
千多年	0	2	0	2	1.0
千块	2	0	0	2	1.0
十几岁	0	2	0	2	1.0
区内	0	2	0	2	1.0
北方	2	0	0	2	1.0
化硫	0	2	0	2	1.0
化工厂	2	0	0	2	1.0
化工	2	0	0	2	1.0
勾结	2	0	0	2	1.0
励志	2	0	0	2	1.0
助	2	0	0	2	1.0
动物园	2	0	0	2	1.0
劣根性	0	2	0	2	1.0
劣根	0	2	0	2	1.0
加盟	0	0	2	2	1.0
功利	2	0	0	2	1.0
剧情	0	2	0	2	1.0
剖宫产	2	0	0	2	1.0
前景	0	0	2	2	1.0
前为	2	0	0	2	1.0
刺	0	2	0	2	1.0
制定者	0	2	0	2	1.0
到场	2	0	0	2	1.0
到位	0	2	0	2	1.0
刮风	0	2	0	2	1.0
刮	2	0	0	2	1.0
利亚人	0	0	2	2	1.0
初四	0	2	0	2	1.0
刊	0	0	2	2	1.0
分配	0	0	2	2	1.0
分离	2	0	0	2	1.0
分数	0	2	0	2	1.0
分娩	0	0	2	2	1.0
刀具	0	2	0	2	1.0
出资	0	2	0	2	1.0
出货量	0	0	2	2	1.0
出租车	0	2	0	2	1.0
出租	0	2	0	2	1.0
出炉	0	0	2	2	1.0
出游	0	2	0	2	1.0
出国	0	2	0	2	1.0
出厂	0	2	0	2	1.0
凸显	0	2	0	2	1.0
凸出	2	0	0	2	1.0
几起	2	0	0	2	1.0
几日	0	2	0	2	1.0
几岁	0	2	0	2	1.0
减负	0	2	0	2	1.0
减排	0	2	0	2	1.0
凌驾	0	2	0	2	1.0
净化	0	2	0	2	1.0
冻死	0	2	0	2	1.0
冷空气	0	2	0	2	1.0
冷汗	0	0	2	2	1.0
决策者	0	2	0	2	1.0
决	0	2	0	2	1.0
冤冤相报	0	2	0	2	1.0
再见	0	2	0	2	1.0
再者	0	2	0	2	1.0
内人	0	0	2	2	1.0
养老金	0	2	0	2	1.0
养成	0	2	0	2	1.0
养家	0	2	0	2	1.0
兴奋	2	0	0	2	1.0
关机	0	0	2	2	1.0
关掉	0	2	0	2	1.0
共度	0	2	0	2	1.0
共产	0	2	0	2	1.0
兰州	0	2	0	2	1.0
六小龄童	2	0	0	2	1.0
六小	2	0	0	2	1.0
公鸡	0	2	0	2	1.0
公民自由	0	2	0	2	1.0
公共场所	2	0	0	2	1.0
八成	0	2	0	2	1.0
八个	2	0	0	2	1.0
全职	0	2	0	2	1.0
全局	2	0	0	2	1.0
全力	0	2	0	2	1.0
兔	2	0	0	2	1.0
光靠	0	2	0	2	1.0
光芒	0	2	0	2	1.0
光标	0	2	0	2	1.0
先行	0	2	0	2	1.0
先是	0	2	0	2	1.0
先人	0	2	0	2	1.0
像样	0	2	0	2	1.0
催促	0	2	0	2	1.0
停工	2	0	0	2	1.0
停停	2	0	0	2	1.0
做工	2	0	0	2	1.0
假设	0	2	0	2	1.0
值不值	0	0	2	2	1.0
借用	0	2	0	2	1.0
倒霉	0	2	0	2	1.0
倍增	0	2	0	2	1.0
信誉	0	2	0	2	1.0
保姆	0	2	0	2	1.0
保健	2	0	0	2	1.0
俄联邦	2	0	0	2	1.0
俄国人	0	2	0	2	1.0
供暖	2	0	0	2	1.0
供	2	0	0	2	1.0
使馆	2	0	0	2	1.0
作梗	2	0	0	2	1.0
作文	2	0	0	2	1.0
余件	0	2	0	2	1.0
何用	0	2	0	2	1.0
何处	0	0	2	2	1.0
何乐而不为	0	2	0	2	1.0
体积	2	0	0	2	1.0
住宅	0	2	0	2	1.0
低能	0	2	0	2	1.0
低收入者	0	2	0	2	1.0
低头	0	0	2	2	1.0
传到	0	0	2	2	1.0
传下来	2	0	0	2	1.0
传下	2	0	0	2	1.0
众多	0	0	2	2	1.0
伐	0	2	0	2	1.0
仲	2	0	0	2	1.0
以色列	2	0	0	2	1.0
以至于	0	0	2	2	1.0
以至	0	0	2	2	1.0
以旧换新	2	0	0	2	1.0
从而	0	2	0	2	1.0
从前	2	0	0	2	1.0
从今	0	2	0	2	1.0
从中作梗	2	0	0	2	1.0
从不	2	0	0	2	1.0
什叶派	0	2	0	2	1.0
什叶	0	2	0	2	1.0
人道主义	0	2	0	2	1.0
人贩	0	2	0	2	1.0
人性化	0	2	0	2	1.0
人均	0	2	0	2	1.0
人口基数	0	2	0	2	1.0
亲眼	2	0	0	2	1.0
亮眼	0	0	2	2	1.0
产房	2	0	0	2	1.0
交际	2	0	0	2	1.0
交通拥堵	0	2	0	2	1.0
亡国	0	2	0	2	1.0
亡	0	2	0	2	1.0
五百	0	2	0	2	1.0
二百万	0	2	0	2	1.0
二百	0	2	0	2	1.0
二氧化硫	0	2	0	2	1.0
二氧化	0	2	0	2	1.0
二氧	0	2	0	2	1.0
事端	2	0	0	2	1.0
事理	2	0	0	2	1.0
事物	0	0	2	2	1.0
事务	2	0	0	2	1.0
书香	2	0	0	2	1.0
乡里	2	0	0	2	1.0
乡下	2	0	0	2	1.0
也罢	0	2	0	2	1.0
九零	0	2	0	2	1.0
九点	0	2	0	2	1.0
九年	0	2	0	2	1.0
之三	0	2	0	2	1.0
义愤填膺	0	0	2	2	1.0
义愤	0	0	2	2	1.0
举手	0	2	0	2	1.0
举国欢庆	2	0	0	2	1.0
举国	2	0	0	2	1.0
丽	2	0	0	2	1.0
主页	0	2	0	2	1.0
主演	2	0	0	2	1.0
主因	0	2	0	2	1.0
主力军	0	2	0	2	1.0
为民	0	2	0	2	1.0
为止	2	0	0	2	1.0
为政	0	2	0	2	1.0
为所欲为	0	2	0	2	1.0
为主	0	2	0	2	1.0
丰年	2	0	0	2	1.0
中文网	0	2	0	2	1.0
中学生	0	2	0	2	1.0
中央气象台	0	2	0	2	1.0
中低收入者	0	2	0	2	1.0
中低收入	0	2	0	2	1.0
中不溜	0	2	0	2	1.0
丫	2	0	0	2	1.0
丧心病狂	0	2	0	2	1.0
丧心	0	2	0	2	1.0
严寒	0	2	0	2	1.0
两胎	2	0	0	2	1.0
两百多	0	2	0	2	1.0
两百	0	2	0	2	1.0
两样	0	2	0	2	1.0
两张	2	0	0	2	1.0
两地	2	0	0	2	1.0
两千多年	0	2	0	2	1.0
两千多	0	2	0	2	1.0
东边	0	2	0	2	1.0
东征	2	0	0	2	1.0
业内人士	0	0	2	2	1.0
业主	0	0	2	2	1.0
丙申	2	0	0	2	1.0
世人	2	0	0	2	1.0
专制	0	2	0	2	1.0
不觉	2	0	0	2	1.0
不要命	0	2	0	2	1.0
不胜	0	2	0	2	1.0
不知不觉	2	0	0	2	1.0
不灵	0	0	2	2	1.0
不满	2	0	0	2	1.0
不治	0	2	0	2	1.0
不折不扣	2	0	0	2	1.0
不折	2	0	0	2	1.0
不惜	2	0	0	2	1.0
不得而知	0	0	2	2	1.0
不尽	2	0	0	2	1.0
不宜	0	2	0	2	1.0
不在乎	0	2	0	2	1.0
不光	0	2	0	2	1.0
不争	0	2	0	2	1.0
不乐	0	0	2	2	1.0
不为	0	2	0	2	1.0
不一	2	0	0	2	1.0
下课	2	0	0	2	1.0
下期	0	0	2	2	1.0
下学	0	2	0	2	1.0
下子	2	0	0	2	1.0
上架	0	0	2	2	1.0
上来	0	0	2	2	1.0
上报	0	0	2	2	1.0
上房	2	0	0	2	1.0
上当	2	0	0	2	1.0
上岗	0	2	0	2	1.0
上下学	0	2	0	2	1.0
三百年	0	2	0	2	1.0
三岁	2	0	0	2	1.0
三千多	0	2	0	2	1.0
三十多	2	0	0	2	1.0
三分钟	0	0	2	2	1.0
万平方公里	0	2	0	2	1.0
万平方	0	2	0	2	1.0
万台	0	0	2	2	1.0
万千	0	2	0	2	1.0
万余件	0	2	0	2	1.0
万余	0	2	0	2	1.0
万万	0	2	0	2	1.0
七个	2	0	0	2	1.0
七	0	2	0	2	1.0
丁	0	0	2	2	1.0
一等	2	0	0	2	1.0
一滴	0	2	0	2	1.0
一棍子打死	0	2	0	2	1.0
一棍子	0	2	0	2	1.0
一早	0	2	0	2	1.0
一支	0	2	0	2	1.0
一抹	0	2	0	2	1.0
一小	0	2	0	2	1.0
一大批	0	0	2	2	1.0
一出	0	2	0	2	1.0
一体	0	2	0	2	1.0
一伙	2	0	0	2	1.0
you	0	0	2	2	1.0
vivo	2	0	0	2	1.0
very	2	0	0	2	1.0
uniq	2	0	0	2	1.0
touchid	0	0	2	2	1.0
spring	2	0	0	2	1.0
show	2	0	0	2	1.0
sb	0	2	0	2	1.0
rbc	0	0	2	2	1.0
qq	2	0	0	2	1.0
pk	2	0	0	2	1.0
no	0	2	0	2	1.0
nice	2	0	0	2	1.0
new	0	2	0	2	1.0
my	0	0	2	2	1.0
mm	0	2	0	2	1.0
mason	2	0	0	2	1.0
markets	0	0	2	2	1.0
localytics	0	0	2	2	1.0
la	2	0	0	2	1.0
kg	0	0	2	2	1.0
ft	0	2	0	2	1.0
capital	0	0	2	2	1.0
龟	0	1	0	1	1.0
龚	1	0	0	1	1.0
龙潭	0	1	0	1	1.0
龙岩	1	0	0	1	1.0
龙岗区	0	1	0	1	1.0
龙头老大	0	1	0	1	1.0
龙头	0	1	0	1	1.0
龙城	0	0	1	1	1.0
龙凤胎	0	1	0	1	1.0
龙凤	0	1	0	1	1.0
龄	0	0	1	1	1.0
齐鲁	0	1	0	1	1.0
齐心	0	1	0	1	1.0
齐家	1	0	0	1	1.0
鼻黏膜	0	1	0	1	1.0
鼻屎	0	1	0	1	1.0
鼓起勇气	0	1	0	1	1.0
鼓起	0	1	0	1	1.0
鼓掌	1	0	0	1	1.0
鼓吹	0	1	0	1	1.0
鼓劲	0	1	0	1	1.0
鼓动	0	0	1	1	1.0
鼓	0	0	1	1	1.0
鼎力支持	1	0	0	1	1.0
鼎力	1	0	0	1	1.0
鼎	1	0	0	1	1.0
默默地	1	0	0	1	1.0
默念	0	0	1	1	1.0
默哀	0	0	1	1	1.0
黑风	1	0	0	1	1.0
黑车	0	0	1	1	1.0
黑诊所	0	0	1	1	1.0
黑裙	1	0	0	1	1.0
黑色	1	0	0	1	1.0
黑脸	0	1	0	1	1.0
黑粉	1	0	0	1	1.0
黑皮	1	0	0	1	1.0
黑猫	0	1	0	1	1.0
黑点	0	1	0	1	1.0
黑海地区	0	0	1	1	1.0
黑海	0	0	1	1	1.0
黑子	0	1	0	1	1.0
黑地	0	1	0	1	1.0
黑哨	1	0	0	1	1.0
黏膜	0	1	0	1	1.0
黏	0	1	0	1	1.0
黎民百姓	0	1	0	1	1.0
黎民	0	1	0	1	1.0
黎巴嫩真主党	0	1	0	1	1.0
黄色	0	0	1	1	1.0
黄粱美梦	1	0	0	1	1.0
黄粱	1	0	0	1	1.0
黄牛	1	0	0	1	1.0
黄灯	0	0	1	1	1.0
黄河	0	0	1	1	1.0
黄先生	0	1	0	1	1.0
麻辣烫	1	0	0	1	1.0
麻辣	1	0	0	1	1.0
麻花	1	0	0	1	1.0
麻	1	0	0	1	1.0
麦田	0	0	1	1	1.0
鹿死谁手	0	1	0	1	1.0
鹏城	0	1	0	1	1.0
鸽子	0	1	0	1	1.0
鸽	1	0	0	1	1.0
鸦片	0	1	0	1	1.0
鸣笛	1	0	0	1	1.0
鸡鸭	1	0	0	1	1.0
鸡鸡	1	0	0	1	1.0
鸡血	0	0	1	1	1.0
鸡肉	1	0	0	1	1.0
鸡皮疙瘩	1	0	0	1	1.0
鸡皮	1	0	0	1	1.0
鸡毛	0	1	0	1	1.0
鸡巴	0	0	1	1	1.0
鸟语花香	1	0	0	1	1.0
鸟语	1	0	0	1	1.0
鲹	1	0	0	1	1.0
鲸	0	1	0	1	1.0
鲜肉	0	0	1	1	1.0
鲍	1	0	0	1	1.0
鲁迅	0	1	0	1	1.0
鲁	0	1	0	1	1.0
鱼肉	0	1	0	1	1.0
鱼死网破	0	1	0	1	1.0
魔掌	0	1	0	1	1.0
魔力	1	0	0	1	1.0
魏	0	0	1	1	1.0
魅	0	0	1	1	1.0
魁祸	1	0	0	1	1.0
鬼子	0	1	0	1	1.0
高高在上	0	1	0	1	1.0
高高兴兴	0	1	0	1	1.0
高领	0	0	1	1	1.0
高音	0	1	0	1	1.0
高速公路	0	1	0	1	1.0
高跷	1	0	0	1	1.0
高贵	0	1	0	1	1.0
高薪	0	1	0	1	1.0
高级别	1	0	0	1	1.0
高级	1	0	0	1	1.0
高程	1	0	0	1	1.0
高点	1	0	0	1	1.0
高潮	1	0	0	1	1.0
高楼	0	0	1	1	1.0
高校	1	0	0	1	1.0
高架桥	1	0	0	1	1.0
高明	1	0	0	1	1.0
高攀	1	0	0	1	1.0
高招	0	1	0	1	1.0
高房价	0	1	0	1	1.0
高性能	1	0	0	1	1.0
高性	1	0	0	1	1.0
高强度	1	0	0	1	1.0
高强	1	0	0	1	1.0
高度评价	1	0	0	1	1.0
高干	0	1	0	1	1.0
高层人士	0	1	0	1	1.0
高官	0	1	0	1	1.0
高回报	1	0	0	1	1.0
高原	1	0	0	1	1.0
高像素	1	0	0	1	1.0
高傲	0	0	1	1	1.0
高低	0	1	0	1	1.0
高中毕业	0	1	0	1	1.0
高三	0	1	0	1	1.0
骨干	1	0	0	1	1.0
骨子里	0	1	0	1	1.0
骨子	0	1	0	1	1.0
骟	0	1	0	1	1.0
骚扰	0	1	0	1	1.0
骗骗	0	1	0	1	1.0
骗局	0	1	0	1	1.0
骗取	0	0	1	1	1.0
骗人	0	0	1	1	1.0
骑马	0	1	0	1	1.0
骑车去	0	0	1	1	1.0
骑车人	0	0	1	1	1.0
骑单车	1	0	0	1	1.0
验货	0	0	1	1	1.0
验证码	0	0	1	1	1.0
验	1	0	0	1	1.0
骆驼	1	0	0	1	1.0
骄傲	1	0	0	1	1.0
骄	1	0	0	1	1.0
骂街	0	1	0	1	1.0
骂名	0	1	0	1	1.0
骂人	1	0	0	1	1.0
骁	0	1	0	1	1.0
驾驶者	0	0	1	1	1.0
驾驭	0	1	0	1	1.0
驾校	0	1	0	1	1.0
驾到	1	0	0	1	1.0
驾乘	0	1	0	1	1.0
驻华大使	1	0	0	1	1.0
驻华	1	0	0	1	1.0
驻	0	1	0	1	1.0
驶	0	1	0	1	1.0
驴	0	1	0	1	1.0
驱逐舰	0	1	0	1	1.0
驱赶	1	0	0	1	1.0
驱散	0	1	0	1	1.0
驱动	0	0	1	1	1.0
驱	0	1	0	1	1.0
马马虎虎	1	0	0	1	1.0
马鞍山	1	0	0	1	1.0
马鞍	1	0	0	1	1.0
马车	0	0	1	1	1.0
马蜂窝	1	0	0	1	1.0
马蜂	1	0	0	1	1.0
马虎	1	0	0	1	1.0
马拉雅	0	1	0	1	1.0
马拉	0	1	0	1	1.0
马勒	0	1	0	1	1.0
香炉	0	0	1	1	1.0
香港	0	0	1	1	1.0
首领	0	0	1	1	1.0
首都	0	0	1	1	1.0
首部	0	1	0	1	1.0
首批	0	1	0	1	1.0
首当其冲	0	0	1	1	1.0
首当	0	0	1	1	1.0
首度	1	0	0	1	1.0
首届	0	1	0	1	1.0
首尔	0	1	0	1	1.0
首富	1	0	0	1	1.0
馒头	1	0	0	1	1.0
馋	0	1	0	1	1.0
馆	1	0	0	1	1.0
饽饽	1	0	0	1	1.0
饼干	0	0	1	1	1.0
饶有兴趣	1	0	0	1	1.0
饶有	1	0	0	1	1.0
饲	0	1	0	1	1.0
饱满	1	0	0	1	1.0
饱和	1	0	0	1	1.0
饮鸩止渴	0	1	0	1	1.0
饮店	0	1	0	1	1.0
饭馆	0	1	0	1	1.0
饭局	1	0	0	1	1.0
饭后	1	0	0	1	1.0
饭前	0	1	0	1	1.0
餐饮店	0	1	0	1	1.0
餐厅	0	0	1	1	1.0
食药监	0	1	0	1	1.0
食品药品	0	1	0	1	1.0
食品安全	0	1	0	1	1.0
飞龙	0	0	1	1	1.0
飞过	0	1	0	1	1.0
飞车	1	0	0	1	1.0
飞弹	1	0	0	1	1.0
飞入	0	1	0	1	1.0
飚	1	0	0	1	1.0
飙车	1	0	0	1	1.0
飘荡	1	0	0	1	1.0
飘	1	0	0	1	1.0
风风火火	1	0	0	1	1.0
风风	1	0	0	1	1.0
风靡	0	0	1	1	1.0
风雨	0	0	1	1	1.0
风生水	0	1	0	1	1.0
风火	1	0	0	1	1.0
风流人物	0	0	1	1	1.0
风流	0	0	1	1	1.0
风波	0	0	1	1	1.0
风池穴	0	0	1	1	1.0
风池	0	0	1	1	1.0
风水	1	0	0	1	1.0
风气	0	0	1	1	1.0
风格	0	1	0	1	1.0
风暴	0	1	0	1	1.0
风景	0	1	0	1	1.0
风度	1	0	0	1	1.0
风向标	1	0	0	1	1.0
风向	1	0	0	1	1.0
风口浪尖	0	1	0	1	1.0
风口	0	1	0	1	1.0
风俗习惯	0	0	1	1	1.0
风不	0	0	1	1	1.0
颠复	0	1	0	1	1.0
颠	0	1	0	1	1.0
额度	1	0	0	1	1.0
额定	0	0	1	1	1.0
额头	0	0	1	1	1.0
颜面	0	1	0	1	1.0
题材	0	0	1	1	1.0
颗粒状	0	0	1	1	1.0
频道	0	1	0	1	1.0
频	0	0	1	1	1.0
颍	0	0	1	1	1.0
颇为	0	1	0	1	1.0
领证	0	1	0	1	1.0
领袖	0	0	1	1	1.0
领略	0	0	1	1	1.0
领悟到	1	0	0	1	1.0
领导班子	0	1	0	1	1.0
领头羊	1	0	0	1	1.0
领头	1	0	0	1	1.0
领地	1	0	0	1	1.0
领土问题	0	1	0	1	1.0
领到	1	0	0	1	1.0
预言	1	0	0	1	1.0
预算	1	0	0	1	1.0
预祝	1	0	0	1	1.0
预期	0	0	1	1	1.0
预料	0	1	0	1	1.0
预告片	1	0	0	1	1.0
预告	1	0	0	1	1.0
颂歌	1	0	0	1	1.0
颁奖	1	0	0	1	1.0
颁发	1	0	0	1	1.0
颁	1	0	0	1	1.0
顾客	1	0	0	1	1.0
顾不得	1	0	0	1	1.0
顽皮	1	0	0	1	1.0
顺路	1	0	0	1	1.0
顺畅	0	0	1	1	1.0
顺心	0	1	0	1	1.0
顺带	0	1	0	1	1.0
顺口	0	0	1	1	1.0
项庄舞剑	1	0	0	1	1.0
项庄	1	0	0	1	1.0
顶层	0	0	1	1	1.0
页面	0	1	0	1	1.0
页	0	1	0	1	1.0
音频	0	1	0	1	1.0
音量	0	0	1	1	1.0
音符	1	0	0	1	1.0
音标	0	1	0	1	1.0
鞭炮厂	1	0	0	1	1.0
鞭挞	0	1	0	1	1.0
鞠躬	0	1	0	1	1.0
鞑靼	0	1	0	1	1.0
鞍山	1	0	0	1	1.0
靴子	0	0	1	1	1.0
革新	0	1	0	1	1.0
革命性	0	1	0	1	1.0
革	0	1	0	1	1.0
面饼	1	0	0	1	1.0
面部	1	0	0	1	1.0
面粉	0	0	1	1	1.0
面皮	1	0	0	1	1.0
面板	0	0	1	1	1.0
面孔	1	0	0	1	1.0
面具	1	0	0	1	1.0
靠着	0	0	1	1	1.0
非驴非马	0	1	0	1	1.0
非议	0	0	1	1	1.0
非标	1	0	0	1	1.0
非常规	0	1	0	1	1.0
非常热心	1	0	0	1	1.0
非常感谢	1	0	0	1	1.0
非凡	1	0	0	1	1.0
非但	1	0	0	1	1.0
非人	1	0	0	1	1.0
静观其变	0	0	1	1	1.0
静观	0	0	1	1	1.0
静悄悄	1	0	0	1	1.0
静下来	0	0	1	1	1.0
静下	0	0	1	1	1.0
靖	0	1	0	1	1.0
青龙满族自治县	1	0	0	1	1.0
青龙	1	0	0	1	1.0
青青	1	0	0	1	1.0
青海	0	1	0	1	1.0
青年报	0	0	1	1	1.0
青少年	1	0	0	1	1.0
青少	1	0	0	1	1.0
青壮年	0	1	0	1	1.0
青光眼	1	0	0	1	1.0
青光	1	0	0	1	1.0
霹雳	0	1	0	1	1.0
霸权主义	1	0	0	1	1.0
霸	1	0	0	1	1.0
露露脸	1	0	0	1	1.0
露露	1	0	0	1	1.0
露脸	1	0	0	1	1.0
霞	1	0	0	1	1.0
霉气	1	0	0	1	1.0
霉变	0	1	0	1	1.0
霄	1	0	0	1	1.0
需谨慎	0	1	0	1	1.0
需用	0	1	0	1	1.0
需求量	1	0	0	1	1.0
雾霭	0	0	1	1	1.0
雷霆	0	1	0	1	1.0
雷达	0	1	0	1	1.0
雷	1	0	0	1	1.0
零星	1	0	0	1	1.0
零头	1	0	0	1	1.0
零售点	0	0	1	1	1.0
雪天	1	0	0	1	1.0
雪城	0	0	1	1	1.0
雪兆丰年	1	0	0	1	1.0
雪儿	1	0	0	1	1.0
雨雪	0	1	0	1	1.0
雨棚	1	0	0	1	1.0
雨天	0	1	0	1	1.0
雌	0	1	0	1	1.0
雇员	1	0	0	1	1.0
雇	0	1	0	1	1.0
集束	0	0	1	1	1.0
集权	0	0	1	1	1.0
集市	0	1	0	1	1.0
集中营	0	1	0	1	1.0
集	0	0	1	1	1.0
雄	0	0	1	1	1.0
难闻	0	1	0	1	1.0
难道真	1	0	0	1	1.0
难逃	0	1	0	1	1.0
难辨	0	1	0	1	1.0
难言之隐	0	1	0	1	1.0
难言	0	1	0	1	1.0
难看	1	0	0	1	1.0
难熬	0	0	1	1	1.0
难度	0	1	0	1	1.0
难寻	1	0	0	1	1.0
难容	1	0	0	1	1.0
难堪	0	1	0	1	1.0
难听	1	0	0	1	1.0
难保	1	0	0	1	1.0
难以想象	0	1	0	1	1.0
难上加难	0	1	0	1	1.0
隔岸观火	1	0	0	1	1.0
隔岸	1	0	0	1	1.0
隐藏	1	0	0	1	1.0
隐瞒	0	1	0	1	1.0
随风而去	1	0	0	1	1.0
随风	1	0	0	1	1.0
随身带	0	1	0	1	1.0
随身	0	1	0	1	1.0
随机	0	0	1	1	1.0
随地吐痰	0	0	1	1	1.0
随地	0	0	1	1	1.0
随口	0	0	1	1	1.0
随	1	0	0	1	1.0
隋代	0	0	1	1	1.0
隆美尔	1	0	0	1	1.0
陷进	0	1	0	1	1.0
陵区	0	1	0	1	1.0
陪衬	0	0	1	1	1.0
陪葬	0	1	0	1	1.0
险象环生	1	0	0	1	1.0
险象	1	0	0	1	1.0
除邪	1	0	0	1	1.0
除此之外	0	0	1	1	1.0
除此	0	0	1	1	1.0
除尘	1	0	0	1	1.0
除名	0	1	0	1	1.0
院长	1	0	0	1	1.0
院里	0	1	0	1	1.0
院	1	0	0	1	1.0
陕西省	0	1	0	1	1.0
限量版	1	0	0	1	1.0
限性	0	0	1	1	1.0
限价	0	1	0	1	1.0
限于	0	0	1	1	1.0
降频	0	1	0	1	1.0
降雪	0	0	1	1	1.0
降温	0	1	0	1	1.0
降服	1	0	0	1	1.0
降到	0	1	0	1	1.0
陌生人	0	0	1	1	1.0
陈腐	1	0	0	1	1.0
陆战队	0	1	0	1	1.0
陆战	0	1	0	1	1.0
附带	1	0	0	1	1.0
附属国	0	1	0	1	1.0
附	0	1	0	1	1.0
阿里巴巴	1	0	0	1	1.0
阿里	1	0	0	1	1.0
阿米	1	0	0	1	1.0
阿弥陀佛	0	0	1	1	1.0
阿弥陀	0	0	1	1	1.0
阿富汉	0	0	1	1	1.0
阿土	1	0	0	1	1.0
阿嚏	1	0	0	1	1.0
阻止不了	0	1	0	1	1.0
阻力	0	1	0	1	1.0
阶梯	1	0	0	1	1.0
阵子	1	0	0	1	1.0
阵地	1	0	0	1	1.0
阵势	1	0	0	1	1.0
阴阴的	1	0	0	1	1.0
阴阴	1	0	0	1	1.0
阴历	1	0	0	1	1.0
阳阳	1	0	0	1	1.0
阳神	0	1	0	1	1.0
阳朔	0	1	0	1	1.0
防老	1	0	0	1	1.0
防盗	0	0	1	1	1.0
防护性	0	0	1	1	1.0
队长	0	1	0	1	1.0
队	1	0	0	1	1.0
阜阳	0	0	1	1	1.0
阐述	1	0	0	1	1.0
阅兵	1	0	0	1	1.0
闻	0	0	1	1	1.0
闹腾	1	0	0	1	1.0
闹元宵	0	0	1	1	1.0
闷闷不乐	0	0	1	1	1.0
闷闷	0	0	1	1	1.0
闷头	0	1	0	1	1.0
闷声	0	1	0	1	1.0
闷	0	1	0	1	1.0
间隔	1	0	0	1	1.0
闲言碎语	1	0	0	1	1.0
闲着	0	0	1	1	1.0
闲心	0	1	0	1	1.0
闲事	0	0	1	1	1.0
闲	1	0	0	1	1.0
闯荡	0	0	1	1	1.0
闯江湖	0	0	1	1	1.0
问罪	0	1	0	1	1.0
问答	1	0	0	1	1.0
问好	0	1	0	1	1.0
闭嘴	0	1	0	1	1.0
闭口	0	1	0	1	1.0
闭一只眼	1	0	0	1	1.0
闭	1	0	0	1	1.0
闫	1	0	0	1	1.0
闪闪发光	1	0	0	1	1.0
闪电	0	1	0	1	1.0
闪现	0	0	1	1	1.0
闪光灯	0	0	1	1	1.0
闪光	0	0	1	1	1.0
闪亮	1	0	0	1	1.0
门铃	0	1	0	1	1.0
门诊部	0	1	0	1	1.0
门诊	0	1	0	1	1.0
门规	0	1	0	1	1.0
门票	0	1	0	1	1.0
门板	1	0	0	1	1.0
门户网站	0	0	1	1	1.0
门户网	0	0	1	1	1.0
门户	0	0	1	1	1.0
门前	0	1	0	1	1.0
门下	0	1	0	1	1.0
门上	1	0	0	1	1.0
长青	1	0	0	1	1.0
长距离	0	1	0	1	1.0
长跑	1	0	0	1	1.0
长耳朵	0	0	1	1	1.0
长篇小说	1	0	0	1	1.0
长篇	1	0	0	1	1.0
长生	1	0	0	1	1.0
长沙火车站	0	0	1	1	1.0
长此以往	0	1	0	1	1.0
长期存在	0	1	0	1	1.0
长年累月	0	0	1	1	1.0
长官	1	0	0	1	1.0
长安街	0	1	0	1	1.0
长宁	1	0	0	1	1.0
长势	0	0	1	1	1.0
镭射	0	0	1	1	1.0
镇定	1	0	0	1	1.0
镇压	1	0	0	1	1.0
镇内	1	0	0	1	1.0
锻炼身体	1	0	0	1	1.0
锱铢必较	0	1	0	1	1.0
锱铢	0	1	0	1	1.0
键盘输入	1	0	0	1	1.0
锦绣	0	1	0	1	1.0
锦	1	0	0	1	1.0
锤子	0	0	1	1	1.0
锣	1	0	0	1	1.0
错综复杂	1	0	0	1	1.0
错综	1	0	0	1	1.0
锐	0	0	1	1	1.0
锋利	1	0	0	1	1.0
锋	0	1	0	1	1.0
锁定	0	1	0	1	1.0
销毁	0	1	0	1	1.0
链条	0	1	0	1	1.0
链接	0	0	1	1	1.0
链子	0	1	0	1	1.0
铺张浪费	0	1	0	1	1.0
铺张	0	1	0	1	1.0
银装	1	0	0	1	1.0
银行信贷	1	0	0	1	1.0
银色	1	0	0	1	1.0
银耳	1	0	0	1	1.0
银子	1	0	0	1	1.0
银	0	0	1	1	1.0
铲除	0	1	0	1	1.0
铜矿	1	0	0	1	1.0
铛	1	0	0	1	1.0
铅笔	1	0	0	1	1.0
铅	0	0	1	1	1.0
铃声	0	0	1	1	1.0
铁鸟	0	0	1	1	1.0
铁骑	1	0	0	1	1.0
铁路局	0	1	0	1	1.0
铁路	0	1	0	1	1.0
铁证	0	1	0	1	1.0
铁血网	1	0	0	1	1.0
铁板一块	0	0	1	1	1.0
铁板	0	0	1	1	1.0
铁幕	0	1	0	1	1.0
铁厂	1	0	0	1	1.0
铁公鸡	0	1	0	1	1.0
铁了心	0	0	1	1	1.0
钻石	0	1	0	1	1.0
钻出来	1	0	0	1	1.0
钻出	1	0	0	1	1.0
钱财	1	0	0	1	1.0
钱包	0	0	1	1	1.0
钢铁厂	1	0	0	1	1.0
钢铁	1	0	0	1	1.0
钢炮	1	0	0	1	1.0
钢材	0	0	1	1	1.0
钟汉良	0	0	1	1	1.0
钟	0	1	0	1	1.0
钞票	0	0	1	1	1.0
钓誉	1	0	0	1	1.0
针锋相对	1	0	0	1	1.0
针锋	1	0	0	1	1.0
鉴定	0	0	1	1	1.0
釜底抽薪	0	1	0	1	1.0
金钱	1	0	0	1	1.0
金边	1	0	0	1	1.0
金融体制	1	0	0	1	1.0
金融	1	0	0	1	1.0
金蛇	0	1	0	1	1.0
金花	1	0	0	1	1.0
金猴	1	0	0	1	1.0
金山	1	0	0	1	1.0
金宝贝	1	0	0	1	1.0
金子	0	0	1	1	1.0
金华	0	1	0	1	1.0
金主	1	0	0	1	1.0
量身定做	0	0	1	1	1.0
量身	0	0	1	1	1.0
量化	0	0	1	1	1.0
野心	0	1	0	1	1.0
野外	0	1	0	1	1.0
野兽	0	1	0	1	1.0
重阳	0	1	0	1	1.0
重镇	1	0	0	1	1.0
重量	0	1	0	1	1.0
重负	0	1	0	1	1.0
重要性	0	0	1	1	1.0
重装系统	0	1	0	1	1.0
重装	0	1	0	1	1.0
重磅	0	0	1	1	1.0
重生	0	0	1	1	1.0
重灾区	1	0	0	1	1.0
重灾	1	0	0	1	1.0
重温	1	0	0	1	1.0
重来	0	1	0	1	1.0
重拳出击	1	0	0	1	1.0
重感冒	1	0	0	1	1.0
重庆市	0	1	0	1	1.0
重启	0	1	0	1	1.0
重合	0	0	1	1	1.0
重出江湖	0	1	0	1	1.0
重出	0	1	0	1	1.0
重典	1	0	0	1	1.0
重伤	0	0	1	1	1.0
重任	1	0	0	1	1.0
重于泰山	0	1	0	1	1.0
重于	0	1	0	1	1.0
里边	0	1	0	1	1.0
里米	0	1	0	1	1.0
里程	0	0	1	1	1.0
里头	0	0	1	1	1.0
里亚尔	1	0	0	1	1.0
释疑	0	0	1	1	1.0
释然	1	0	0	1	1.0
释手	1	0	0	1	1.0
采集	1	0	0	1	1.0
采购	1	0	0	1	1.0
采莲船	1	0	0	1	1.0
采取措施	0	1	0	1	1.0
采取任何	1	0	0	1	1.0
醒脑	0	1	0	1	1.0
醒来	0	0	1	1	1.0
醒悟	0	1	0	1	1.0
醉酒	0	0	1	1	1.0
醉人	1	0	0	1	1.0
酸酸甜甜	1	0	0	1	1.0
酸酸	1	0	0	1	1.0
酸蓄电池	0	0	1	1	1.0
酸甜	1	0	0	1	1.0
酸性	0	0	1	1	1.0
酸	0	1	0	1	1.0
酷爱	1	0	0	1	1.0
酱油	1	0	0	1	1.0
酱汤	1	0	0	1	1.0
酒窝	0	1	0	1	1.0
酒杯	0	1	0	1	1.0
配额	1	0	0	1	1.0
配钥匙	0	1	0	1	1.0
配送费	0	1	0	1	1.0
配方	0	0	1	1	1.0
配对	0	1	0	1	1.0
配套措施	0	1	0	1	1.0
配型	0	0	1	1	1.0
配件	0	0	1	1	1.0
酌情	0	1	0	1	1.0
都还没	1	0	0	1	1.0
都市报	1	0	0	1	1.0
郴州	0	0	1	1	1.0
部门规章	0	1	0	1	1.0
部手机	0	1	0	1	1.0
部属	0	1	0	1	1.0
部下	1	0	0	1	1.0
郑重宣布	0	1	0	1	1.0
郑重	0	1	0	1	1.0
郑州市	0	0	1	1	1.0
郊游	1	0	0	1	1.0
郊区	0	1	0	1	1.0
郁	0	0	1	1	1.0
邵阳	1	0	0	1	1.0
邯郸	0	1	0	1	1.0
邮政局	0	0	1	1	1.0
邮报	1	0	0	1	1.0
邮局	1	0	0	1	1.0
那达慕	1	0	0	1	1.0
那次	0	1	0	1	1.0
那才真	0	1	0	1	1.0
那大	0	0	1	1	1.0
那句话	0	0	1	1	1.0
那儿	0	0	1	1	1.0
那伙子	1	0	0	1	1.0
那伙	1	0	0	1	1.0
那么些	1	0	0	1	1.0
那一刻	0	0	1	1	1.0
邓小平	0	1	0	1	1.0
邑	1	0	0	1	1.0
避让	0	1	0	1	1.0
避孕环	0	0	1	1	1.0
避孕套	0	1	0	1	1.0
避嫌	1	0	0	1	1.0
遵纪守法	1	0	0	1	1.0
遵纪	1	0	0	1	1.0
遵循	0	1	0	1	1.0
遮雨棚	1	0	0	1	1.0
遮雨	1	0	0	1	1.0
遮羞布	0	1	0	1	1.0
遮羞	0	1	0	1	1.0
遮天蔽日	1	0	0	1	1.0
遮天	1	0	0	1	1.0
遮不住	0	0	1	1	1.0
遭难	0	0	1	1	1.0
遭劫持	0	0	1	1	1.0
遭劫	0	0	1	1	1.0
遥远	1	0	0	1	1.0
遥控	0	1	0	1	1.0
遣返	0	0	1	1	1.0
遗留问题	0	1	0	1	1.0
遗留	0	1	0	1	1.0
遗弃	1	0	0	1	1.0
遗失	1	0	0	1	1.0
遗产	1	0	0	1	1.0
道里区	0	1	0	1	1.0
道路以目	0	1	0	1	1.0
道歉	0	1	0	1	1.0
道家	1	0	0	1	1.0
遏制	1	0	0	1	1.0
遍布	1	0	0	1	1.0
遇见	1	0	0	1	1.0
遇袭	0	1	0	1	1.0
遂	0	0	1	1	1.0
逼迫	0	1	0	1	1.0
逼急	0	1	0	1	1.0
逼婚	0	1	0	1	1.0
逼人	0	0	1	1	1.0
逸	0	0	1	1	1.0
逮捕	0	1	0	1	1.0
逮到	0	0	1	1	1.0
逢年过节	0	0	1	1	1.0
逢	0	1	0	1	1.0
造纸厂	1	0	0	1	1.0
造纸	1	0	0	1	1.0
造福	1	0	0	1	1.0
造影	0	0	1	1	1.0
造反	0	1	0	1	1.0
造出来	1	0	0	1	1.0
造出	1	0	0	1	1.0
速速	1	0	0	1	1.0
速率	0	1	0	1	1.0
速度限制	0	1	0	1	1.0
速	0	0	1	1	1.0
逝去	1	0	0	1	1.0
逛商场	0	0	1	1	1.0
通通	0	1	0	1	1.0
通讯社	1	0	0	1	1.0
通胀	0	1	0	1	1.0
通红	0	1	0	1	1.0
通明	1	0	0	1	1.0
通常	0	0	1	1	1.0
通宵	0	1	0	1	1.0
通城	1	0	0	1	1.0
逗我	0	1	0	1	1.0
逗人	1	0	0	1	1.0
逐年	0	1	0	1	1.0
逐客令	0	1	0	1	1.0
逐客	0	1	0	1	1.0
逐利	0	1	0	1	1.0
逐出	0	0	1	1	1.0
透过	0	0	1	1	1.0
透彻	0	0	1	1	1.0
逍遥	0	1	0	1	1.0
逊	1	0	0	1	1.0
选购	0	0	1	1	1.0
选票	0	1	0	1	1.0
选取	0	0	1	1	1.0
逆向行驶	1	0	0	1	1.0
逆向	1	0	0	1	1.0
逆势	1	0	0	1	1.0
逃避	0	0	1	1	1.0
逃税	0	0	1	1	1.0
逃离	0	1	0	1	1.0
逃票	1	0	0	1	1.0
逃犯	0	1	0	1	1.0
逃往	1	0	0	1	1.0
逃回	1	0	0	1	1.0
逃	0	1	0	1	1.0
适龄	1	0	0	1	1.0
适婚年龄	1	0	0	1	1.0
适婚	1	0	0	1	1.0
适可而止	1	0	0	1	1.0
适中	0	0	1	1	1.0
送达	0	1	0	1	1.0
送葬	0	1	0	1	1.0
送医	1	0	0	1	1.0
退货	0	1	0	1	1.0
退化	1	0	0	1	1.0
退休年龄	0	1	0	1	1.0
退一步	1	0	0	1	1.0
追问	1	0	0	1	1.0
追求	0	0	1	1	1.0
追捧	1	0	0	1	1.0
追捕	1	0	0	1	1.0
追尾	1	0	0	1	1.0
追堵	0	1	0	1	1.0
迷茫	1	0	0	1	1.0
迷你版	0	1	0	1	1.0
迷人	0	0	1	1	1.0
迷	0	0	1	1	1.0
迫害	1	0	0	1	1.0
迪沃斯	0	1	0	1	1.0
迥异	1	0	0	1	1.0
迟迟	1	0	0	1	1.0
迟到	1	0	0	1	1.0
连降	0	0	1	1	1.0
连锁	0	0	1	1	1.0
连连	0	0	1	1	1.0
连累	0	1	0	1	1.0
连环画	1	0	0	1	1.0
连天	0	1	0	1	1.0
连夜	0	1	0	1	1.0
连城	1	0	0	1	1.0
违约	1	0	0	1	1.0
违法乱纪	0	1	0	1	1.0
违反规定	1	0	0	1	1.0
远门	0	1	0	1	1.0
远远	1	0	0	1	1.0
远流	0	0	1	1	1.0
远嫁	1	0	0	1	1.0
远大于	0	1	0	1	1.0
远大	0	1	0	1	1.0
远东地区	0	1	0	1	1.0
进行谈判	0	1	0	1	1.0
进屋	1	0	0	1	1.0
进城	0	1	0	1	1.0
进出口	0	0	1	1	1.0
进出	0	0	1	1	1.0
进军	1	0	0	1	1.0
进修	0	1	0	1	1.0
这辆	0	0	1	1	1.0
这笔	0	1	0	1	1.0
这段话	0	1	0	1	1.0
这段	0	1	0	1	1.0
这本	1	0	0	1	1.0
这时候	0	0	1	1	1.0
这帮	0	1	0	1	1.0
这家	0	1	0	1	1.0
这天	1	0	0	1	1.0
这场	0	1	0	1	1.0
这些年来	0	0	1	1	1.0
这么点儿	1	0	0	1	1.0
这下子	1	0	0	1	1.0
还过得去	1	0	0	1	1.0
还过	1	0	0	1	1.0
还跟着	0	1	0	1	1.0
还清	1	0	0	1	1.0
还原	0	0	1	1	1.0
返家	1	0	0	1	1.0
近日来	1	0	0	1	1.0
近在咫尺	1	0	0	1	1.0
近在	1	0	0	1	1.0
近千人	0	1	0	1	1.0
近几个月	0	0	1	1	1.0
近代史	1	0	0	1	1.0
近代	1	0	0	1	1.0
近些年	1	0	0	1	1.0
近些	1	0	0	1	1.0
运转	0	1	0	1	1.0
运走	0	1	0	1	1.0
运费	0	0	1	1	1.0
运往	0	1	0	1	1.0
运到	0	0	1	1	1.0
迎送	0	0	1	1	1.0
迎合	0	1	0	1	1.0
迎刃而解	0	1	0	1	1.0
迈德	0	0	1	1	1.0
迈尔斯	1	0	0	1	1.0
迈尔	1	0	0	1	1.0
过路	1	0	0	1	1.0
过街老鼠	1	0	0	1	1.0
过街	1	0	0	1	1.0
过瘾	0	0	1	1	1.0
过生日	1	0	0	1	1.0
过段时间	1	0	0	1	1.0
过桥	0	0	1	1	1.0
过期作废	0	0	1	1	1.0
过时	0	1	0	1	1.0
过得去	1	0	0	1	1.0
过家家	0	1	0	1	1.0
过头	0	1	0	1	1.0
过境费	1	0	0	1	1.0
过境	1	0	0	1	1.0
过场	1	0	0	1	1.0
过半	1	0	0	1	1.0
过剩	0	0	1	1	1.0
过冬	1	0	0	1	1.0
过世	0	0	1	1	1.0
迅	1	0	0	1	1.0
迄今	1	0	0	1	1.0
迂回	1	0	0	1	1.0
迁移	1	0	0	1	1.0
达标	1	0	0	1	1.0
达成协议	0	1	0	1	1.0
达尔	0	1	0	1	1.0
辽宁省	0	1	0	1	1.0
边角料	0	1	0	1	1.0
边角	0	1	0	1	1.0
边疆	0	0	1	1	1.0
边界地区	1	0	0	1	1.0
边玩	0	0	1	1	1.0
边境线	1	0	0	1	1.0
边境县	0	0	1	1	1.0
辱骂	1	0	0	1	1.0
辩论	0	0	1	1	1.0
辞旧岁	0	1	0	1	1.0
辛酸	0	0	1	1	1.0
辛格	0	1	0	1	1.0
辛劳	1	0	0	1	1.0
辛	0	0	1	1	1.0
输送	0	1	0	1	1.0
输精管	0	1	0	1	1.0
输精	0	1	0	1	1.0
输出功率	0	0	1	1	1.0
辐射	1	0	0	1	1.0
辍学	0	0	1	1	1.0
辉煌	0	1	0	1	1.0
辈分	0	1	0	1	1.0
辅导	1	0	0	1	1.0
较量	0	0	1	1	1.0
较劲	0	1	0	1	1.0
较之	0	0	1	1	1.0
载舟	0	1	0	1	1.0
载物	1	0	0	1	1.0
载人	1	0	0	1	1.0
轻重	1	0	0	1	1.0
轻轻松松	0	0	1	1	1.0
轻轨	0	0	1	1	1.0
轻言	0	1	0	1	1.0
轻而易举	0	1	0	1	1.0
轻松松	0	0	1	1	1.0
轻描淡写	1	0	0	1	1.0
轻微	0	1	0	1	1.0
轻举妄动	1	0	0	1	1.0
轰隆隆	0	1	0	1	1.0
轰隆	0	1	0	1	1.0
轰轰烈烈	1	0	0	1	1.0
轰轰	1	0	0	1	1.0
软饭	0	1	0	1	1.0
轮胎	1	0	0	1	1.0
轮廓	0	0	1	1	1.0
轮回	1	0	0	1	1.0
转过	1	0	0	1	1.0
转转	1	0	0	1	1.0
转身	1	0	0	1	1.0
转瞬	1	0	0	1	1.0
转盘	1	0	0	1	1.0
转接头	1	0	0	1	1.0
转接	1	0	0	1	1.0
转换	0	1	0	1	1.0
转手	1	0	0	1	1.0
转嫁给	0	1	0	1	1.0
转嫁	0	1	0	1	1.0
转基因	0	1	0	1	1.0
转向	0	0	1	1	1.0
转发给	0	1	0	1	1.0
转下去	0	1	0	1	1.0
转下	0	1	0	1	1.0
轩然大波	0	0	1	1	1.0
轨	0	0	1	1	1.0
轧死	1	0	0	1	1.0
车队	0	0	1	1	1.0
车迷	1	0	0	1	1.0
车身	0	0	1	1	1.0
车行	0	1	0	1	1.0
车臣共和国	0	1	0	1	1.0
车臣	0	1	0	1	1.0
车管	0	1	0	1	1.0
车流	0	0	1	1	1.0
车底	0	1	0	1	1.0
车库	0	1	0	1	1.0
车展	1	0	0	1	1.0
躲避	0	0	1	1	1.0
身高	0	0	1	1	1.0
身经	1	0	0	1	1.0
身怀	1	0	0	1	1.0
身心	0	0	1	1	1.0
身影	0	1	0	1	1.0
身处	0	1	0	1	1.0
身后	1	0	0	1	1.0
身体力行	0	1	0	1	1.0
躁动	1	0	0	1	1.0
蹲	0	1	0	1	1.0
蹭	0	0	1	1	1.0
蹦蹦跳跳	0	0	1	1	1.0
蹦蹦跳	0	0	1	1	1.0
蹦蹦	0	0	1	1	1.0
蹦跳	0	0	1	1	1.0
蹦出	1	0	0	1	1.0
蹦	1	0	0	1	1.0
踩高跷	1	0	0	1	1.0
踏上	0	1	0	1	1.0
跳跃	1	0	0	1	1.0
路通	1	0	0	1	1.0
路途遥远	1	0	0	1	1.0
路路通	1	0	0	1	1.0
路易斯	0	0	1	1	1.0
路易	0	0	1	1	1.0
路局	0	1	0	1	1.0
跪下	0	0	1	1	1.0
跟贴	1	0	0	1	1.0
跟我来	1	0	0	1	1.0
跟得上	1	0	0	1	1.0
跟得	1	0	0	1	1.0
跟帖	0	0	1	1	1.0
跟屁虫	0	1	0	1	1.0
距	0	0	1	1	1.0
跑跳	1	0	0	1	1.0
跑跑跳跳	1	0	0	1	1.0
跑跑	1	0	0	1	1.0
跌宕	0	1	0	1	1.0
跌停	0	1	0	1	1.0
趴	0	0	1	1	1.0
足轻	1	0	0	1	1.0
足足	0	1	0	1	1.0
足球场	0	0	1	1	1.0
足球	0	0	1	1	1.0
足够	1	0	0	1	1.0
趣味	1	0	0	1	1.0
趣事	1	0	0	1	1.0
越来越近	0	1	0	1	1.0
越来越低	0	1	0	1	1.0
越慢	1	0	0	1	1.0
越感	1	0	0	1	1.0
越境者	1	0	0	1	1.0
超重	0	1	0	1	1.0
超载	0	1	0	1	1.0
超越	0	1	0	1	1.0
超出	1	0	0	1	1.0
超低	0	1	0	1	1.0
趁火打劫	0	1	0	1	1.0
趁	0	0	1	1	1.0
起火	0	0	1	1	1.0
起源于	1	0	0	1	1.0
起源	1	0	0	1	1.0
起死回生	0	1	0	1	1.0
起步价	0	1	0	1	1.0
起家	1	0	0	1	1.0
起名	1	0	0	1	1.0
起价	0	0	1	1	1.0
赶超	1	0	0	1	1.0
赶往	1	0	0	1	1.0
赶尽杀绝	0	1	0	1	1.0
赶场	1	0	0	1	1.0
赶不上	1	0	0	1	1.0
赶下台	1	0	0	1	1.0
赶下	1	0	0	1	1.0
赴美	1	0	0	1	1.0
赴	0	0	1	1	1.0
走进	1	0	0	1	1.0
走过场	1	0	0	1	1.0
走街串巷	1	0	0	1	1.0
走稳	1	0	0	1	1.0
走私	1	0	0	1	1.0
走掉	1	0	0	1	1.0
走廊	0	0	1	1	1.0
走回头路	0	1	0	1	1.0
走回头	0	1	0	1	1.0
走回	0	1	0	1	1.0
走出	0	0	1	1	1.0
走低	0	0	1	1	1.0
走下坡路	1	0	0	1	1.0
走下坡	1	0	0	1	1.0
走下	1	0	0	1	1.0
走一遍	0	0	1	1	1.0
赫然	0	0	1	1	1.0
赫拉	0	0	1	1	1.0
赤贫	0	1	0	1	1.0
赤裸裸	0	1	0	1	1.0
赤裸	0	1	0	1	1.0
赢得	1	0	0	1	1.0
赡养父母	0	1	0	1	1.0
赠送	0	1	0	1	1.0
赞美	0	0	1	1	1.0
赞扬	0	1	0	1	1.0
赛龙舟	1	0	0	1	1.0
赛龙	1	0	0	1	1.0
赔钱	0	1	0	1	1.0
赔付	1	0	0	1	1.0
赔不是	0	1	0	1	1.0
赔	0	1	0	1	1.0
赏金	0	1	0	1	1.0
资源分配	0	0	1	1	1.0
资深	1	0	0	1	1.0
资料	1	0	0	1	1.0
贾	0	1	0	1	1.0
贼喊捉贼	1	0	0	1	1.0
贼	1	0	0	1	1.0
贺年	1	0	0	1	1.0
贺岁片	0	0	1	1	1.0
贺岁	0	0	1	1	1.0
费钱	0	1	0	1	1.0
费心	1	0	0	1	1.0
费劲	1	0	0	1	1.0
贸易	1	0	0	1	1.0
贷	1	0	0	1	1.0
贵阳	0	0	1	1	1.0
贵重	0	0	1	1	1.0
贵族	1	0	0	1	1.0
贵州	0	1	0	1	1.0
贵宾犬	1	0	0	1	1.0
贵宾	1	0	0	1	1.0
贵子	0	0	1	1	1.0
贴近生活	1	0	0	1	1.0
贴近	1	0	0	1	1.0
贴纸	0	1	0	1	1.0
贴图	0	1	0	1	1.0
贱民	0	1	0	1	1.0
购车	0	1	0	1	1.0
购房	0	1	0	1	1.0
贫铀弹	0	1	0	1	1.0
贫铀	0	1	0	1	1.0
贫贱夫妻	0	1	0	1	1.0
贫贱	0	1	0	1	1.0
贫瘠	1	0	0	1	1.0
贫富差距	0	1	0	1	1.0
贫富	0	1	0	1	1.0
贫乏	1	0	0	1	1.0
贫	0	1	0	1	1.0
贪腐	0	1	0	1	1.0
贪官污吏	0	1	0	1	1.0
贪	0	1	0	1	1.0
贩卖军火	1	0	0	1	1.0
质问	0	1	0	1	1.0
质监局	0	0	1	1	1.0
质监	0	0	1	1	1.0
质感	0	1	0	1	1.0
货币化	1	0	0	1	1.0
货币	1	0	0	1	1.0
货价	0	1	0	1	1.0
败类	1	0	0	1	1.0
败笔	0	1	0	1	1.0
败	1	0	0	1	1.0
贤惠	0	0	1	1	1.0
责任心	1	0	0	1	1.0
财经网	0	1	0	1	1.0
财经新闻	0	0	1	1	1.0
财物	0	0	1	1	1.0
财源滚滚	1	0	0	1	1.0
财源	1	0	0	1	1.0
财气	1	0	0	1	1.0
财权	0	0	1	1	1.0
财政状况	0	1	0	1	1.0
财政	0	1	0	1	1.0
财产权利	0	1	0	1	1.0
财产损失	0	0	1	1	1.0
贡	1	0	0	1	1.0
负荷	1	0	0	1	1.0
负翁	1	0	0	1	1.0
贞洁	0	1	0	1	1.0
贝尔	1	0	0	1	1.0
贝	1	0	0	1	1.0
豫西南	1	0	0	1	1.0
豫西	1	0	0	1	1.0
豫北	1	0	0	1	1.0
豫	0	1	0	1	1.0
豪情	1	0	0	1	1.0
豪	0	1	0	1	1.0
象征	1	0	0	1	1.0
豚	0	1	0	1	1.0
豆豆	1	0	0	1	1.0
豆包	1	0	0	1	1.0
谭	1	0	0	1	1.0
谬论	1	0	0	1	1.0
谩骂	1	0	0	1	1.0
谨防	0	1	0	1	1.0
谣言	0	1	0	1	1.0
谢谢你们	1	0	0	1	1.0
谢瓦尔德纳泽	0	1	0	1	1.0
谢瓦尔德纳	0	1	0	1	1.0
谋财害命	0	0	1	1	1.0
谋财	0	0	1	1	1.0
谈资	0	1	0	1	1.0
谈笑风生	0	1	0	1	1.0
谈笑	0	1	0	1	1.0
谈朋友	0	0	1	1	1.0
谈判桌	0	1	0	1	1.0
谈何	1	0	0	1	1.0
调运	0	1	0	1	1.0
调解员	0	1	0	1	1.0
调研	0	1	0	1	1.0
调理	1	0	0	1	1.0
调教	0	0	1	1	1.0
调和	1	0	0	1	1.0
调味剂	1	0	0	1	1.0
调味	1	0	0	1	1.0
调兵山	0	1	0	1	1.0
调兵	0	1	0	1	1.0
调停	0	1	0	1	1.0
谁错	0	1	0	1	1.0
课程	0	0	1	1	1.0
课外	0	1	0	1	1.0
课后	1	0	0	1	1.0
读物	0	1	0	1	1.0
诺贝尔和平奖	1	0	0	1	1.0
诺贝尔	1	0	0	1	1.0
诺贝	1	0	0	1	1.0
诺夫	1	0	0	1	1.0
诸葛	1	0	0	1	1.0
诸城	1	0	0	1	1.0
诸位	1	0	0	1	1.0
请客	0	0	1	1	1.0
说破	0	0	1	1	1.0
说瞎话	0	1	0	1	1.0
说服教育	0	1	0	1	1.0
说教	1	0	0	1	1.0
说得好	0	1	0	1	1.0
说句话	0	0	1	1	1.0
说句实话	0	1	0	1	1.0
说到做到	0	0	1	1	1.0
说不得	0	1	0	1	1.0
说不完	1	0	0	1	1.0
说一说	0	1	0	1	1.0
诱发	0	1	0	1	1.0
误触	0	1	0	1	1.0
误打	0	1	0	1	1.0
语音	0	1	0	1	1.0
语言文学	0	0	1	1	1.0
语无伦次	1	0	0	1	1.0
语录	0	0	1	1	1.0
该车	0	0	1	1	1.0
该是	0	1	0	1	1.0
该奖	1	0	0	1	1.0
该国	1	0	0	1	1.0
诡异	0	1	0	1	1.0
诡	1	0	0	1	1.0
诠释	1	0	0	1	1.0
诞生	0	1	0	1	1.0
话筒	1	0	0	1	1.0
话机	0	0	1	1	1.0
诚然	0	0	1	1	1.0
诚恳	0	0	1	1	1.0
诗神	1	0	0	1	1.0
试衣间	0	0	1	1	1.0
试衣	0	0	1	1	1.0
试纸	1	0	0	1	1.0
试用	0	0	1	1	1.0
试玩	0	1	0	1	1.0
试点	0	1	0	1	1.0
试探	1	0	0	1	1.0
试一下	1	0	0	1	1.0
诊治	0	1	0	1	1.0
诊所	0	0	1	1	1.0
诉说	1	0	0	1	1.0
诈骗	1	0	0	1	1.0
诅咒	1	0	0	1	1.0
评理	0	1	0	1	1.0
评委	1	0	0	1	1.0
评估	1	0	0	1	1.0
评为	1	0	0	1	1.0
证券	0	0	1	1	1.0
设身处地	0	1	0	1	1.0
设计师	0	1	0	1	1.0
设置	0	0	1	1	1.0
设立	0	0	1	1	1.0
设有	0	0	1	1	1.0
设定	1	0	0	1	1.0
设	0	1	0	1	1.0
讽刺	1	0	0	1	1.0
讽	0	0	1	1	1.0
论点	0	1	0	1	1.0
论持久战	0	0	1	1	1.0
论事	0	0	1	1	1.0
许愿	1	0	0	1	1.0
许可证书	0	0	1	1	1.0
讲理	0	0	1	1	1.0
讲法	0	0	1	1	1.0
讲求	0	1	0	1	1.0
讲故事	1	0	0	1	1.0
讲义	0	0	1	1	1.0
记者会	0	1	0	1	1.0
记忆犹新	1	0	0	1	1.0
记录本	0	1	0	1	1.0
记住	0	0	1	1	1.0
记不住	0	0	1	1	1.0
讯	0	1	0	1	1.0
议论文	0	0	1	1	1.0
议和	0	1	0	1	1.0
议会	0	0	1	1	1.0
训	0	0	1	1	1.0
让给	0	1	0	1	1.0
让座	1	0	0	1	1.0
让出	0	0	1	1	1.0
认错	1	0	0	1	1.0
认真思考	0	0	1	1	1.0
认定	1	0	0	1	1.0
认不出来	0	0	1	1	1.0
认不出	0	0	1	1	1.0
订购	1	0	0	1	1.0
订票	1	0	0	1	1.0
订单式	1	0	0	1	1.0
订	0	1	0	1	1.0
计谋	0	1	0	1	1.0
计生办	0	1	0	1	1.0
计时	1	0	0	1	1.0
计学	1	0	0	1	1.0
计	0	1	0	1	1.0
警醒	0	1	0	1	1.0
警报声	0	0	1	1	1.0
警官	1	0	0	1	1.0
警务	1	0	0	1	1.0
誓死捍卫	0	1	0	1	1.0
誓死	0	1	0	1	1.0
誉为	1	0	0	1	1.0
言语	0	0	1	1	1.0
言论	1	0	0	1	1.0
言行	1	0	0	1	1.0
言下之意	1	0	0	1	1.0
触发	0	0	1	1	1.0
触及	1	0	0	1	1.0
触动	0	0	1	1	1.0
解除	1	0	0	1	1.0
解读	1	0	0	1	1.0
解答	0	0	1	1	1.0
解放日报	0	1	0	1	1.0
解惑	0	0	1	1	1.0
解决不了	0	1	0	1	1.0
解体	0	1	0	1	1.0
角旗	1	0	0	1	1.0
角度看	0	0	1	1	1.0
角	0	1	0	1	1.0
觉醒	0	1	0	1	1.0
觉着	0	1	0	1	1.0
视而不见	1	0	0	1	1.0
视网膜	1	0	0	1	1.0
视网	1	0	0	1	1.0
视同	0	1	0	1	1.0
规章制度	0	0	1	1	1.0
观火	1	0	0	1	1.0
观感	0	0	1	1	1.0
观察员	1	0	0	1	1.0
观世音	0	1	0	1	1.0
见证	0	1	0	1	1.0
见缝就钻	1	0	0	1	1.0
见成效	0	1	0	1	1.0
覆舟	0	1	0	1	1.0
要饭	0	1	0	1	1.0
要花费	0	1	0	1	1.0
要强	1	0	0	1	1.0
要图	1	0	0	1	1.0
要件	0	1	0	1	1.0
要从严	0	0	1	1	1.0
要义	1	0	0	1	1.0
要不是	1	0	0	1	1.0
西门町	1	0	0	1	1.0
西门	1	0	0	1	1.0
西边	0	1	0	1	1.0
西路	0	0	1	1	1.0
西装	1	0	0	1	1.0
西藏	1	0	0	1	1.0
西瓜	0	1	0	1	1.0
西环路	1	0	0	1	1.0
西湖	1	0	0	1	1.0
西游记	0	1	0	1	1.0
西欧	0	0	1	1	1.0
西柏坡	0	1	0	1	1.0
西往东	1	0	0	1	1.0
西往	1	0	0	1	1.0
西域	0	0	1	1	1.0
西城	0	0	1	1	1.0
西南	1	0	0	1	1.0
西单	1	0	0	1	1.0
西北风	0	0	1	1	1.0
西北方	1	0	0	1	1.0
西北地区	1	0	0	1	1.0
西化	1	0	0	1	1.0
西兰	0	1	0	1	1.0
西侧	0	1	0	1	1.0
西亚	1	0	0	1	1.0
褶	0	1	0	1	1.0
褪	0	1	0	1	1.0
裹足不前	0	1	0	1	1.0
裹足	0	1	0	1	1.0
裸	0	0	1	1	1.0
裴	0	1	0	1	1.0
装进	0	0	1	1	1.0
装置	0	0	1	1	1.0
装盒	0	0	1	1	1.0
装潢	0	0	1	1	1.0
装模作样	1	0	0	1	1.0
装备	1	0	0	1	1.0
装入	0	1	0	1	1.0
装修	0	1	0	1	1.0
裁判	1	0	0	1	1.0
被誉为	1	0	0	1	1.0
被盗	0	0	1	1	1.0
被捕	0	0	1	1	1.0
被打乱	0	0	1	1	1.0
被忽视	0	1	0	1	1.0
被告	1	0	0	1	1.0
被压迫	0	1	0	1	1.0
被动	1	0	0	1	1.0
袜子	1	0	0	1	1.0
袜	1	0	0	1	1.0
袋子	1	0	0	1	1.0
衷心祝愿	1	0	0	1	1.0
衰落	0	1	0	1	1.0
衰弱	1	0	0	1	1.0
表述	1	0	0	1	1.0
表达方式	1	0	0	1	1.0
表象	0	1	0	1	1.0
表示感谢	1	0	0	1	1.0
表示同意	0	1	0	1	1.0
表皮	1	0	0	1	1.0
表白	0	0	1	1	1.0
表扬	0	1	0	1	1.0
表意	0	0	1	1	1.0
表弟	1	0	0	1	1.0
表带	0	1	0	1	1.0
表妹	1	0	0	1	1.0
表哥	0	0	1	1	1.0
表决	0	1	0	1	1.0
补习	1	0	0	1	1.0
衣裳	0	1	0	1	1.0
衢州	0	1	0	1	1.0
衢	0	1	0	1	1.0
街道办	0	0	1	1	1.0
街边	0	1	0	1	1.0
街巷	1	0	0	1	1.0
街头巷尾	0	1	0	1	1.0
衔接	0	1	0	1	1.0
行驶证	1	0	0	1	1.0
行路人	0	1	0	1	1.0
行者	0	0	1	1	1.0
行政长官	1	0	0	1	1.0
行之有效	0	0	1	1	1.0
行业标准	0	1	0	1	1.0
行不行	0	0	1	1	1.0
血雨	0	1	0	1	1.0
血腥	1	0	0	1	1.0
血统	0	1	0	1	1.0
血糖	1	0	0	1	1.0
血球	1	0	0	1	1.0
血液	0	1	0	1	1.0
血洗	0	1	0	1	1.0
血汗	0	0	1	1	1.0
蠢事	1	0	0	1	1.0
螺丝	1	0	0	1	1.0
融资	1	0	0	1	1.0
螃蟹	1	0	0	1	1.0
蝴蝶	1	0	0	1	1.0
蝇	1	0	0	1	1.0
蜡烛	1	0	0	1	1.0
蜗牛	0	0	1	1	1.0
蜂窝	1	0	0	1	1.0
蛮子	0	1	0	1	1.0
蛙	1	0	0	1	1.0
蛋糕店	0	0	1	1	1.0
蛇口港	0	0	1	1	1.0
蛇口	0	0	1	1	1.0
蛀虫	0	1	0	1	1.0
蚕食	0	0	1	1	1.0
蚂蚁	0	0	1	1	1.0
虫子	0	1	0	1	1.0
虞舜	1	0	0	1	1.0
虚荣心	0	1	0	1	1.0
虚脱	1	0	0	1	1.0
虚无缥缈	0	1	0	1	1.0
虚无	0	1	0	1	1.0
虚岁	0	1	0	1	1.0
虚假	0	1	0	1	1.0
虚伪	1	0	0	1	1.0
虚	1	0	0	1	1.0
虐杀	1	0	0	1	1.0
虐恋	0	0	1	1	1.0
虎门	0	1	0	1	1.0
虎虎	1	0	0	1	1.0
蘑菇云	1	0	0	1	1.0
蘑菇	1	0	0	1	1.0
藏獒	1	0	0	1	1.0
藏	1	0	0	1	1.0
薰	0	0	1	1	1.0
薜	0	1	0	1	1.0
蔽日	1	0	0	1	1.0
蔷薇	0	0	1	1	1.0
蔬菜	0	1	0	1	1.0
蔡	0	0	1	1	1.0
蔚蓝	0	1	0	1	1.0
蓝色	1	0	0	1	1.0
蓝绿	0	0	1	1	1.0
蓝牙	0	0	1	1	1.0
蓝海	1	0	0	1	1.0
蓝光	1	0	0	1	1.0
蒙哥马利	1	0	0	1	1.0
蒙哥	1	0	0	1	1.0
蒙古族	1	0	0	1	1.0
蒙古人	0	1	0	1	1.0
蒙	0	1	0	1	1.0
蒂夫	1	0	0	1	1.0
蒂固	1	0	0	1	1.0
葱	1	0	0	1	1.0
葬身之地	0	1	0	1	1.0
葬身	0	1	0	1	1.0
著称	1	0	0	1	1.0
落马	0	1	0	1	1.0
落花流水	0	0	1	1	1.0
落花	0	0	1	1	1.0
落脚点	0	1	0	1	1.0
落脚	0	1	0	1	1.0
落空	0	1	0	1	1.0
落户	0	1	0	1	1.0
落伍	1	0	0	1	1.0
落下来	0	1	0	1	1.0
落下	0	1	0	1	1.0
萨哈林	0	0	1	1	1.0
萨哈	0	0	1	1	1.0
萨利赫	0	0	1	1	1.0
萨	1	0	0	1	1.0
萧山	1	0	0	1	1.0
萧	1	0	0	1	1.0
萦绕在	0	0	1	1	1.0
萦绕	0	0	1	1	1.0
营造	0	1	0	1	1.0
营生	1	0	0	1	1.0
营商	0	0	1	1	1.0
营利性	0	1	0	1	1.0
营利	0	1	0	1	1.0
萍乡市	0	0	1	1	1.0
萍乡	0	0	1	1	1.0
菲	0	0	1	1	1.0
菱角	1	0	0	1	1.0
菩萨	0	1	0	1	1.0
菏泽	1	0	0	1	1.0
菌	0	1	0	1	1.0
菊花	1	0	0	1	1.0
菊	0	1	0	1	1.0
获	0	0	1	1	1.0
莲藕	1	0	0	1	1.0
莱西	0	1	0	1	1.0
莫过于此	0	0	1	1	1.0
莫让	0	1	0	1	1.0
莫言	1	0	0	1	1.0
莫忘	1	0	0	1	1.0
莫名其妙	1	0	0	1	1.0
莉	0	0	1	1	1.0
荷兰	0	0	1	1	1.0
药物	1	0	0	1	1.0
药品	0	1	0	1	1.0
荧光棒	1	0	0	1	1.0
荧光	1	0	0	1	1.0
荤	0	1	0	1	1.0
荣华	1	0	0	1	1.0
荣	0	1	0	1	1.0
荡然无存	0	1	0	1	1.0
荡然	0	1	0	1	1.0
草莓	1	0	0	1	1.0
草率	0	1	0	1	1.0
草民	0	1	0	1	1.0
草案	0	1	0	1	1.0
草原	1	0	0	1	1.0
草	0	0	1	1	1.0
茶馆	0	1	0	1	1.0
茶水	1	0	0	1	1.0
茶庄	0	1	0	1	1.0
茫茫	0	0	1	1	1.0
范畴	0	0	1	1	1.0
茂名	0	1	0	1	1.0
茁壮成长	0	0	1	1	1.0
茁壮	0	0	1	1	1.0
英雄好汉	0	1	0	1	1.0
英语	1	0	0	1	1.0
英文	0	0	1	1	1.0
英双语	1	0	0	1	1.0
英勇斗争	1	0	0	1	1.0
英军	1	0	0	1	1.0
苦难	0	0	1	1	1.0
苦短	0	1	0	1	1.0
苦日子	0	0	1	1	1.0
苦哈哈	0	0	1	1	1.0
苦劝	0	1	0	1	1.0
苦主	1	0	0	1	1.0
苦中作乐	0	1	0	1	1.0
苦不堪言	0	1	0	1	1.0
苟	0	1	0	1	1.0
苗	0	1	0	1	1.0
苏维埃共和国	0	1	0	1	1.0
苏维埃	0	1	0	1	1.0
苏宁	0	0	1	1	1.0
苏区	1	0	0	1	1.0
苏俄	0	1	0	1	1.0
苏伊士运河	1	0	0	1	1.0
苏伊士	1	0	0	1	1.0
苏丹	0	1	0	1	1.0
苍白	0	1	0	1	1.0
花香	1	0	0	1	1.0
花销	0	1	0	1	1.0
花钱买	0	1	0	1	1.0
花絮	1	0	0	1	1.0
花石	1	0	0	1	1.0
花甲之年	0	0	1	1	1.0
花甲	0	0	1	1	1.0
花生酱	1	0	0	1	1.0
花球	0	0	1	1	1.0
花王	1	0	0	1	1.0
花椒	1	0	0	1	1.0
花栗鼠	1	0	0	1	1.0
花朵	0	0	1	1	1.0
花季	0	0	1	1	1.0
花城	0	0	1	1	1.0
花园	1	0	0	1	1.0
花卷	1	0	0	1	1.0
芯	1	0	0	1	1.0
芝士	0	0	1	1	1.0
芝	1	0	0	1	1.0
芜菁	1	0	0	1	1.0
芒	0	0	1	1	1.0
节约型	0	1	0	1	1.0
节气	1	0	0	1	1.0
节日期间	1	0	0	1	1.0
节奏快	1	0	0	1	1.0
节制性	1	0	0	1	1.0
艾哈迈德	0	0	1	1	1.0
艾哈迈	0	0	1	1	1.0
艺术课	1	0	0	1	1.0
艺术	1	0	0	1	1.0
艳	1	0	0	1	1.0
色调	1	0	0	1	1.0
色温	0	0	1	1	1.0
艰辛	1	0	0	1	1.0
艰	0	1	0	1	1.0
良辰	0	0	1	1	1.0
良知	0	1	0	1	1.0
船队	0	1	0	1	1.0
船长	0	1	0	1	1.0
舰	1	0	0	1	1.0
般	0	1	0	1	1.0
航空公司	0	1	0	1	1.0
航班	0	1	0	1	1.0
航	0	1	0	1	1.0
舞蹈演员	1	0	0	1	1.0
舞蹈	1	0	0	1	1.0
舞狮队	1	0	0	1	1.0
舞姿	0	0	1	1	1.0
舞台	0	0	1	1	1.0
舞剑	1	0	0	1	1.0
舒畅	1	0	0	1	1.0
舍本逐末	1	0	0	1	1.0
舍我其谁	0	1	0	1	1.0
舍尔	0	0	1	1	1.0
舍友	1	0	0	1	1.0
舆论导向	0	1	0	1	1.0
舆论压力	0	1	0	1	1.0
舅舅	0	0	1	1	1.0
舅	1	0	0	1	1.0
致电	0	1	0	1	1.0
致命	0	1	0	1	1.0
致伤	0	1	0	1	1.0
臭味相投	0	1	0	1	1.0
臭味	0	1	0	1	1.0
自负	0	0	1	1	1.0
自语	1	0	0	1	1.0
自言自语	1	0	0	1	1.0
自觉自愿	0	1	0	1	1.0
自艾	0	1	0	1	1.0
自称	0	0	1	1	1.0
自私自利	1	0	0	1	1.0
自禁	0	0	1	1	1.0
自相残杀	0	1	0	1	1.0
自相	0	1	0	1	1.0
自由选择	0	1	0	1	1.0
自然而然	1	0	0	1	1.0
自然环境	0	1	0	1	1.0
自治县	1	0	0	1	1.0
自杀	0	0	1	1	1.0
自愿者	0	1	0	1	1.0
自愈	0	1	0	1	1.0
自得	0	0	1	1	1.0
自律	1	0	0	1	1.0
自强	0	1	0	1	1.0
自寻烦恼	0	1	0	1	1.0
自寻	0	1	0	1	1.0
自如	0	0	1	1	1.0
自告奋勇	0	1	0	1	1.0
自古	1	0	0	1	1.0
自发	0	1	0	1	1.0
自卫队	0	0	1	1	1.0
自动化	0	1	0	1	1.0
自动关机	0	0	1	1	1.0
自利	1	0	0	1	1.0
自作自受	1	0	0	1	1.0
自作	1	0	0	1	1.0
自以为是	0	1	0	1	1.0
自以	0	1	0	1	1.0
自个儿	0	1	0	1	1.0
膨胀	0	1	0	1	1.0
膝下	1	0	0	1	1.0
膜	1	0	0	1	1.0
膈	1	0	0	1	1.0
腿部	1	0	0	1	1.0
腾出	0	1	0	1	1.0
腹痛	1	0	0	1	1.0
腹中	1	0	0	1	1.0
腰酸背疼	1	0	0	1	1.0
腰酸	1	0	0	1	1.0
腰疼	0	1	0	1	1.0
腰	0	1	0	1	1.0
腮	1	0	0	1	1.0
腥风血雨	0	1	0	1	1.0
腐败无能	0	1	0	1	1.0
腐蚀	0	0	1	1	1.0
腐烂	1	0	0	1	1.0
腐	1	0	0	1	1.0
腊八	0	0	1	1	1.0
脸皮	0	1	0	1	1.0
脱胎	1	0	0	1	1.0
脱离现实	1	0	0	1	1.0
脱口秀	1	0	0	1	1.0
脱口	1	0	0	1	1.0
脱不了	0	1	0	1	1.0
脚踏车	1	0	0	1	1.0
脚跟	1	0	0	1	1.0
脚底板	0	1	0	1	1.0
脚底	0	1	0	1	1.0
脑门	0	1	0	1	1.0
脑筋	1	0	0	1	1.0
脑瓜子	0	1	0	1	1.0
脑瓜	0	1	0	1	1.0
脑海	0	0	1	1	1.0
脐带血	0	0	1	1	1.0
脏话	1	0	0	1	1.0
脆弱不堪	0	1	0	1	1.0
脆弱	0	1	0	1	1.0
能见度	0	0	1	1	1.0
能见	0	0	1	1	1.0
能干	1	0	0	1	1.0
能屈能伸	1	0	0	1	1.0
能及	0	1	0	1	1.0
能力差	0	0	1	1	1.0
能伸	1	0	0	1	1.0
胡言乱语	0	1	0	1	1.0
胡言	0	1	0	1	1.0
胡	0	0	1	1	1.0
胜过	1	0	0	1	1.0
胜算	0	1	0	1	1.0
胎死腹中	1	0	0	1	1.0
胎心	0	1	0	1	1.0
背面	1	0	0	1	1.0
背负	0	1	0	1	1.0
背离	0	1	0	1	1.0
胆小	0	1	0	1	1.0
胆大妄为	0	0	1	1	1.0
胆大	0	0	1	1	1.0
胃肠道	0	0	1	1	1.0
胃肠	0	0	1	1	1.0
胃口	0	0	1	1	1.0
胃	1	0	0	1	1.0
肿	1	0	0	1	1.0
肺部	1	0	0	1	1.0
肺结核	0	1	0	1	1.0
育龄妇女	1	0	0	1	1.0
育龄	1	0	0	1	1.0
育人	0	0	1	1	1.0
肮脏	0	1	0	1	1.0
肩头	1	0	0	1	1.0
肩	1	0	0	1	1.0
肥胖	1	0	0	1	1.0
肥沃	0	0	1	1	1.0
肤色	0	0	1	1	1.0
肤浅	0	1	0	1	1.0
肢解	0	1	0	1	1.0
股子	0	1	0	1	1.0
肠道	0	0	1	1	1.0
肠粉	0	0	1	1	1.0
肝	1	0	0	1	1.0
肚脐	0	0	1	1	1.0
肚子疼	0	0	1	1	1.0
肖	1	0	0	1	1.0
肌肤	0	0	1	1	1.0
肌瘤	1	0	0	1	1.0
肌	0	0	1	1	1.0
肉桂粉	0	1	0	1	1.0
肉桂	0	1	0	1	1.0
肉丸	1	0	0	1	1.0
肉中刺	1	0	0	1	1.0
肆虐	0	0	1	1	1.0
肆意妄为	1	0	0	1	1.0
聪	0	0	1	1	1.0
聚龙	0	0	1	1	1.0
聚餐	0	0	1	1	1.0
聚散	0	0	1	1	1.0
聚在一起	0	1	0	1	1.0
聘礼	0	1	0	1	1.0
联邦区	0	0	1	1	1.0
联络	1	0	0	1	1.0
联播	0	0	1	1	1.0
联席会议	0	0	1	1	1.0
联席会	0	0	1	1	1.0
联席	0	0	1	1	1.0
联名	0	1	0	1	1.0
聒噪	0	1	0	1	1.0
职位	0	0	1	1	1.0
职业生涯	0	1	0	1	1.0
职业女性	0	1	0	1	1.0
聊起	0	0	1	1	1.0
聊聊吧	0	0	1	1	1.0
聆听	0	0	1	1	1.0
耿直	1	0	0	1	1.0
耻辱柱	0	1	0	1	1.0
耻辱	0	1	0	1	1.0
耻	0	1	0	1	1.0
耶稣	0	0	1	1	1.0
耳鸣	1	0	0	1	1.0
耳目一新	1	0	0	1	1.0
耳目	1	0	0	1	1.0
耗尽	0	0	1	1	1.0
耗	0	1	0	1	1.0
耕读	1	0	0	1	1.0
耐用度	0	0	1	1	1.0
耐不住	0	1	0	1	1.0
耍赖	1	0	0	1	1.0
耍花样	0	1	0	1	1.0
而论	1	0	0	1	1.0
考驾照	0	0	1	1	1.0
考量	1	0	0	1	1.0
考试分数	0	1	0	1	1.0
考证	0	1	0	1	1.0
考研	0	0	1	1	1.0
考生	0	0	1	1	1.0
考点	1	0	0	1	1.0
考察	1	0	0	1	1.0
考完试	1	0	0	1	1.0
考学	0	1	0	1	1.0
考取	1	0	0	1	1.0
考上	0	0	1	1	1.0
老鼠	1	0	0	1	1.0
老话	0	1	0	1	1.0
老规矩	0	0	1	1	1.0
老街	1	0	0	1	1.0
老知青	1	0	0	1	1.0
老照片	1	0	0	1	1.0
老母鸡	1	0	0	1	1.0
老母	1	0	0	1	1.0
老早	0	1	0	1	1.0
老总	0	1	0	1	1.0
老张	1	0	0	1	1.0
老弟	1	0	0	1	1.0
老巢	1	0	0	1	1.0
老姐	1	0	0	1	1.0
老头儿	0	1	0	1	1.0
老天	0	1	0	1	1.0
老大爷	0	0	1	1	1.0
老大徒伤	0	0	1	1	1.0
老处女	0	1	0	1	1.0
老哥	1	0	0	1	1.0
老周	1	0	0	1	1.0
老同学	1	0	0	1	1.0
老兄	0	0	1	1	1.0
老下	1	0	0	1	1.0
老一代	1	0	0	1	1.0
翼翼	0	0	1	1	1.0
翻身	0	0	1	1	1.0
翻白眼	1	0	0	1	1.0
翻白	1	0	0	1	1.0
翻版	1	0	0	1	1.0
翻墙	0	1	0	1	1.0
翱翔	0	1	0	1	1.0
羹	1	0	0	1	1.0
群起	1	0	0	1	1.0
群发	1	0	0	1	1.0
美誉	0	1	0	1	1.0
美猴王	1	0	0	1	1.0
美版	1	0	0	1	1.0
美梦	1	0	0	1	1.0
美景	1	0	0	1	1.0
美尔	1	0	0	1	1.0
美妙	0	1	0	1	1.0
美女	1	0	0	1	1.0
美国驻华大使馆	1	0	0	1	1.0
美国防部	0	0	1	1	1.0
美国防	0	0	1	1	1.0
美国政府	1	0	0	1	1.0
美国会	1	0	0	1	1.0
美味佳肴	1	0	0	1	1.0
署长	0	0	1	1	1.0
署名	0	0	1	1	1.0
署	0	0	1	1	1.0
置办	1	0	0	1	1.0
置于脑后	0	1	0	1	1.0
置于	0	1	0	1	1.0
置	0	1	0	1	1.0
罪魁祸首	1	0	0	1	1.0
罪魁	1	0	0	1	1.0
罪过	1	0	0	1	1.0
罪状	0	1	0	1	1.0
罪犯	1	0	0	1	1.0
罪孽	0	1	0	1	1.0
罗湖口岸	1	0	0	1	1.0
罗湖	1	0	0	1	1.0
网膜	1	0	0	1	1.0
网罗	1	0	0	1	1.0
网络图	0	1	0	1	1.0
网上商城	0	1	0	1	1.0
罐车	0	1	0	1	1.0
缺货	0	1	0	1	1.0
缺憾	1	0	0	1	1.0
缺心眼	1	0	0	1	1.0
缺德事	0	0	1	1	1.0
缺德	0	0	1	1	1.0
缺口	0	1	0	1	1.0
缺位	1	0	0	1	1.0
缴费	0	1	0	1	1.0
缴获	1	0	0	1	1.0
缩短	0	1	0	1	1.0
缩成一团	0	0	1	1	1.0
缩成	0	0	1	1	1.0
缩减	0	0	1	1	1.0
缩	0	1	0	1	1.0
缥缈	0	1	0	1	1.0
缠绕	0	1	0	1	1.0
编辑	0	0	1	1	1.0
缔约国	0	1	0	1	1.0
缔约	0	1	0	1	1.0
缓冲期	0	0	1	1	1.0
缓兵之计	0	1	0	1	1.0
缓兵	0	1	0	1	1.0
缓	1	0	0	1	1.0
缉	0	1	0	1	1.0
缄默	1	0	0	1	1.0
绿帽子	1	0	0	1	1.0
绿帽	1	0	0	1	1.0
绿城	0	1	0	1	1.0
绿化率	1	0	0	1	1.0
绿化	1	0	0	1	1.0
绽放	1	0	0	1	1.0
综合症	0	0	1	1	1.0
综合体	0	0	1	1	1.0
绸缪	0	0	1	1	1.0
维耶	1	0	0	1	1.0
维维	1	0	0	1	1.0
维权	0	1	0	1	1.0
维族	0	1	0	1	1.0
维持	1	0	0	1	1.0
维护正义	1	0	0	1	1.0
维护和平	1	0	0	1	1.0
维度	0	0	1	1	1.0
维塔利	0	0	1	1	1.0
维塔	0	0	1	1	1.0
维埃	0	1	0	1	1.0
维和	0	0	1	1	1.0
绳子	0	1	0	1	1.0
绳	0	1	0	1	1.0
继而	0	0	1	1	1.0
继续发扬	1	0	0	1	1.0
绥芬河	0	0	1	1	1.0
统统	0	1	0	1	1.0
统治者	0	1	0	1	1.0
统一标准	0	1	0	1	1.0
绞死	1	0	0	1	1.0
绞杀	1	0	0	1	1.0
绝非	1	0	0	1	1.0
绝配	1	0	0	1	1.0
绝症	0	0	1	1	1.0
绝活	1	0	0	1	1.0
绝情	0	1	0	1	1.0
绝大多数	1	0	0	1	1.0
绝后	1	0	0	1	1.0
绝伦	1	0	0	1	1.0
绝人	1	0	0	1	1.0
绝不能	1	0	0	1	1.0
络绎不绝	1	0	0	1	1.0
络绎	1	0	0	1	1.0
绚烂	0	1	0	1	1.0
给钱	0	1	0	1	1.0
绕道	1	0	0	1	1.0
结队	1	0	0	1	1.0
结舌	1	0	0	1	1.0
结结实实	0	0	1	1	1.0
结结	0	0	1	1	1.0
结盟	0	1	0	1	1.0
结核	0	1	0	1	1.0
结晶	1	0	0	1	1.0
结彩	1	0	0	1	1.0
结实	0	0	1	1	1.0
结婚年龄	0	1	0	1	1.0
结下	0	1	0	1	1.0
经销商	0	0	1	1	1.0
经销	0	0	1	1	1.0
经贸大学	1	0	0	1	1.0
经贸	1	0	0	1	1.0
经警	0	0	1	1	1.0
经营	0	0	1	1	1.0
经纪人	0	1	0	1	1.0
经管	0	1	0	1	1.0
经济负担	1	0	0	1	1.0
经济网	0	1	0	1	1.0
经济学	0	0	1	1	1.0
经济危机	0	0	1	1	1.0
经商	0	1	0	1	1.0
经受	0	0	1	1	1.0
经典之作	0	1	0	1	1.0
绊脚	1	0	0	1	1.0
终身	0	1	0	1	1.0
终生	0	0	1	1	1.0
终极	0	1	0	1	1.0
织女	1	0	0	1	1.0
细腻	1	0	0	1	1.0
细胞分裂	1	0	0	1	1.0
细胞	1	0	0	1	1.0
细心	0	0	1	1	1.0
细则	1	0	0	1	1.0
绅士	1	0	0	1	1.0
组组	0	1	0	1	1.0
组团	1	0	0	1	1.0
组件	0	0	1	1	1.0
练字	1	0	0	1	1.0
练	0	0	1	1	1.0
线香	0	1	0	1	1.0
线路	0	1	0	1	1.0
纽约	0	0	1	1	1.0
纹	1	0	0	1	1.0
纸牌	0	0	1	1	1.0
纸尿裤	1	0	0	1	1.0
纸厂	1	0	0	1	1.0
纷扰	0	0	1	1	1.0
纵队	1	0	0	1	1.0
纵观	0	0	1	1	1.0
纵火	0	1	0	1	1.0
纵欲	0	0	1	1	1.0
纵横	0	1	0	1	1.0
纳粹	1	0	0	1	1.0
纯正	1	0	0	1	1.0
纯文字	0	0	1	1	1.0
纯手工	0	0	1	1	1.0
纯净	0	1	0	1	1.0
纪录片	0	1	0	1	1.0
纪	0	1	0	1	1.0
约翰	1	0	0	1	1.0
约旦	0	0	1	1	1.0
红烧鱼	0	1	0	1	1.0
红烧	0	1	0	1	1.0
红灯笼	0	1	0	1	1.0
纠集	1	0	0	1	1.0
纠葛	1	0	0	1	1.0
繁缛	1	0	0	1	1.0
繁多	1	0	0	1	1.0
紫色	0	0	1	1	1.0
紫竹	0	0	1	1	1.0
紫丁香	1	0	0	1	1.0
紧迫性	0	0	1	1	1.0
紧迫	0	0	1	1	1.0
紧跟形势	0	0	1	1	1.0
紧要	1	0	0	1	1.0
紧绷	0	0	1	1	1.0
紧急任务	0	1	0	1	1.0
紧密	1	0	0	1	1.0
索性	1	0	0	1	1.0
素餐	1	0	0	1	1.0
素质教育	1	0	0	1	1.0
系统工程	1	0	0	1	1.0
系统升级	0	0	1	1	1.0
系数	0	1	0	1	1.0
糟透了	0	1	0	1	1.0
糟透	0	1	0	1	1.0
糟粕	0	1	0	1	1.0
糜烂	1	0	0	1	1.0
糊涂	1	0	0	1	1.0
糊口	0	1	0	1	1.0
精良	1	0	0	1	1.0
精神污染	0	1	0	1	1.0
精神文明	0	1	0	1	1.0
精神压力	1	0	0	1	1.0
精液	0	0	1	1	1.0
精心	1	0	0	1	1.0
精彩绝伦	1	0	0	1	1.0
精巧	0	1	0	1	1.0
精子	1	0	0	1	1.0
精准	1	0	0	1	1.0
精光	0	0	1	1	1.0
粮草先行	0	1	0	1	1.0
粮草	0	1	0	1	1.0
粮油	0	0	1	1	1.0
粪池	0	1	0	1	1.0
粘合剂	0	0	1	1	1.0
粘合	0	0	1	1	1.0
粒状	0	0	1	1	1.0
粒子	0	1	0	1	1.0
粉面	1	0	0	1	1.0
粉红	0	0	1	1	1.0
粉碎机	0	0	1	1	1.0
粉碎	0	0	1	1	1.0
粉尘	0	0	1	1	1.0
粉丝团	1	0	0	1	1.0
米糠	1	0	0	1	1.0
米粉	1	0	0	1	1.0
米奇	1	0	0	1	1.0
米亚	0	1	0	1	1.0
籍	1	0	0	1	1.0
篇文章	0	1	0	1	1.0
管闲事	0	0	1	1	1.0
管理权	0	1	0	1	1.0
管理局	1	0	0	1	1.0
管教	1	0	0	1	1.0
管控	0	1	0	1	1.0
管好	0	0	1	1	1.0
管不了	1	0	0	1	1.0
算进去	0	1	0	1	1.0
算进	0	1	0	1	1.0
算计	0	1	0	1	1.0
算啦	0	1	0	1	1.0
算下来	0	1	0	1	1.0
算下	0	1	0	1	1.0
简称	0	0	1	1	1.0
简易	0	1	0	1	1.0
简政放权	1	0	0	1	1.0
简政	1	0	0	1	1.0
签署	1	0	0	1	1.0
签字	0	1	0	1	1.0
签名	0	1	0	1	1.0
筹	0	0	1	1	1.0
筷子	0	0	1	1	1.0
筱	0	1	0	1	1.0
筛查	0	0	1	1	1.0
策源地	0	1	0	1	1.0
答问	0	1	0	1	1.0
答辩	1	0	0	1	1.0
等同于	1	0	0	1	1.0
等不及	1	0	0	1	1.0
笼罩着	1	0	0	1	1.0
笼罩	1	0	0	1	1.0
第四胎	0	0	1	1	1.0
第四等	0	0	1	1	1.0
第四届	1	0	0	1	1.0
第六	0	1	0	1	1.0
第五纵队	1	0	0	1	1.0
第五	1	0	0	1	1.0
第二次世界大战	0	0	1	1	1.0
第二次世	0	0	1	1	1.0
第二年	0	0	1	1	1.0
第二只	0	0	1	1	1.0
第二代	0	0	1	1	1.0
第三胎	1	0	0	1	1.0
第三期	1	0	0	1	1.0
第三个	0	0	1	1	1.0
第一集	0	0	1	1	1.0
第一期	1	0	0	1	1.0
第一声	0	1	0	1	1.0
第一台	1	0	0	1	1.0
第一句	1	0	0	1	1.0
第一例	0	0	1	1	1.0
第一代	0	1	0	1	1.0
笫	0	1	0	1	1.0
符拉迪沃斯托克	0	1	0	1	1.0
符拉迪	0	1	0	1	1.0
符合规定	1	0	0	1	1.0
符	0	0	1	1	1.0
笑脸	1	0	0	1	1.0
笑死人	1	0	0	1	1.0
笋	1	0	0	1	1.0
竿子	0	0	1	1	1.0
竹板	1	0	0	1	1.0
端机	0	0	1	1	1.0
童鞋	0	1	0	1	1.0
章法	0	1	0	1	1.0
竟是	0	0	1	1	1.0
竞猜	0	1	0	1	1.0
竞折腰	0	0	1	1	1.0
竞争力	1	0	0	1	1.0
站队	0	1	0	1	1.0
站稳脚跟	1	0	0	1	1.0
站稳	1	0	0	1	1.0
站不住脚	1	0	0	1	1.0
站不住	1	0	0	1	1.0
立面	0	1	0	1	1.0
立足	1	0	0	1	1.0
立法者	0	1	0	1	1.0
立法法	0	1	0	1	1.0
立案	0	1	0	1	1.0
立方米	0	0	1	1	1.0
立方	0	0	1	1	1.0
窦	0	1	0	1	1.0
窝	0	1	0	1	1.0
窘迫	1	0	0	1	1.0
窘困	0	1	0	1	1.0
窗帘	0	0	1	1	1.0
窒息	0	1	0	1	1.0
窑湾	0	1	0	1	1.0
窄	0	1	0	1	1.0
窃案	0	0	1	1	1.0
窃喜	0	1	0	1	1.0
窃取	0	0	1	1	1.0
突突突	1	0	0	1	1.0
突突	1	0	0	1	1.0
突围	0	1	0	1	1.0
突变	0	1	0	1	1.0
突	1	0	0	1	1.0
穿帮	1	0	0	1	1.0
空隙	0	1	0	1	1.0
空跑	1	0	0	1	1.0
空虚	1	0	0	1	1.0
空腹	0	0	1	1	1.0
空洞	1	0	0	1	1.0
空气清新	0	1	0	1	1.0
空档	1	0	0	1	1.0
空旷	1	0	0	1	1.0
空文	1	0	0	1	1.0
空城计	0	0	1	1	1.0
空城	0	0	1	1	1.0
空前绝后	1	0	0	1	1.0
空前	1	0	0	1	1.0
空出	0	1	0	1	1.0
穷苦	0	1	0	1	1.0
究其	0	1	0	1	1.0
穆斯塔法	1	0	0	1	1.0
穆	1	0	0	1	1.0
稿费	1	0	0	1	1.0
稻草	0	1	0	1	1.0
稳稳	0	0	1	1	1.0
稳扎稳打	1	0	0	1	1.0
稳扎	1	0	0	1	1.0
稳定性	1	0	0	1	1.0
稳准狠	0	1	0	1	1.0
稳住	1	0	0	1	1.0
稍有不慎	0	1	0	1	1.0
稀缺	1	0	0	1	1.0
稀少	0	1	0	1	1.0
移民	0	0	1	1	1.0
移植	0	1	0	1	1.0
移	0	1	0	1	1.0
称呼	0	0	1	1	1.0
称号	1	0	0	1	1.0
称之为	0	1	0	1	1.0
积累	1	0	0	1	1.0
积淀	0	0	1	1	1.0
秩序井然	0	1	0	1	1.0
秦皇岛市	1	0	0	1	1.0
租赁	0	0	1	1	1.0
租房	0	1	0	1	1.0
租	0	0	1	1	1.0
秘书	1	0	0	1	1.0
秒钟	0	0	1	1	1.0
科级	0	1	0	1	1.0
科巴	1	0	0	1	1.0
种类	0	1	0	1	1.0
秋天	1	0	0	1	1.0
秃子	1	0	0	1	1.0
秃	0	1	0	1	1.0
私车	1	0	0	1	1.0
私有制	0	1	0	1	1.0
私有	0	1	0	1	1.0
私心	0	1	0	1	1.0
私囊	0	1	0	1	1.0
私刑	1	0	0	1	1.0
私企	0	1	0	1	1.0
私	1	0	0	1	1.0
秀美	1	0	0	1	1.0
秀气	1	0	0	1	1.0
离间	1	0	0	1	1.0
离谱	0	1	0	1	1.0
离职	0	1	0	1	1.0
离线	0	0	1	1	1.0
离析	1	0	0	1	1.0
离家近	1	0	0	1	1.0
离婚率	0	1	0	1	1.0
福龙	1	0	0	1	1.0
福音	1	0	0	1	1.0
福祉	1	0	0	1	1.0
福田区	1	0	0	1	1.0
福州市	0	1	0	1	1.0
禁锢	0	1	0	1	1.0
禁绝	0	1	0	1	1.0
禁烟	1	0	0	1	1.0
禁止令	1	0	0	1	1.0
禁放令	1	0	0	1	1.0
禁完	0	1	0	1	1.0
祸首	1	0	0	1	1.0
祭神	1	0	0	1	1.0
祭祀	0	1	0	1	1.0
祭扫	0	1	0	1	1.0
祭奠	0	1	0	1	1.0
祭	1	0	0	1	1.0
票	1	0	0	1	1.0
祥瑞	1	0	0	1	1.0
祥云	0	0	1	1	1.0
祥	1	0	0	1	1.0
祠堂	1	0	0	1	1.0
神采奕奕	1	0	0	1	1.0
神采	1	0	0	1	1.0
神经系统	0	1	0	1	1.0
神经系	0	1	0	1	1.0
神经病	0	0	1	1	1.0
神秘	1	0	0	1	1.0
神明	1	0	0	1	1.0
神州大地	1	0	0	1	1.0
神州	1	0	0	1	1.0
神学院	0	0	1	1	1.0
神圣不可	0	1	0	1	1.0
神圣	0	1	0	1	1.0
神似	1	0	0	1	1.0
祝福语	1	0	0	1	1.0
祝您	0	1	0	1	1.0
祈福	1	0	0	1	1.0
祈求	0	1	0	1	1.0
祈	1	0	0	1	1.0
社群	1	0	0	1	1.0
社火	1	0	0	1	1.0
社戏	1	0	0	1	1.0
社会主义	0	1	0	1	1.0
社交	0	0	1	1	1.0
礼节	1	0	0	1	1.0
礼拜六	0	0	1	1	1.0
礼品	0	1	0	1	1.0
礼俗	1	0	0	1	1.0
礼仪	1	0	0	1	1.0
示意	1	0	0	1	1.0
示弱	0	1	0	1	1.0
示好	0	1	0	1	1.0
磨叽	0	0	1	1	1.0
磨	1	0	0	1	1.0
磕碰	1	0	0	1	1.0
磕头	1	0	0	1	1.0
磐	1	0	0	1	1.0
磊磊	0	0	1	1	1.0
磊	0	0	1	1	1.0
碧海	0	0	1	1	1.0
碧水	0	1	0	1	1.0
碎了心	0	1	0	1	1.0
碍事	1	0	0	1	1.0
确无	0	1	0	1	1.0
确切	1	0	0	1	1.0
确保安全	1	0	0	1	1.0
硬道理	0	1	0	1	1.0
硬盘	1	0	0	1	1.0
硬生生	1	0	0	1	1.0
硬度	0	0	1	1	1.0
硬地	0	1	0	1	1.0
硫磺	0	1	0	1	1.0
硫化氢	0	1	0	1	1.0
硫化	0	1	0	1	1.0
硅胶	0	0	1	1	1.0
破碎	0	1	0	1	1.0
破口大骂	1	0	0	1	1.0
破口	1	0	0	1	1.0
破例	0	1	0	1	1.0
砲	0	1	0	1	1.0
砰	1	0	0	1	1.0
砝码	0	0	1	1	1.0
研究所	0	1	0	1	1.0
研究会	0	1	0	1	1.0
研发	0	1	0	1	1.0
砍头	1	0	0	1	1.0
砍	0	1	0	1	1.0
码头	0	0	1	1	1.0
码	1	0	0	1	1.0
石油价格	0	1	0	1	1.0
石榴	1	0	0	1	1.0
短距离	0	1	0	1	1.0
短距	0	1	0	1	1.0
短篇小说	1	0	0	1	1.0
短篇	1	0	0	1	1.0
短片	0	0	1	1	1.0
短消息	0	1	0	1	1.0
短波	1	0	0	1	1.0
短期内	0	1	0	1	1.0
短时期	0	1	0	1	1.0
短命	0	1	0	1	1.0
知音	1	0	0	1	1.0
知青	1	0	0	1	1.0
知多少	1	0	0	1	1.0
知书达礼	0	1	0	1	1.0
矛盾激化	0	1	0	1	1.0
瞳孔放大	1	0	0	1	1.0
瞳孔	1	0	0	1	1.0
瞪	1	0	0	1	1.0
瞠目结舌	1	0	0	1	1.0
瞠目	1	0	0	1	1.0
瞎话	0	1	0	1	1.0
瞎眼	1	0	0	1	1.0
瞎搞	0	1	0	1	1.0
瞎指挥	0	1	0	1	1.0
瞎扯	1	0	0	1	1.0
瞎了眼	0	1	0	1	1.0
瞅	1	0	0	1	1.0
睿智	0	0	1	1	1.0
睽睽	0	1	0	1	1.0
睹	1	0	0	1	1.0
睡美人	1	0	0	1	1.0
睡着	0	0	1	1	1.0
睡懒觉	1	0	0	1	1.0
睁眼	0	1	0	1	1.0
睁开眼睛	0	1	0	1	1.0
睁开眼	0	1	0	1	1.0
睁开	0	1	0	1	1.0
睁一只眼	1	0	0	1	1.0
睁	1	0	0	1	1.0
着落	1	0	0	1	1.0
着眼	1	0	0	1	1.0
着实	0	1	0	1	1.0
眼罩	0	1	0	1	1.0
眼瞎	0	1	0	1	1.0
眼皮	0	1	0	1	1.0
眼珠子	1	0	0	1	1.0
眼珠	1	0	0	1	1.0
眼压	1	0	0	1	1.0
眼前一亮	1	0	0	1	1.0
眼光	0	1	0	1	1.0
眼不见	0	1	0	1	1.0
眯眼	0	1	0	1	1.0
眯眯眼	0	1	0	1	1.0
眨眼	1	0	0	1	1.0
眨	1	0	0	1	1.0
真诚	0	1	0	1	1.0
真让人	0	1	0	1	1.0
真累	0	1	0	1	1.0
真的假	0	0	1	1	1.0
真理	0	1	0	1	1.0
真是太	0	0	1	1	1.0
真想念	1	0	0	1	1.0
真性情	0	0	1	1	1.0
真性	0	0	1	1	1.0
真差	0	0	1	1	1.0
真对不起	0	1	0	1	1.0
真对	0	1	0	1	1.0
真好玩	0	1	0	1	1.0
真好	0	1	0	1	1.0
真可笑	1	0	0	1	1.0
真受不了	0	0	1	1	1.0
真切感	0	1	0	1	1.0
真切	0	1	0	1	1.0
真假难辨	0	1	0	1	1.0
真假	0	1	0	1	1.0
真不知道	1	0	0	1	1.0
看透	0	1	0	1	1.0
看穿	0	1	0	1	1.0
看病难	1	0	0	1	1.0
看病贵	1	0	0	1	1.0
看热闹	0	1	0	1	1.0
看点	0	0	1	1	1.0
看清楚	1	0	0	1	1.0
看清	1	0	0	1	1.0
看淡	0	0	1	1	1.0
看护	0	1	0	1	1.0
看得见	0	1	0	1	1.0
看得	0	1	0	1	1.0
看客	1	0	0	1	1.0
看中	1	0	0	1	1.0
看不起	0	1	0	1	1.0
看不见	1	0	0	1	1.0
看不清	0	1	0	1	1.0
看不得	0	0	1	1	1.0
看不下去	1	0	0	1	1.0
眉毛	0	1	0	1	1.0
省得	1	0	0	1	1.0
省委	1	0	0	1	1.0
省内	1	0	0	1	1.0
相隔	1	0	0	1	1.0
相逢	0	1	0	1	1.0
相近	1	0	0	1	1.0
相继问世	0	0	1	1	1.0
相约	0	1	0	1	1.0
相符	1	0	0	1	1.0
相片	1	0	0	1	1.0
相残	0	1	0	1	1.0
相投	0	1	0	1	1.0
相悖	0	0	1	1	1.0
相夫教子	0	1	0	1	1.0
相夫	0	1	0	1	1.0
相像	0	0	1	1	1.0
相似	0	0	1	1	1.0
相亲相爱	1	0	0	1	1.0
相互间	0	0	1	1	1.0
相争	0	0	1	1	1.0
直营店	0	0	1	1	1.0
直营	0	0	1	1	1.0
直线	0	1	0	1	1.0
直管	0	1	0	1	1.0
直立	0	1	0	1	1.0
直播	0	0	1	1	1.0
直指	0	1	0	1	1.0
直径	1	0	0	1	1.0
直到现在	0	0	1	1	1.0
盲目攀比	0	1	0	1	1.0
盲目	0	1	0	1	1.0
盲	0	1	0	1	1.0
盟国	1	0	0	1	1.0
盛开	1	0	0	1	1.0
盛事	0	0	1	1	1.0
盛	0	0	1	1	1.0
盘古	0	1	0	1	1.0
盘	1	0	0	1	1.0
盗窃案	0	0	1	1	1.0
盗窃	0	0	1	1	1.0
盗匪	0	0	1	1	1.0
盗	0	0	1	1	1.0
盖世	0	0	1	1	1.0
盒子	0	0	1	1	1.0
盒	0	0	1	1	1.0
监视	0	1	0	1	1.0
监管部门	0	1	0	1	1.0
监管部	0	1	0	1	1.0
监管局	0	0	1	1	1.0
监禁	1	0	0	1	1.0
监测点	0	1	0	1	1.0
监控	0	1	0	1	1.0
监事会	1	0	0	1	1.0
监事	1	0	0	1	1.0
监	0	1	0	1	1.0
盐官	1	0	0	1	1.0
盐城	0	0	1	1	1.0
益州	0	1	0	1	1.0
益	0	0	1	1	1.0
盈利	0	0	1	1	1.0
盈	1	0	0	1	1.0
盆地	0	1	0	1	1.0
皇帝	0	1	0	1	1.0
皇上	1	0	0	1	1.0
百遍	0	1	0	1	1.0
百越	0	1	0	1	1.0
百米	1	0	0	1	1.0
百态	0	0	1	1	1.0
百家	1	0	0	1	1.0
百多年	0	1	0	1	1.0
百六	1	0	0	1	1.0
百元	0	0	1	1	1.0
百事	0	1	0	1	1.0
白骨精	1	0	0	1	1.0
白骨	1	0	0	1	1.0
白领	1	0	0	1	1.0
白银	0	1	0	1	1.0
白衣	1	0	0	1	1.0
白菜	1	0	0	1	1.0
白胡子	0	0	1	1	1.0
白猫	0	1	0	1	1.0
白沙瓦	0	0	1	1	1.0
白沙	0	0	1	1	1.0
白旗	0	1	0	1	1.0
白带	0	0	1	1	1.0
白岩松	0	1	0	1	1.0
白宫	0	1	0	1	1.0
白事	1	0	0	1	1.0
登山	1	0	0	1	1.0
登场	1	0	0	1	1.0
癖	0	0	1	1	1.0
瘴气	0	1	0	1	1.0
瘫	0	0	1	1	1.0
瘢痕	1	0	0	1	1.0
痛骂	0	1	0	1	1.0
痛经	0	1	0	1	1.0
痛痒	1	0	0	1	1.0
痛楚	1	0	0	1	1.0
痛斥	1	0	0	1	1.0
痛快	0	0	1	1	1.0
痛心	0	1	0	1	1.0
痛处	1	0	0	1	1.0
痘痘	1	0	0	1	1.0
症结	0	1	0	1	1.0
症	0	1	0	1	1.0
病猫	1	0	0	1	1.0
病患者	0	0	1	1	1.0
病患	0	0	1	1	1.0
病急	0	0	1	1	1.0
病态	0	1	0	1	1.0
病因	0	1	0	1	1.0
病友	0	0	1	1	1.0
疾	1	0	0	1	1.0
疼爱	1	0	0	1	1.0
疲软	0	0	1	1	1.0
疲劳	0	0	1	1	1.0
疲于	1	0	0	1	1.0
疲乏	1	0	0	1	1.0
疯狗	0	1	0	1	1.0
疑点	0	1	0	1	1.0
疏于	0	1	0	1	1.0
疆	1	0	0	1	1.0
番邦	0	0	1	1	1.0
番	0	1	0	1	1.0
略有	0	0	1	1	1.0
留给	0	1	0	1	1.0
留校	1	0	0	1	1.0
留影	0	1	0	1	1.0
畏惧	1	0	0	1	1.0
界定	0	0	1	1	1.0
界	1	0	0	1	1.0
畅通	1	0	0	1	1.0
畅所欲言	0	0	1	1	1.0
畅	1	0	0	1	1.0
男青年	0	1	0	1	1.0
男方	0	0	1	1	1.0
男孩子	1	0	0	1	1.0
男士	1	0	0	1	1.0
男团	1	0	0	1	1.0
男友	0	0	1	1	1.0
电路	1	0	0	1	1.0
电灯泡	0	0	1	1	1.0
电流	0	1	0	1	1.0
电报	0	0	1	1	1.0
电影界	0	0	1	1	1.0
电子警察	1	0	0	1	1.0
电子版	1	0	0	1	1.0
电商	0	0	1	1	1.0
电台	1	0	0	1	1.0
电压	0	0	1	1	1.0
电动汽车	0	1	0	1	1.0
电动机	0	0	1	1	1.0
申遗	1	0	0	1	1.0
甲醛	1	0	0	1	1.0
甲	0	0	1	1	1.0
由此而来	0	0	1	1	1.0
由来已久	1	0	0	1	1.0
由来	1	0	0	1	1.0
由不得	1	0	0	1	1.0
田间	0	1	0	1	1.0
田	0	0	1	1	1.0
甭说	0	1	0	1	1.0
甭管	1	0	0	1	1.0
甬	1	0	0	1	1.0
甩	1	0	0	1	1.0
用钱	0	1	0	1	1.0
用者	0	1	0	1	1.0
用来用去	0	1	0	1	1.0
用户群	0	0	1	1	1.0
用尽	0	0	1	1	1.0
用品	1	0	0	1	1.0
用去	0	1	0	1	1.0
用力	0	1	0	1	1.0
用兵	0	0	1	1	1.0
用作	1	0	0	1	1.0
用以	1	0	0	1	1.0
用人单位	0	1	0	1	1.0
用不着	0	1	0	1	1.0
用不完	0	1	0	1	1.0
生贵子	0	0	1	1	1.0
生肖	1	0	0	1	1.0
生病	0	0	1	1	1.0
生生死死	0	1	0	1	1.0
生理需求	0	1	0	1	1.0
生理期	0	1	0	1	1.0
生物链	0	0	1	1	1.0
生灵	1	0	0	1	1.0
生源	0	1	0	1	1.0
生涯	0	1	0	1	1.0
生活节奏	0	1	0	1	1.0
生水	0	1	0	1	1.0
生死未卜	0	1	0	1	1.0
生日礼物	1	0	0	1	1.0
生怕	0	0	1	1	1.0
生态系统	0	0	1	1	1.0
生态系	0	0	1	1	1.0
生存空间	0	1	0	1	1.0
生姜	1	0	0	1	1.0
生命财产	0	1	0	1	1.0
生命安全	1	0	0	1	1.0
生命危险	0	1	0	1	1.0
生前	1	0	0	1	1.0
生出	1	0	0	1	1.0
生产成本	0	1	0	1	1.0
生事	0	0	1	1	1.0
甜食	0	0	1	1	1.0
甜甜	1	0	0	1	1.0
甚或	0	0	1	1	1.0
甚	1	0	0	1	1.0
甘美	0	0	1	1	1.0
甘地	0	1	0	1	1.0
甘	0	1	0	1	1.0
瓷	1	0	0	1	1.0
瓶装	0	1	0	1	1.0
瓶	1	0	0	1	1.0
瓦解	0	1	0	1	1.0
瓦良格	1	0	0	1	1.0
瓦尔德纳	0	1	0	1	1.0
瓦尔德	0	1	0	1	1.0
瓦尔	0	1	0	1	1.0
瓦伦西亚	1	0	0	1	1.0
瓦伦西	1	0	0	1	1.0
瓜子	0	1	0	1	1.0
瑾	1	0	0	1	1.0
瑞雪兆丰年	1	0	0	1	1.0
瑞雪兆	1	0	0	1	1.0
瑞	0	1	0	1	1.0
瑜伽	0	1	0	1	1.0
瑕	1	0	0	1	1.0
琴	0	0	1	1	1.0
琮	1	0	0	1	1.0
理赔	0	0	1	1	1.0
理论	1	0	0	1	1.0
理睬	0	1	0	1	1.0
理应	1	0	0	1	1.0
理学	0	0	1	1	1.0
理喻	1	0	0	1	1.0
理合	0	0	1	1	1.0
理事会	1	0	0	1	1.0
球场	0	0	1	1	1.0
班车	0	0	1	1	1.0
班费	1	0	0	1	1.0
班级	0	0	1	1	1.0
班子	0	1	0	1	1.0
珠海	1	0	0	1	1.0
珠子	1	0	0	1	1.0
珠光	1	0	0	1	1.0
珍贵	1	0	0	1	1.0
珍珠	1	0	0	1	1.0
现货	0	0	1	1	1.0
现行政策	0	1	0	1	1.0
现政府	0	1	0	1	1.0
现成	0	1	0	1	1.0
现场报道	0	0	1	1	1.0
现出	1	0	0	1	1.0
现况	1	0	0	1	1.0
现任	0	1	0	1	1.0
现代文明	0	1	0	1	1.0
现代文	0	1	0	1	1.0
现代战争	1	0	0	1	1.0
现代化	1	0	0	1	1.0
现代人	0	0	1	1	1.0
现今	0	1	0	1	1.0
环路	1	0	0	1	1.0
环线	0	1	0	1	1.0
环生	1	0	0	1	1.0
环境质量	0	0	1	1	1.0
环境监测	0	0	1	1	1.0
环境保护局	0	0	1	1	1.0
环保网	0	1	0	1	1.0
玫瑰色	0	1	0	1	1.0
玩闹	1	0	0	1	1.0
玩火	1	0	0	1	1.0
玩法	1	0	0	1	1.0
玩偶	1	0	0	1	1.0
玩伴	1	0	0	1	1.0
玩乐	1	0	0	1	1.0
王者	1	0	0	1	1.0
王明	0	1	0	1	1.0
王子	0	1	0	1	1.0
王女士	0	1	0	1	1.0
王大夫	0	1	0	1	1.0
玉龙	0	0	1	1	1.0
率先	0	1	0	1	1.0
猴王	1	0	0	1	1.0
献身	0	0	1	1	1.0
献上	1	0	0	1	1.0
献	1	0	0	1	1.0
猫腻	0	1	0	1	1.0
猫猫	0	1	0	1	1.0
猪脑子	0	1	0	1	1.0
猪脑	0	1	0	1	1.0
猪仔	0	1	0	1	1.0
猜猜	1	0	0	1	1.0
猜想	0	1	0	1	1.0
猜中	0	1	0	1	1.0
猛击	1	0	0	1	1.0
猛兽	0	0	1	1	1.0
猖獗	1	0	0	1	1.0
狼藉	0	0	1	1	1.0
狮子会	0	1	0	1	1.0
狭路相逢	0	1	0	1	1.0
狭路	0	1	0	1	1.0
独钟	0	1	0	1	1.0
独身	0	1	0	1	1.0
独行	0	1	0	1	1.0
独立性	1	0	0	1	1.0
独立思考	1	0	0	1	1.0
独白	0	1	0	1	1.0
独生子女证	0	1	0	1	1.0
独生女	0	1	0	1	1.0
独木桥	0	1	0	1	1.0
独木	0	1	0	1	1.0
独有	1	0	0	1	1.0
独断	0	1	0	1	1.0
独子	0	0	1	1	1.0
独善其身	0	0	1	1	1.0
独善	0	0	1	1	1.0
独占	1	0	0	1	1.0
狡辩	0	1	0	1	1.0
狡猾	1	0	0	1	1.0
狠辣	1	0	0	1	1.0
狗贼	1	0	0	1	1.0
狗血	1	0	0	1	1.0
狗肉	0	1	0	1	1.0
狗屎	0	0	1	1	1.0
狗咬狗	0	1	0	1	1.0
狄	0	1	0	1	1.0
狂轰滥炸	0	1	0	1	1.0
狂舞	0	1	0	1	1.0
犹新	1	0	0	1	1.0
状告	1	0	0	1	1.0
状	1	0	0	1	1.0
犯罪活动	1	0	0	1	1.0
犯人	0	0	1	1	1.0
犬科	1	0	0	1	1.0
犬	0	1	0	1	1.0
特辑	1	0	0	1	1.0
特设	0	1	0	1	1.0
特斯拉	1	0	0	1	1.0
特斯	1	0	0	1	1.0
特效	0	0	1	1	1.0
特意	0	0	1	1	1.0
特工	0	0	1	1	1.0
特大城市	0	0	1	1	1.0
特大	0	0	1	1	1.0
特写	0	0	1	1	1.0
牵挂	1	0	0	1	1.0
牵扯	0	0	1	1	1.0
牵强	0	1	0	1	1.0
牵动	0	1	0	1	1.0
牵出去	1	0	0	1	1.0
牵出	1	0	0	1	1.0
牵	1	0	0	1	1.0
牲口	0	0	1	1	1.0
物种	0	0	1	1	1.0
物流业	1	0	0	1	1.0
物极必反	1	0	0	1	1.0
物排放	0	0	1	1	1.0
物件	1	0	0	1	1.0
牧羊犬	1	0	0	1	1.0
牧羊	1	0	0	1	1.0
牢骚	1	0	0	1	1.0
牢牢	0	1	0	1	1.0
牢房	0	1	0	1	1.0
牢	0	1	0	1	1.0
牡丹江	0	0	1	1	1.0
牡丹	0	0	1	1	1.0
牛郎织女	1	0	0	1	1.0
牛车	0	1	0	1	1.0
牛气	1	0	0	1	1.0
牛排	0	1	0	1	1.0
牛奶	1	0	0	1	1.0
版面	0	1	0	1	1.0
片子	0	1	0	1	1.0
片区	1	0	0	1	1.0
爷们儿	1	0	0	1	1.0
父母官	0	1	0	1	1.0
父母亲	1	0	0	1	1.0
父亲节	1	0	0	1	1.0
爱管闲事	0	0	1	1	1.0
爱祖国	0	1	0	1	1.0
爱犬	0	0	1	1	1.0
爱戴	1	0	0	1	1.0
爱意	0	1	0	1	1.0
爱惜	1	0	0	1	1.0
爱幼	1	0	0	1	1.0
爱好和平	1	0	0	1	1.0
爱哭	1	0	0	1	1.0
爱人	1	0	0	1	1.0
爱乐维	1	0	0	1	1.0
爱乐	1	0	0	1	1.0
爱不释手	1	0	0	1	1.0
爱不释	1	0	0	1	1.0
爱不爱	1	0	0	1	1.0
爬山	1	0	0	1	1.0
爆炸案	0	0	1	1	1.0
爆炸声	0	1	0	1	1.0
爆满	0	1	0	1	1.0
爆出	0	0	1	1	1.0
燎原	0	1	0	1	1.0
燃气	0	0	1	1	1.0
熬过	1	0	0	1	1.0
熬	0	0	1	1	1.0
熟饭	1	0	0	1	1.0
熟烂	1	0	0	1	1.0
熟人	1	0	0	1	1.0
熄	0	1	0	1	1.0
煽风点火	1	0	0	1	1.0
煽情	1	0	0	1	1.0
照着	1	0	0	1	1.0
照看	0	1	0	1	1.0
照料	1	0	0	1	1.0
照搬	0	1	0	1	1.0
照应	1	0	0	1	1.0
照常	0	1	0	1	1.0
煤场	0	0	1	1	1.0
煤仓	0	1	0	1	1.0
煞有其事	1	0	0	1	1.0
焦点访谈	0	0	1	1	1.0
焦	1	0	0	1	1.0
焚尸炉	0	1	0	1	1.0
焚尸	0	1	0	1	1.0
烹	0	0	1	1	1.0
热销	0	0	1	1	1.0
热肠	0	1	0	1	1.0
热络	0	0	1	1	1.0
热爱祖国	0	1	0	1	1.0
热烈祝贺	1	0	0	1	1.0
热烈响应	0	1	0	1	1.0
热情	0	1	0	1	1.0
热心	1	0	0	1	1.0
热度	0	1	0	1	1.0
热卖	0	0	1	1	1.0
烧煤	1	0	0	1	1.0
烧烤	1	0	0	1	1.0
烧死	0	1	0	1	1.0
烧柴	1	0	0	1	1.0
烧杀抢掠	0	1	0	1	1.0
烧杀	0	1	0	1	1.0
烧掉	1	0	0	1	1.0
烧伤	0	1	0	1	1.0
烦死人	1	0	0	1	1.0
烤火	0	1	0	1	1.0
烟雾弥漫	0	0	1	1	1.0
烟花节	0	0	1	1	1.0
烟瘴	0	1	0	1	1.0
烟头	0	1	0	1	1.0
烟台	1	0	0	1	1.0
烟	0	1	0	1	1.0
烛台	1	0	0	1	1.0
烘	1	0	0	1	1.0
烈烈	1	0	0	1	1.0
烂透	0	1	0	1	1.0
烂泥	0	1	0	1	1.0
点错	1	0	0	1	1.0
点钟	0	1	0	1	1.0
点评	0	1	0	1	1.0
点破	0	1	0	1	1.0
点着	1	0	0	1	1.0
点滴	0	1	0	1	1.0
点子	0	0	1	1	1.0
点头	1	0	0	1	1.0
炸锅	0	1	0	1	1.0
炸药	1	0	0	1	1.0
炸毁	1	0	0	1	1.0
炮灰	0	1	0	1	1.0
炮火连天	0	1	0	1	1.0
炮火	0	1	0	1	1.0
炮声隆隆	1	0	0	1	1.0
炮响	1	0	0	1	1.0
炮击	1	0	0	1	1.0
炮兵	0	1	0	1	1.0
炮仗	0	0	1	1	1.0
炭	0	1	0	1	1.0
炫耀	0	1	0	1	1.0
炜	0	1	0	1	1.0
炕	1	0	0	1	1.0
炎黄	0	1	0	1	1.0
炎症	1	0	0	1	1.0
灿	1	0	0	1	1.0
灾祸	0	0	1	1	1.0
灾区	1	0	0	1	1.0
灶	0	0	1	1	1.0
灵芝	0	0	1	1	1.0
灵活性	1	0	0	1	1.0
灵敏	0	0	1	1	1.0
灵巧	0	0	1	1	1.0
灵宝	0	1	0	1	1.0
灰色收入	0	1	0	1	1.0
灯火	1	0	0	1	1.0
灯泡	0	0	1	1	1.0
灭绝人性	1	0	0	1	1.0
灭国	0	0	1	1	1.0
火鸡	1	0	0	1	1.0
火车站	0	0	1	1	1.0
火警	0	1	0	1	1.0
火苗	1	0	0	1	1.0
火祭	1	0	0	1	1.0
火热	0	0	1	1	1.0
火炮	0	1	0	1	1.0
火灾事故	0	1	0	1	1.0
火旺	1	0	0	1	1.0
火并	0	1	0	1	1.0
火上浇油	0	1	0	1	1.0
灌	0	0	1	1	1.0
濮	0	1	0	1	1.0
激进	1	0	0	1	1.0
激情	1	0	0	1	1.0
激发	1	0	0	1	1.0
激励	0	1	0	1	1.0
澳洲	1	0	0	1	1.0
澳	1	0	0	1	1.0
澧	0	1	0	1	1.0
澥	0	1	0	1	1.0
潮红	0	1	0	1	1.0
潮汕	0	0	1	1	1.0
潮州	1	0	0	1	1.0
潜藏着	0	0	1	1	1.0
潜藏	0	0	1	1	1.0
潜意识	0	1	0	1	1.0
潜在用户	0	1	0	1	1.0
潜在	0	1	0	1	1.0
潜力	1	0	0	1	1.0
潜入	0	0	1	1	1.0
潜伏	0	0	1	1	1.0
潍坊市	1	0	0	1	1.0
潇洒	1	0	0	1	1.0
漯河	0	1	0	1	1.0
漫漫	1	0	0	1	1.0
漫天	0	1	0	1	1.0
漫	0	1	0	1	1.0
漩涡	0	0	1	1	1.0
漠河	0	0	1	1	1.0
漠北	0	1	0	1	1.0
演绎	0	0	1	1	1.0
演着	1	0	0	1	1.0
演技派	0	0	1	1	1.0
演技	0	0	1	1	1.0
演唱会	1	0	0	1	1.0
演员	1	0	0	1	1.0
演出	1	0	0	1	1.0
漆	0	0	1	1	1.0
漂游	1	0	0	1	1.0
滴滴	1	0	0	1	1.0
滴水	0	1	0	1	1.0
滩	0	1	0	1	1.0
滨	1	0	0	1	1.0
滥用	0	1	0	1	1.0
滥杀无辜	0	1	0	1	1.0
滥杀	0	1	0	1	1.0
满钻石	0	1	0	1	1.0
满足感	1	0	0	1	1.0
满清	0	1	0	1	1.0
满族	1	0	0	1	1.0
满怀豪情	1	0	0	1	1.0
满心欢喜	0	0	1	1	1.0
满心	0	0	1	1	1.0
满州国	0	1	0	1	1.0
满州	0	1	0	1	1.0
满屋	1	0	0	1	1.0
满城风雨	0	0	1	1	1.0
满地	0	1	0	1	1.0
满嘴	1	0	0	1	1.0
滞留	0	0	1	1	1.0
滚动	0	1	0	1	1.0
滚出来	1	0	0	1	1.0
滚出	1	0	0	1	1.0
滕州	0	1	0	1	1.0
滔天	0	1	0	1	1.0
滑雪	1	0	0	1	1.0
滑板车	0	0	1	1	1.0
滑板	0	0	1	1	1.0
滑	0	0	1	1	1.0
滋滋	0	1	0	1	1.0
滋养	1	0	0	1	1.0
滋事	1	0	0	1	1.0
溺毙	1	0	0	1	1.0
溺	0	1	0	1	1.0
溢价	0	0	1	1	1.0
溜溜	1	0	0	1	1.0
源远流长	0	0	1	1	1.0
源自	1	0	0	1	1.0
源源不断	0	1	0	1	1.0
源源	0	1	0	1	1.0
源地	0	1	0	1	1.0
源	1	0	0	1	1.0
湿气	0	0	1	1	1.0
湾	1	0	0	1	1.0
湛江	1	0	0	1	1.0
湛	1	0	0	1	1.0
湘江	1	0	0	1	1.0
湖州	0	1	0	1	1.0
湖口	1	0	0	1	1.0
游走	0	0	1	1	1.0
游记	0	1	0	1	1.0
游民	0	0	1	1	1.0
游子	1	0	0	1	1.0
游园	1	0	0	1	1.0
渲染	0	0	1	1	1.0
港币	0	0	1	1	1.0
港台腔	0	0	1	1	1.0
港台	0	0	1	1	1.0
温饱	0	0	1	1	1.0
温雅	0	1	0	1	1.0
温柔	0	0	1	1	1.0
温情	1	0	0	1	1.0
温度	0	0	1	1	1.0
温差	0	0	1	1	1.0
渣滓	1	0	0	1	1.0
渡过	1	0	0	1	1.0
渗透到	0	1	0	1	1.0
渗透	0	1	0	1	1.0
渔翁得利	1	0	0	1	1.0
渔翁	1	0	0	1	1.0
渐进	1	0	0	1	1.0
渐渐	1	0	0	1	1.0
清风明月	1	0	0	1	1.0
清静	0	1	0	1	1.0
清醒	0	1	0	1	1.0
清运	0	0	1	1	1.0
清脆	1	0	0	1	1.0
清白	0	1	0	1	1.0
清溪	0	1	0	1	1.0
清洁工	0	1	0	1	1.0
清汤寡水	0	1	0	1	1.0
清汤	0	1	0	1	1.0
清朝	1	0	0	1	1.0
清政府	0	1	0	1	1.0
清华大学	0	1	0	1	1.0
清净	0	1	0	1	1.0
添置	1	0	0	1	1.0
添加	1	0	0	1	1.0
添丁	0	1	0	1	1.0
淸	0	1	0	1	1.0
混血	1	0	0	1	1.0
混成	1	0	0	1	1.0
深谙	1	0	0	1	1.0
深深地	0	0	1	1	1.0
深明大义	0	1	0	1	1.0
深明	0	1	0	1	1.0
深得我心	1	0	0	1	1.0
深圳特区	1	0	0	1	1.0
深圳湾	0	0	1	1	1.0
深圳大学	0	0	1	1	1.0
深呼吸	0	0	1	1	1.0
深呼	0	0	1	1	1.0
深受	0	0	1	1	1.0
深厚	0	0	1	1	1.0
深化改革	1	0	0	1	1.0
深入人心	0	1	0	1	1.0
深入	0	1	0	1	1.0
深信	0	0	1	1	1.0
深一步	0	1	0	1	1.0
淫	1	0	0	1	1.0
淡漠	1	0	0	1	1.0
淡季	0	1	0	1	1.0
淘气	0	1	0	1	1.0
淑女	0	0	1	1	1.0
淌	1	0	0	1	1.0
淋	0	1	0	1	1.0
涪陵区	0	1	0	1	1.0
涪陵	0	1	0	1	1.0
涨起	0	1	0	1	1.0
涨价	1	0	0	1	1.0
涡	0	1	0	1	1.0
涛声	1	0	0	1	1.0
涌入	0	0	1	1	1.0
涉外	1	0	0	1	1.0
消除	1	0	0	1	1.0
消费观	0	1	0	1	1.0
消解	1	0	0	1	1.0
消散	0	1	0	1	1.0
消化	1	0	0	1	1.0
消亡	0	1	0	1	1.0
涅	1	0	0	1	1.0
涂炭生灵	1	0	0	1	1.0
涂炭	1	0	0	1	1.0
浸润	1	0	0	1	1.0
海龙	0	1	0	1	1.0
海鲜	1	0	0	1	1.0
海马	1	0	0	1	1.0
海运	0	0	1	1	1.0
海边	0	0	1	1	1.0
海空	1	0	0	1	1.0
海燕	1	0	0	1	1.0
海滨	0	1	0	1	1.0
海涛	1	0	0	1	1.0
海拔	1	0	0	1	1.0
海岸	0	0	1	1	1.0
海宁市	1	0	0	1	1.0
海宁	1	0	0	1	1.0
海外华人	1	0	0	1	1.0
海城	1	0	0	1	1.0
海地	0	0	1	1	1.0
海口市	0	0	1	1	1.0
海口	0	0	1	1	1.0
海南	0	1	0	1	1.0
海关	0	1	0	1	1.0
海事	1	0	0	1	1.0
海之滨	0	0	1	1	1.0
浮动	0	1	0	1	1.0
浮云	1	0	0	1	1.0
浪漫	1	0	0	1	1.0
浪尖	0	1	0	1	1.0
浩特	0	1	0	1	1.0
浩大	1	0	0	1	1.0
浦和	0	1	0	1	1.0
浓雾	0	1	0	1	1.0
浓缩	0	1	0	1	1.0
浓烟滚滚	0	0	1	1	1.0
浓烟	0	0	1	1	1.0
浓烈	0	0	1	1	1.0
浑	0	1	0	1	1.0
浏览量	0	1	0	1	1.0
浏览器	0	0	1	1	1.0
济学	0	0	1	1	1.0
测点	0	1	0	1	1.0
浇灭	0	1	0	1	1.0
浇	0	1	0	1	1.0
浅薄	0	1	0	1	1.0
浅显	1	0	0	1	1.0
流长	0	0	1	1	1.0
流转	1	0	0	1	1.0
流经	0	1	0	1	1.0
流程	0	0	1	1	1.0
流离失所	1	0	0	1	1.0
流离	1	0	0	1	1.0
流流	0	1	0	1	1.0
流泪	0	0	1	1	1.0
流水	0	0	1	1	1.0
流感	0	1	0	1	1.0
流失	0	1	0	1	1.0
流向	1	0	0	1	1.0
流传	1	0	0	1	1.0
流人	0	0	1	1	1.0
派遣	1	0	0	1	1.0
派系	1	0	0	1	1.0
派对	0	1	0	1	1.0
派兵	1	0	0	1	1.0
活生生	0	1	0	1	1.0
活生	0	1	0	1	1.0
活现	1	0	0	1	1.0
活性	1	0	0	1	1.0
活宝	1	0	0	1	1.0
活动场所	0	1	0	1	1.0
活力	0	1	0	1	1.0
活人	0	1	0	1	1.0
洲	1	0	0	1	1.0
洪灾	0	0	1	1	1.0
洪流	0	1	0	1	1.0
洪水	0	1	0	1	1.0
洪	0	0	1	1	1.0
津市	0	1	0	1	1.0
津城	0	1	0	1	1.0
洛杉矶	1	0	0	1	1.0
洛夫	0	0	1	1	1.0
洗面奶	1	0	0	1	1.0
洗面	1	0	0	1	1.0
洗碗工	0	0	1	1	1.0
洗碗	0	0	1	1	1.0
洗牌	1	0	0	1	1.0
洗洁精	0	1	0	1	1.0
洗洁	0	1	0	1	1.0
洗头	1	0	0	1	1.0
洗劫	0	0	1	1	1.0
洒	0	0	1	1	1.0
洋火	0	0	1	1	1.0
洋溢着	1	0	0	1	1.0
洋溢	1	0	0	1	1.0
洋洋自得	0	0	1	1	1.0
洋教	1	0	0	1	1.0
洁尔阴	0	1	0	1	1.0
泼水节	0	1	0	1	1.0
泼水	0	1	0	1	1.0
泼	0	1	0	1	1.0
泱泱大国	1	0	0	1	1.0
泱泱	1	0	0	1	1.0
泰山	0	1	0	1	1.0
泰安	0	0	1	1	1.0
泰国	1	0	0	1	1.0
泯灭	0	1	0	1	1.0
泪花	1	0	0	1	1.0
泪	0	0	1	1	1.0
注重	1	0	0	1	1.0
注明	0	0	1	1	1.0
注射	0	1	0	1	1.0
注定	0	0	1	1	1.0
注册	0	0	1	1	1.0
注	1	0	0	1	1.0
泥人	0	0	1	1	1.0
波斯	1	0	0	1	1.0
泡泡	0	0	1	1	1.0
泡沫经济	0	1	0	1	1.0
泡沫	0	1	0	1	1.0
泡汤	1	0	0	1	1.0
泛黄	0	1	0	1	1.0
泛	1	0	0	1	1.0
法理学	0	0	1	1	1.0
法理	0	0	1	1	1.0
法政	0	1	0	1	1.0
法庭	0	1	0	1	1.0
法师	0	0	1	1	1.0
法学院	0	0	1	1	1.0
法学	0	0	1	1	1.0
法制宣传	0	0	1	1	1.0
泌乳素	1	0	0	1	1.0
泌乳	1	0	0	1	1.0
泉州	1	0	0	1	1.0
沿用	0	1	0	1	1.0
沿海地区	0	0	1	1	1.0
沿海	0	0	1	1	1.0
沿岸	0	0	1	1	1.0
沽名钓誉	1	0	0	1	1.0
沽名	1	0	0	1	1.0
治理环境	0	1	0	1	1.0
治理整顿	1	0	0	1	1.0
治权	1	0	0	1	1.0
治愈	1	0	0	1	1.0
治安员	0	1	0	1	1.0
治学	0	0	1	1	1.0
油钱	1	0	0	1	1.0
油腻	0	0	1	1	1.0
油条	1	0	0	1	1.0
油光	0	0	1	1	1.0
油价格	0	1	0	1	1.0
油井	0	1	0	1	1.0
河源	0	0	1	1	1.0
河南省委	1	0	0	1	1.0
河南省	1	0	0	1	1.0
河北省	1	0	0	1	1.0
沮丧	1	0	0	1	1.0
沫	0	1	0	1	1.0
沪	0	0	1	1	1.0
沧海	0	0	1	1	1.0
沦落	0	1	0	1	1.0
沦丧	0	1	0	1	1.0
没过多久	0	0	1	1	1.0
没过	0	0	1	1	1.0
没谱	0	1	0	1	1.0
没说出	0	1	0	1	1.0
没话说	1	0	0	1	1.0
没脸没皮	1	0	0	1	1.0
没脸	1	0	0	1	1.0
没脑子	0	1	0	1	1.0
没签	0	0	1	1	1.0
没理由	0	0	1	1	1.0
没戏	1	0	0	1	1.0
没得说	1	0	0	1	1.0
没得	1	0	0	1	1.0
没完没了	1	0	0	1	1.0
没出息	1	0	0	1	1.0
没出	1	0	0	1	1.0
没关系	0	1	0	1	1.0
没关	0	1	0	1	1.0
没入	0	1	0	1	1.0
没事儿	0	0	1	1	1.0
没事人	0	0	1	1	1.0
没了	1	0	0	1	1.0
沛	1	0	0	1	1.0
沙皇	0	1	0	1	1.0
沙滩	0	1	0	1	1.0
沙坪坝区	0	0	1	1	1.0
沙坪坝	0	0	1	1	1.0
沙坪	0	0	1	1	1.0
沙俄	0	1	0	1	1.0
沉浸	1	0	0	1	1.0
沉不住气	1	0	0	1	1.0
沃斯托	0	1	0	1	1.0
沃	1	0	0	1	1.0
汽车站	1	0	0	1	1.0
汽车业	1	0	0	1	1.0
汽笛	0	0	1	1	1.0
汹汹	0	0	1	1	1.0
汴	1	0	0	1	1.0
汪	0	1	0	1	1.0
汤	0	1	0	1	1.0
污蔑	0	1	0	1	1.0
污物	1	0	0	1	1.0
污水	1	0	0	1	1.0
污垢	1	0	0	1	1.0
污吏	0	1	0	1	1.0
污	0	1	0	1	1.0
江西省	0	0	1	1	1.0
江宁	1	0	0	1	1.0
江城	0	1	0	1	1.0
江云	0	1	0	1	1.0
江东	0	1	0	1	1.0
汉语	0	0	1	1	1.0
汉字	1	0	0	1	1.0
汉奸走狗	0	1	0	1	1.0
汉奸	0	1	0	1	1.0
汉人	1	0	0	1	1.0
汇率	1	0	0	1	1.0
汇报	0	1	0	1	1.0
汇	1	0	0	1	1.0
求知	0	1	0	1	1.0
求生存	0	1	0	1	1.0
求生	0	1	0	1	1.0
求求	1	0	0	1	1.0
求子	1	0	0	1	1.0
永恒	1	0	0	1	1.0
永州	1	0	0	1	1.0
永城	0	0	1	1	1.0
永和镇	0	1	0	1	1.0
永和	0	1	0	1	1.0
永元	1	0	0	1	1.0
水饺	1	0	0	1	1.0
水集	0	1	0	1	1.0
水道	0	1	0	1	1.0
水路	0	0	1	1	1.0
水资源	0	1	0	1	1.0
水花	1	0	0	1	1.0
水电	1	0	0	1	1.0
水瓶	1	0	0	1	1.0
水火之中	0	0	1	1	1.0
水火不容	0	1	0	1	1.0
水漂	0	1	0	1	1.0
水污染	0	1	0	1	1.0
水头	1	0	0	1	1.0
水可载舟	0	1	0	1	1.0
水准	0	0	1	1	1.0
水中毒	1	0	0	1	1.0
水中	1	0	0	1	1.0
氧化碳	0	1	0	1	1.0
氧化氮	0	1	0	1	1.0
气魄	1	0	0	1	1.0
气象部门	0	1	0	1	1.0
气死	0	1	0	1	1.0
气愤	0	1	0	1	1.0
气宇	0	0	1	1	1.0
气候	0	1	0	1	1.0
民阵	0	1	0	1	1.0
民间故事	1	0	0	1	1.0
民航	0	1	0	1	1.0
民族宗教	1	0	0	1	1.0
民族主义	1	0	0	1	1.0
民政	0	1	0	1	1.0
民愤	0	1	0	1	1.0
民意基础	0	1	0	1	1.0
民主自由	1	0	0	1	1.0
氏	0	1	0	1	1.0
毫无意义	1	0	0	1	1.0
毫安	1	0	0	1	1.0
毫发	1	0	0	1	1.0
毫不犹豫	1	0	0	1	1.0
毫不	1	0	0	1	1.0
毡帽	0	1	0	1	1.0
毛泽东	0	0	1	1	1.0
毛利率	0	1	0	1	1.0
毛利	0	1	0	1	1.0
毛估估	0	1	0	1	1.0
毛估	0	1	0	1	1.0
毕业生	0	0	1	1	1.0
比重	0	0	1	1	1.0
比照	0	1	0	1	1.0
比拼	1	0	0	1	1.0
比拟	1	0	0	1	1.0
比如说	0	1	0	1	1.0
比利时	0	0	1	1	1.0
比利	0	0	1	1	1.0
比不上	0	1	0	1	1.0
毓秀	1	0	0	1	1.0
毒药	0	1	0	1	1.0
毒素	0	0	1	1	1.0
毒奶粉	1	0	0	1	1.0
毒品	1	0	0	1	1.0
每隔	1	0	0	1	1.0
每辆	0	1	0	1	1.0
每每	0	1	0	1	1.0
每晚	0	1	0	1	1.0
每户	0	1	0	1	1.0
每家每户	0	1	0	1	1.0
每位	0	1	0	1	1.0
每人	0	1	0	1	1.0
母鸡	1	0	0	1	1.0
母狗	1	0	0	1	1.0
母子	1	0	0	1	1.0
母婴	1	0	0	1	1.0
母女	0	1	0	1	1.0
毅然	0	0	1	1	1.0
毁约	1	0	0	1	1.0
毁灭性	1	0	0	1	1.0
毁坏	0	0	1	1	1.0
毁	0	1	0	1	1.0
段式	0	0	1	1	1.0
殡葬	1	0	0	1	1.0
残疾人	1	0	0	1	1.0
残疾	1	0	0	1	1.0
残留	1	0	0	1	1.0
残杀	0	1	0	1	1.0
残废	0	1	0	1	1.0
残屑	0	0	1	1	1.0
残害	1	0	0	1	1.0
残余	1	0	0	1	1.0
死难	0	1	0	1	1.0
死角	0	1	0	1	1.0
死死的	1	0	0	1	1.0
死棋	0	1	0	1	1.0
死机	1	0	0	1	1.0
死无葬身之地	0	1	0	1	1.0
死无葬身	0	1	0	1	1.0
死战	0	1	0	1	1.0
死忠	1	0	0	1	1.0
死心	0	0	1	1	1.0
死伤	0	1	0	1	1.0
死不了	1	0	0	1	1.0
武汉市	1	0	0	1	1.0
武断	0	1	0	1	1.0
武安	1	0	0	1	1.0
武器弹药	0	1	0	1	1.0
武器库	1	0	0	1	1.0
武力	1	0	0	1	1.0
步骤	1	0	0	1	1.0
步棋	1	0	0	1	1.0
步履	0	1	0	1	1.0
此项	0	1	0	1	1.0
此类	0	1	0	1	1.0
此种	0	0	1	1	1.0
此法	0	1	0	1	1.0
此处	1	0	0	1	1.0
此人	1	0	0	1	1.0
此一时	0	1	0	1	1.0
正道	0	1	0	1	1.0
正视	0	1	0	1	1.0
正气	0	1	0	1	1.0
正正	1	0	0	1	1.0
正月初五	0	1	0	1	1.0
正当权益	0	1	0	1	1.0
正当性	0	0	1	1	1.0
正式版	0	0	1	1	1.0
正常人	1	0	0	1	1.0
正巧	1	0	0	1	1.0
正宗	0	0	1	1	1.0
正太	1	0	0	1	1.0
正向	1	0	0	1	1.0
正合适	1	0	0	1	1.0
正合	1	0	0	1	1.0
正南方	1	0	0	1	1.0
正南	1	0	0	1	1.0
正值	0	1	0	1	1.0
正义感	0	1	0	1	1.0
正义性	0	1	0	1	1.0
止渴	0	1	0	1	1.0
止咳药	0	1	0	1	1.0
止咳	0	1	0	1	1.0
歌王	0	0	1	1	1.0
歌儿	1	0	0	1	1.0
歇业	0	1	0	1	1.0
歇	0	1	0	1	1.0
款式	1	0	0	1	1.0
欲望	0	1	0	1	1.0
欧洲央行	0	0	1	1	1.0
欧内斯特	0	1	0	1	1.0
欧亚大陆	0	1	0	1	1.0
欧亚	0	1	0	1	1.0
欣闻	0	1	0	1	1.0
欣慰	1	0	0	1	1.0
欣	0	0	1	1	1.0
欢聚一堂	1	0	0	1	1.0
欢愉	0	1	0	1	1.0
欢快	1	0	0	1	1.0
欢天喜地	1	0	0	1	1.0
欢乐祥和	0	1	0	1	1.0
次次	0	0	1	1	1.0
次于	1	0	0	1	1.0
次世代	0	1	0	1	1.0
欠帐	0	0	1	1	1.0
檀	1	0	0	1	1.0
橙色	0	1	0	1	1.0
橙子	0	1	0	1	1.0
橘子	1	0	0	1	1.0
樱花季	0	0	1	1	1.0
樱花	0	0	1	1	1.0
横财	0	0	1	1	1.0
横行霸道	0	1	0	1	1.0
横蛮	0	1	0	1	1.0
横空出世	0	1	0	1	1.0
横空	0	1	0	1	1.0
横流	1	0	0	1	1.0
横七竖八	1	0	0	1	1.0
模糊	1	0	0	1	1.0
模样	1	0	0	1	1.0
模拟	1	0	0	1	1.0
模仿	0	1	0	1	1.0
槽罐车	0	1	0	1	1.0
槟榔	0	1	0	1	1.0
榨	0	1	0	1	1.0
榆中	0	1	0	1	1.0
楼市	0	1	0	1	1.0
楼层	0	1	0	1	1.0
楼上	1	0	0	1	1.0
楹联	1	0	0	1	1.0
楠	0	0	1	1	1.0
植物	0	1	0	1	1.0
植树	0	1	0	1	1.0
椅	0	0	1	1	1.0
棱角	1	0	0	1	1.0
棘手	0	0	1	1	1.0
棋局	0	1	0	1	1.0
棋	0	1	0	1	1.0
棉袄	1	0	0	1	1.0
棉花球	0	0	1	1	1.0
检讨	0	1	0	1	1.0
梯形	1	0	0	1	1.0
梦醒	0	0	1	1	1.0
梦乡	0	1	0	1	1.0
梗	0	1	0	1	1.0
梅县	1	0	0	1	1.0
桥下	0	0	1	1	1.0
档案	1	0	0	1	1.0
档期	0	1	0	1	1.0
档	0	0	1	1	1.0
桔子	1	0	0	1	1.0
案件	0	0	1	1	1.0
案	0	1	0	1	1.0
框架	1	0	0	1	1.0
桃木	0	0	1	1	1.0
桂圆	0	0	1	1	1.0
格式	0	0	1	1	1.0
格外	1	0	0	1	1.0
根深蒂固	1	0	0	1	1.0
根治	1	0	0	1	1.0
根本性	0	1	0	1	1.0
根本就是	0	1	0	1	1.0
根子	0	0	1	1	1.0
根基	0	1	0	1	1.0
核武器	0	1	0	1	1.0
核桃	1	0	0	1	1.0
核打击	0	0	1	1	1.0
核心内容	1	0	0	1	1.0
核实	0	0	1	1	1.0
核大国	1	0	0	1	1.0
核发	1	0	0	1	1.0
样本	0	0	1	1	1.0
校方	0	1	0	1	1.0
校	0	0	1	1	1.0
栗鼠	1	0	0	1	1.0
栗子	1	0	0	1	1.0
树欲静而风不止	0	0	1	1	1.0
树欲静而	0	0	1	1	1.0
栏杆	0	0	1	1	1.0
栋	0	1	0	1	1.0
标题	0	0	1	1	1.0
标语	0	1	0	1	1.0
标签	1	0	0	1	1.0
标称	0	0	1	1	1.0
标杆	0	1	0	1	1.0
标本兼治	1	0	0	1	1.0
标本	1	0	0	1	1.0
标准规定	0	1	0	1	1.0
标准规	0	1	0	1	1.0
标准版	1	0	0	1	1.0
标价	1	0	0	1	1.0
柴禾	1	0	0	1	1.0
柬埔寨	1	0	0	1	1.0
查理	0	1	0	1	1.0
查查	0	0	1	1	1.0
查明	0	0	1	1	1.0
查找	0	0	1	1	1.0
查封	0	1	0	1	1.0
查完	0	0	1	1	1.0
查出来	1	0	0	1	1.0
柜子	1	0	0	1	1.0
柜	0	0	1	1	1.0
染指	0	0	1	1	1.0
染	0	1	0	1	1.0
某物	1	0	0	1	1.0
柏	1	0	0	1	1.0
架桥	1	0	0	1	1.0
枫桥	1	0	0	1	1.0
枫	0	0	1	1	1.0
枪毙	1	0	0	1	1.0
枣庄	0	1	0	1	1.0
枣	0	1	0	1	1.0
果粉	1	0	0	1	1.0
果断	1	0	0	1	1.0
果敢	0	1	0	1	1.0
果实	1	0	0	1	1.0
林木	1	0	0	1	1.0
林斯克	0	0	1	1	1.0
林区	0	1	0	1	1.0
枉费	1	0	0	1	1.0
构成威胁	0	1	0	1	1.0
极致	0	0	1	1	1.0
极快	1	0	0	1	1.0
极差	1	0	0	1	1.0
极容易	0	1	0	1	1.0
极好	1	0	0	1	1.0
极大	1	0	0	1	1.0
极右	0	1	0	1	1.0
板儿	1	0	0	1	1.0
板	1	0	0	1	1.0
松江	1	0	0	1	1.0
松树	1	0	0	1	1.0
松松	0	0	1	1	1.0
松弛	1	0	0	1	1.0
松岗	1	0	0	1	1.0
杰作	1	0	0	1	1.0
杰伦	0	0	1	1	1.0
杯赛	0	1	0	1	1.0
杯杯	1	0	0	1	1.0
杭州市	0	1	0	1	1.0
杭	1	0	0	1	1.0
来讲	0	1	0	1	1.0
来用	0	1	0	1	1.0
来源不明	0	0	1	1	1.0
来得及	0	0	1	1	1.0
来得	0	0	1	1	1.0
来势汹汹	0	0	1	1	1.0
来势	0	0	1	1	1.0
来之不易	0	1	0	1	1.0
条条	0	1	0	1	1.0
杠杆作用	0	1	0	1	1.0
杠杆	0	1	0	1	1.0
杜蕾斯	1	0	0	1	1.0
杜	0	0	1	1	1.0
村庄	0	1	0	1	1.0
村干部	0	1	0	1	1.0
村委会	1	0	0	1	1.0
村委	1	0	0	1	1.0
材	0	1	0	1	1.0
杏仁	1	0	0	1	1.0
李老师	0	1	0	1	1.0
李明启	0	1	0	1	1.0
李开复	0	1	0	1	1.0
李宇春	1	0	0	1	1.0
杆子	1	0	0	1	1.0
权益部	0	0	1	1	1.0
权宜之计	0	1	0	1	1.0
权宜	0	1	0	1	1.0
权威部门	0	0	1	1	1.0
权威	0	0	1	1	1.0
权且	0	1	0	1	1.0
杂鱼	1	0	0	1	1.0
杂音	0	1	0	1	1.0
杂谈	0	0	1	1	1.0
杀鸡	1	0	0	1	1.0
杀绝	0	1	0	1	1.0
杀猪	1	0	0	1	1.0
杀手	1	0	0	1	1.0
杀光	0	1	0	1	1.0
杀伤力	1	0	0	1	1.0
机遇	1	0	0	1	1.0
机车	0	0	1	1	1.0
机密	0	1	0	1	1.0
机壳	0	1	0	1	1.0
机场	0	0	1	1	1.0
机关	0	1	0	1	1.0
朵颐	1	0	0	1	1.0
朵	1	0	0	1	1.0
术	1	0	0	1	1.0
本馆	1	0	0	1	1.0
本质区别	0	1	0	1	1.0
本该	0	0	1	1	1.0
本科	1	0	0	1	1.0
本次	0	1	0	1	1.0
本本	0	1	0	1	1.0
本性	0	1	0	1	1.0
本年度	1	0	0	1	1.0
本年	1	0	0	1	1.0
本帖	0	0	1	1	1.0
本命年	1	0	0	1	1.0
本命	1	0	0	1	1.0
本价	1	0	0	1	1.0
本书	0	1	0	1	1.0
末路	0	1	0	1	1.0
末端	1	0	0	1	1.0
未雨绸缪	0	0	1	1	1.0
未闻	0	1	0	1	1.0
未能	0	1	0	1	1.0
未满	0	0	1	1	1.0
未战	1	0	0	1	1.0
未尝	1	0	0	1	1.0
未婚	0	1	0	1	1.0
未卜	0	1	0	1	1.0
未动	0	1	0	1	1.0
未免太	0	1	0	1	1.0
木质	1	0	0	1	1.0
木桥	0	1	0	1	1.0
木材	0	1	0	1	1.0
木偶	1	0	0	1	1.0
期末考试	0	0	1	1	1.0
期末考	0	0	1	1	1.0
期末	0	0	1	1	1.0
期望	0	1	0	1	1.0
期内	0	1	0	1	1.0
朝日	0	0	1	1	1.0
望海	0	0	1	1	1.0
望	0	0	1	1	1.0
朕	0	1	0	1	1.0
服饰	1	0	0	1	1.0
服役	0	1	0	1	1.0
服务队	1	0	0	1	1.0
服务社	0	1	0	1	1.0
服务水平	0	0	1	1	1.0
服务态度	0	0	1	1	1.0
服务商	1	0	0	1	1.0
服务员	0	0	1	1	1.0
服务中心	0	1	0	1	1.0
服务业	0	1	0	1	1.0
有识之士	1	0	0	1	1.0
有色	1	0	0	1	1.0
有百害而无一利	0	1	0	1	1.0
有理有据	0	1	0	1	1.0
有机	1	0	0	1	1.0
有望	0	0	1	1	1.0
有方	1	0	0	1	1.0
有所不同	0	0	1	1	1.0
有心	1	0	0	1	1.0
有得卖	1	0	0	1	1.0
有待	0	1	0	1	1.0
有山有水	0	0	1	1	1.0
有声有色	1	0	0	1	1.0
有名无实	0	1	0	1	1.0
有史以来	1	0	0	1	1.0
有劲	0	1	0	1	1.0
有利有弊	1	0	0	1	1.0
有余	0	0	1	1	1.0
有何意义	0	0	1	1	1.0
有仇必报	0	1	0	1	1.0
有事没事	0	1	0	1	1.0
有了钱	0	0	1	1	1.0
月黑风高	1	0	0	1	1.0
月租金	1	0	0	1	1.0
月租	1	0	0	1	1.0
月光族	1	0	0	1	1.0
月光	1	0	0	1	1.0
月亮	1	0	0	1	1.0
最高点	1	0	0	1	1.0
最长	1	0	0	1	1.0
最让人	1	0	0	1	1.0
最舒服	1	0	0	1	1.0
最爽	1	0	0	1	1.0
最新进展	0	0	1	1	1.0
最新消息	0	0	1	1	1.0
最快	1	0	0	1	1.0
最少	0	0	1	1	1.0
最小	0	0	1	1	1.0
最前沿	1	0	0	1	1.0
最前	1	0	0	1	1.0
最全	1	0	0	1	1.0
最低气温	0	1	0	1	1.0
替罪	0	1	0	1	1.0
替换	1	0	0	1	1.0
曼斯	0	0	1	1	1.0
曼德拉	0	1	0	1	1.0
更进一步	0	1	0	1	1.0
更累	1	0	0	1	1.0
更有意义	0	1	0	1	1.0
更改	0	0	1	1	1.0
更换	0	0	1	1	1.0
更为严重	0	1	0	1	1.0
曲解	0	1	0	1	1.0
曲折	0	0	1	1	1.0
曲别针	0	0	1	1	1.0
曲	0	0	1	1	1.0
暴露无遗	1	0	0	1	1.0
暴露出	0	1	0	1	1.0
暴跌	0	1	0	1	1.0
暴行	1	0	0	1	1.0
暴增	0	1	0	1	1.0
暴君	0	1	0	1	1.0
暴发户	0	1	0	1	1.0
暴发	0	1	0	1	1.0
暴利	0	1	0	1	1.0
暗杀	0	0	1	1	1.0
暗指	1	0	0	1	1.0
暖色调	1	0	0	1	1.0
暖色	1	0	0	1	1.0
暖意	1	0	0	1	1.0
暂扣	0	0	1	1	1.0
智能机	0	1	0	1	1.0
智者	0	1	0	1	1.0
智库	0	1	0	1	1.0
智力	1	0	0	1	1.0
晶片	1	0	0	1	1.0
晶报	1	0	0	1	1.0
晴天	0	1	0	1	1.0
晴	0	1	0	1	1.0
景象	0	1	0	1	1.0
景观	1	0	0	1	1.0
景区	1	0	0	1	1.0
景况	0	1	0	1	1.0
景	0	1	0	1	1.0
普通群众	0	1	0	1	1.0
普查	1	0	0	1	1.0
普度众生	1	0	0	1	1.0
普度	1	0	0	1	1.0
普天同庆	1	0	0	1	1.0
普天同	1	0	0	1	1.0
普天	1	0	0	1	1.0
晨会	0	0	1	1	1.0
晚饭	0	0	1	1	1.0
晚点	1	0	0	1	1.0
晚期	1	0	0	1	1.0
晚学	0	0	1	1	1.0
晚些时候	0	0	1	1	1.0
晚些	0	0	1	1	1.0
晓得	0	1	0	1	1.0
晒晒	1	0	0	1	1.0
显出	0	1	0	1	1.0
昼夜	1	0	0	1	1.0
昼	1	0	0	1	1.0
是否是	1	0	0	1	1.0
昭雪	0	1	0	1	1.0
昭示	0	0	1	1	1.0
昭告	0	0	1	1	1.0
昨天下午	0	1	0	1	1.0
昨夜	0	1	0	1	1.0
昨	0	1	0	1	1.0
春节前夕	0	1	0	1	1.0
春笋	0	0	1	1	1.0
星空	0	1	0	1	1.0
星期天	0	1	0	1	1.0
星期六	1	0	0	1	1.0
星星之火	0	1	0	1	1.0
星子	1	0	0	1	1.0
昕	1	0	0	1	1.0
昔日	0	1	0	1	1.0
易经	1	0	0	1	1.0
易碎	0	1	0	1	1.0
易用性	1	0	0	1	1.0
易用	1	0	0	1	1.0
昏睡	1	0	0	1	1.0
昏天黑地	0	1	0	1	1.0
明面儿	1	0	0	1	1.0
明面	1	0	0	1	1.0
明确规定	0	0	1	1	1.0
明码标价	1	0	0	1	1.0
明码	1	0	0	1	1.0
明白事理	1	0	0	1	1.0
明珠	1	0	0	1	1.0
明火	0	1	0	1	1.0
明朗化	0	1	0	1	1.0
明朗	0	1	0	1	1.0
明月	1	0	0	1	1.0
明智之举	0	0	1	1	1.0
明智	0	0	1	1	1.0
明显好转	1	0	0	1	1.0
明显增加	0	0	1	1	1.0
明大义	0	1	0	1	1.0
明大	0	1	0	1	1.0
昌平	1	0	0	1	1.0
昆山	1	0	0	1	1.0
旺火	0	0	1	1	1.0
旺	1	0	0	1	1.0
时隔	0	0	1	1	1.0
时装周	0	1	0	1	1.0
时装	0	1	0	1	1.0
时差	1	0	0	1	1.0
时局	0	0	1	1	1.0
时会	0	1	0	1	1.0
时代性	0	1	0	1	1.0
旱冰鞋	0	0	1	1	1.0
旱冰	0	0	1	1	1.0
旭	1	0	0	1	1.0
早读	0	1	0	1	1.0
早知如此	0	1	0	1	1.0
早生贵子	0	0	1	1	1.0
早生	0	0	1	1	1.0
早班车	0	0	1	1	1.0
早班	0	0	1	1	1.0
早期	1	0	0	1	1.0
早报	0	1	0	1	1.0
早安	0	1	0	1	1.0
旧岁	0	1	0	1	1.0
旧交	0	1	0	1	1.0
旦夕	1	0	0	1	1.0
日程	1	0	0	1	1.0
日益严重	0	1	0	1	1.0
日来	1	0	0	1	1.0
日本外务省	0	0	1	1	1.0
日志	0	0	1	1	1.0
日增	0	1	0	1	1.0
日内瓦	0	1	0	1	1.0
既然如此	1	0	0	1	1.0
既成事实	1	0	0	1	1.0
既得利益者	0	0	1	1	1.0
无非	0	1	0	1	1.0
无需	0	0	1	1	1.0
无遗	1	0	0	1	1.0
无谓	0	1	0	1	1.0
无误	0	1	0	1	1.0
无能为力	0	1	0	1	1.0
无线电	1	0	0	1	1.0
无端	0	1	0	1	1.0
无穷	0	0	1	1	1.0
无码	0	0	1	1	1.0
无烟	0	1	0	1	1.0
无法比拟	1	0	0	1	1.0
无法弥补	1	0	0	1	1.0
无果	0	1	0	1	1.0
无条件	0	0	1	1	1.0
无权	0	1	0	1	1.0
无本万利	0	1	0	1	1.0
无望	0	1	0	1	1.0
无时无刻	0	1	0	1	1.0
无时	0	1	0	1	1.0
无数次	0	1	0	1	1.0
无效	0	1	0	1	1.0
无忧	1	0	0	1	1.0
无度	0	0	1	1	1.0
无害	0	0	1	1	1.0
无存	0	1	0	1	1.0
无头	1	0	0	1	1.0
无处	0	0	1	1	1.0
无名	0	1	0	1	1.0
无可争辩	1	0	0	1	1.0
无动于衷	0	1	0	1	1.0
无关痛痒	1	0	0	1	1.0
无休无止	0	0	1	1	1.0
无以复加	1	0	0	1	1.0
无以	1	0	0	1	1.0
无业游民	0	0	1	1	1.0
无业	0	0	1	1	1.0
旗舰机	0	1	0	1	1.0
旗舰店	0	1	0	1	1.0
旗子	0	1	0	1	1.0
旗下	0	0	1	1	1.0
旅舍	0	1	0	1	1.0
旁敲侧击	0	0	1	1	1.0
旁	0	1	0	1	1.0
施加	0	1	0	1	1.0
施	0	0	1	1	1.0
方针	0	1	0	1	1.0
方言	0	0	1	1	1.0
方正	1	0	0	1	1.0
方方正正	1	0	0	1	1.0
方圆	1	0	0	1	1.0
方向盘	0	0	1	1	1.0
方便快捷	0	1	0	1	1.0
新鲜血液	0	1	0	1	1.0
新鲜感	0	1	0	1	1.0
新鲜事儿	0	0	1	1	1.0
新马泰	1	0	0	1	1.0
新颖	1	0	0	1	1.0
新闻资讯	0	0	1	1	1.0
新闻社	0	1	0	1	1.0
新闻媒体	0	1	0	1	1.0
新闻处	0	1	0	1	1.0
新进展	0	0	1	1	1.0
新车	0	0	1	1	1.0
新路	1	0	0	1	1.0
新西兰	0	1	0	1	1.0
新街	1	0	0	1	1.0
新能源	0	1	0	1	1.0
新窗口	0	0	1	1	1.0
新疆地区	0	1	0	1	1.0
新生事物	0	0	1	1	1.0
新版	0	0	1	1	1.0
新潮流	0	0	1	1	1.0
新民晚报	0	1	0	1	1.0
新款手机	1	0	0	1	1.0
新桃换旧符	1	0	0	1	1.0
新格局	1	0	0	1	1.0
新春愉快	0	0	1	1	1.0
新春快乐	0	1	0	1	1.0
新旧交替	0	1	0	1	1.0
新旧	0	1	0	1	1.0
新思维	1	0	0	1	1.0
新学期	0	0	1	1	1.0
新学	0	0	1	1	1.0
新型	1	0	0	1	1.0
新亮点	1	0	0	1	1.0
新乡	1	0	0	1	1.0
新举措	1	0	0	1	1.0
新一代	0	1	0	1	1.0
斯特	0	1	0	1	1.0
斯港	1	0	0	1	1.0
斯托克	0	1	0	1	1.0
斯托	0	1	0	1	1.0
斯大林	0	1	0	1	1.0
斯塔	1	0	0	1	1.0
斯坦福	0	0	1	1	1.0
斯兰教	1	0	0	1	1.0
断续	0	1	0	1	1.0
断章取义	1	0	0	1	1.0
断断续续	0	1	0	1	1.0
断断	0	1	0	1	1.0
断层	0	1	0	1	1.0
断定	1	0	0	1	1.0
斩	0	0	1	1	1.0
斑马线	0	0	1	1	1.0
斑马	0	0	1	1	1.0
文艺节目	1	0	0	1	1.0
文艺活动	0	1	0	1	1.0
文稿	1	0	0	1	1.0
文帝	1	0	0	1	1.0
文学刊物	1	0	0	1	1.0
文字版	1	0	0	1	1.0
文化遗产	1	0	0	1	1.0
文化版	1	0	0	1	1.0
文化氛围	1	0	0	1	1.0
文化差异	1	0	0	1	1.0
文化圈	1	0	0	1	1.0
文体	1	0	0	1	1.0
整车	0	0	1	1	1.0
整洁	0	1	0	1	1.0
整栋	0	0	1	1	1.0
整条	0	0	1	1	1.0
整备	0	0	1	1	1.0
整出	0	1	0	1	1.0
整一个	1	0	0	1	1.0
整一	1	0	0	1	1.0
敲诈勒索	1	0	0	1	1.0
敲响	0	0	1	1	1.0
数起	1	0	0	1	1.0
数码产品	0	0	1	1	1.0
数着	0	1	0	1	1.0
数次	0	1	0	1	1.0
数据分析	0	0	1	1	1.0
数千年	1	0	0	1	1.0
数千万	0	0	1	1	1.0
数值	0	1	0	1	1.0
数万	1	0	0	1	1.0
敬老	0	1	0	1	1.0
敬畏	0	1	0	1	1.0
敬佩	0	1	0	1	1.0
敬业	0	1	0	1	1.0
敦促	0	0	1	1	1.0
散伙	0	1	0	1	1.0
散	0	1	0	1	1.0
敢死	0	1	0	1	1.0
敢当	0	0	1	1	1.0
敢动	1	0	0	1	1.0
敢作敢当	0	0	1	1	1.0
敢作	0	0	1	1	1.0
敢不敢	0	1	0	1	1.0
教育部	0	1	0	1	1.0
教育法	0	1	0	1	1.0
教育局	1	0	0	1	1.0
教科书	0	1	0	1	1.0
教科	0	1	0	1	1.0
教材	0	1	0	1	1.0
教室	0	1	0	1	1.0
教子	0	1	0	1	1.0
教士	0	0	1	1	1.0
教务	0	1	0	1	1.0
教体局	0	0	1	1	1.0
教会	1	0	0	1	1.0
教书育人	0	0	1	1	1.0
救活	0	1	0	1	1.0
救星	1	0	0	1	1.0
救救	0	1	0	1	1.0
救国	0	1	0	1	1.0
救人	0	1	0	1	1.0
敏感点	0	1	0	1	1.0
敏感度	0	0	1	1	1.0
敏感区域	0	1	0	1	1.0
敏感区	0	1	0	1	1.0
敏	1	0	0	1	1.0
敌我	0	1	0	1	1.0
敌国	0	1	0	1	1.0
故障	0	1	0	1	1.0
故土	1	0	0	1	1.0
故作	1	0	0	1	1.0
故乡	1	0	0	1	1.0
政要	0	0	1	1	1.0
政者	0	1	0	1	1.0
政经	1	0	0	1	1.0
政治觉悟	0	1	0	1	1.0
政治经济	0	1	0	1	1.0
政治权利	1	0	0	1	1.0
政治权	1	0	0	1	1.0
政治局势	1	0	0	1	1.0
政治局	1	0	0	1	1.0
政治学	0	0	1	1	1.0
政教	1	0	0	1	1.0
政府部门	0	1	0	1	1.0
政协委员	0	1	0	1	1.0
政协	0	1	0	1	1.0
政务	0	1	0	1	1.0
政党	1	0	0	1	1.0
政令	0	1	0	1	1.0
放进去	0	0	1	1	1.0
放过	1	0	0	1	1.0
放行	0	0	1	1	1.0
放纵	1	0	0	1	1.0
放眼	0	1	0	1	1.0
放生	0	1	0	1	1.0
放烟火	0	0	1	1	1.0
放满	0	1	0	1	1.0
放权	1	0	0	1	1.0
放归	1	0	0	1	1.0
放入	0	0	1	1	1.0
放上去	1	0	0	1	1.0
放上	1	0	0	1	1.0
攻打	0	0	1	1	1.0
攻城略地	1	0	0	1	1.0
攻城	1	0	0	1	1.0
改装车	1	0	0	1	1.0
改行	0	1	0	1	1.0
改掉	1	0	0	1	1.0
改不了	0	0	1	1	1.0
收钱	0	1	0	1	1.0
收腹	1	0	0	1	1.0
收税	0	1	0	1	1.0
收盘	1	0	0	1	1.0
收容	1	0	0	1	1.0
收听	0	0	1	1	1.0
收取	0	0	1	1	1.0
收件	0	1	0	1	1.0
收买	1	0	0	1	1.0
收不到	0	1	0	1	1.0
支队长	0	1	0	1	1.0
支队	0	1	0	1	1.0
支撑	0	0	1	1	1.0
支援	1	0	0	1	1.0
支付	0	0	1	1	1.0
攀登	0	1	0	1	1.0
攀比	0	1	0	1	1.0
擦身	1	0	0	1	1.0
擦亮眼睛	0	0	1	1	1.0
擦亮	0	0	1	1	1.0
播扬	0	1	0	1	1.0
撤销	1	0	0	1	1.0
撤走	0	0	1	1	1.0
撤离	1	0	0	1	1.0
撤完	0	1	0	1	1.0
撞击	1	0	0	1	1.0
撕票	1	0	0	1	1.0
撒谎	0	0	1	1	1.0
撒拉	1	0	0	1	1.0
撒	1	0	0	1	1.0
撑住	0	0	1	1	1.0
撇清	1	0	0	1	1.0
摸摸	0	0	1	1	1.0
摸了摸	1	0	0	1	1.0
摩洛哥	0	0	1	1	1.0
摩洛	0	0	1	1	1.0
摩擦	1	0	0	1	1.0
摩尔曼斯克	0	0	1	1	1.0
摘掉	1	0	0	1	1.0
摘	1	0	0	1	1.0
摔下去	1	0	0	1	1.0
摔下	1	0	0	1	1.0
摊贩	0	1	0	1	1.0
摊前	0	0	1	1	1.0
摊位	1	0	0	1	1.0
摈弃	0	0	1	1	1.0
摇身一变	0	1	0	1	1.0
摇身	0	1	0	1	1.0
摇晃	0	1	0	1	1.0
摇摆	1	0	0	1	1.0
摆开	1	0	0	1	1.0
摆布	0	1	0	1	1.0
摄影师	0	0	1	1	1.0
摄取	0	1	0	1	1.0
摄制	0	0	1	1	1.0
携手	0	1	0	1	1.0
携带方便	1	0	0	1	1.0
搭配	0	1	0	1	1.0
搭理	0	1	0	1	1.0
搭客	0	0	1	1	1.0
搬	0	1	0	1	1.0
搞错	0	1	0	1	1.0
搞起	1	0	0	1	1.0
搞混	0	0	1	1	1.0
搞活	0	1	0	1	1.0
搞平衡	0	1	0	1	1.0
搞完	0	0	1	1	1.0
搞好	1	0	0	1	1.0
搞乱	0	1	0	1	1.0
搞不好	0	0	1	1	1.0
搜狗	0	1	0	1	1.0
搓麻	0	1	0	1	1.0
搅局	0	0	1	1	1.0
搅和	0	1	0	1	1.0
搁置	1	0	0	1	1.0
揽	0	1	0	1	1.0
援	0	1	0	1	1.0
揭露	1	0	0	1	1.0
揭锅	1	0	0	1	1.0
揭竿起义	0	1	0	1	1.0
揭竿	0	1	0	1	1.0
揭晓	0	0	1	1	1.0
揭开	1	0	0	1	1.0
揣测	0	1	0	1	1.0
握持	0	1	0	1	1.0
握拳	0	0	1	1	1.0
插队	1	0	0	1	1.0
插手	0	0	1	1	1.0
插	0	1	0	1	1.0
提防	1	0	0	1	1.0
提醒您	0	1	0	1	1.0
提速	1	0	0	1	1.0
提神醒脑	0	1	0	1	1.0
提神	0	1	0	1	1.0
提早	0	1	0	1	1.0
提名	1	0	0	1	1.0
提前准备	1	0	0	1	1.0
描述	1	0	0	1	1.0
描淡写	1	0	0	1	1.0
揉	1	0	0	1	1.0
掷地有声	1	0	0	1	1.0
掷	0	1	0	1	1.0
掩耳盗铃	0	1	0	1	1.0
掩耳	0	1	0	1	1.0
掩盖	1	0	0	1	1.0
推陈出新	0	1	0	1	1.0
推销员	0	0	1	1	1.0
推销	0	0	1	1	1.0
推车	1	0	0	1	1.0
推行	1	0	0	1	1.0
推移	1	0	0	1	1.0
推断	0	1	0	1	1.0
推卸责任	0	1	0	1	1.0
推动力	1	0	0	1	1.0
推倒	1	0	0	1	1.0
推上来	0	0	1	1	1.0
推上	0	0	1	1	1.0
推三阻四	1	0	0	1	1.0
控制权	0	0	1	1	1.0
接过	1	0	0	1	1.0
接踵而至	1	0	0	1	1.0
接踵	1	0	0	1	1.0
接财神	1	0	0	1	1.0
接触	1	0	0	1	1.0
接种	0	1	0	1	1.0
接生	1	0	0	1	1.0
接班	0	1	0	1	1.0
接物	0	1	0	1	1.0
接待	0	1	0	1	1.0
接头	1	0	0	1	1.0
接处警	0	1	0	1	1.0
接壤	0	1	0	1	1.0
接回来	0	0	1	1	1.0
接回	0	0	1	1	1.0
探讨	0	0	1	1	1.0
探索	0	1	0	1	1.0
探	0	0	1	1	1.0
掘取	0	1	0	1	1.0
掖	1	0	0	1	1.0
排骨	0	0	1	1	1.0
排雷	1	0	0	1	1.0
排量	1	0	0	1	1.0
排行榜	1	0	0	1	1.0
排行	1	0	0	1	1.0
排烟	1	0	0	1	1.0
排查	1	0	0	1	1.0
排开	0	0	1	1	1.0
排出	1	0	0	1	1.0
掐	1	0	0	1	1.0
掏钱	0	1	0	1	1.0
掌厨	0	1	0	1	1.0
掉电	1	0	0	1	1.0
掉头	1	0	0	1	1.0
授予	1	0	0	1	1.0
掀	0	1	0	1	1.0
据预测	0	0	1	1	1.0
据称	0	0	1	1	1.0
据理力争	0	1	0	1	1.0
据理	0	1	0	1	1.0
据点	0	1	0	1	1.0
据守	0	0	1	1	1.0
据估计	0	0	1	1	1.0
捧	1	0	0	1	1.0
换货	0	1	0	1	1.0
换来	1	0	0	1	1.0
换岗	0	0	1	1	1.0
换句话说	0	1	0	1	1.0
换句话	0	1	0	1	1.0
换句	0	1	0	1	1.0
换取	0	1	0	1	1.0
换代	0	1	0	1	1.0
换上	0	1	0	1	1.0
损坏	0	1	0	1	1.0
捞回	0	1	0	1	1.0
捞取	0	1	0	1	1.0
捕杀	0	1	0	1	1.0
捕	0	1	0	1	1.0
捏把汗	1	0	0	1	1.0
捉贼	1	0	0	1	1.0
捂住	0	0	1	1	1.0
捂	0	0	1	1	1.0
挽回	0	1	0	1	1.0
挺住	0	1	0	1	1.0
挺不错	1	0	0	1	1.0
挨骂	0	0	1	1	1.0
挨过	0	1	0	1	1.0
挨揍	1	0	0	1	1.0
挨宰	0	0	1	1	1.0
挥舞	0	1	0	1	1.0
挤死	0	1	0	1	1.0
挣点	0	1	0	1	1.0
挣得	0	1	0	1	1.0
挡开	1	0	0	1	1.0
挡不住	1	0	0	1	1.0
挡	0	1	0	1	1.0
挞	0	0	1	1	1.0
挖苦	1	0	0	1	1.0
按说	1	0	0	1	1.0
按时	1	0	0	1	1.0
按住	0	0	1	1	1.0
指着	1	0	0	1	1.0
指手划脚	1	0	0	1	1.0
指引	0	1	0	1	1.0
指导	1	0	0	1	1.0
指向	0	1	0	1	1.0
挂钩	0	1	0	1	1.0
挂号	1	0	0	1	1.0
持久战	0	0	1	1	1.0
持久	0	0	1	1	1.0
持	0	1	0	1	1.0
拿来	0	1	0	1	1.0
拿捏	0	0	1	1	1.0
拽	0	1	0	1	1.0
拼装	0	1	0	1	1.0
拼杀	0	0	1	1	1.0
拼写	1	0	0	1	1.0
拴	0	0	1	1	1.0
拱手让出	0	0	1	1	1.0
拱手	0	0	1	1	1.0
择	0	1	0	1	1.0
拨款	0	1	0	1	1.0
拨开	1	0	0	1	1.0
拨乱反正	1	0	0	1	1.0
拦截	0	0	1	1	1.0
拥抱	0	1	0	1	1.0
拥护者	1	0	0	1	1.0
拜访	0	0	1	1	1.0
拜登	1	0	0	1	1.0
拜尔	1	0	0	1	1.0
拜天地	1	0	0	1	1.0
招聘	0	0	1	1	1.0
招生	1	0	0	1	1.0
招牌	0	1	0	1	1.0
招数	0	1	0	1	1.0
招待	0	1	0	1	1.0
拙	0	0	1	1	1.0
拘捕	0	1	0	1	1.0
拖延	0	1	0	1	1.0
拖垮	0	1	0	1	1.0
拖后腿	1	0	0	1	1.0
拖	0	1	0	1	1.0
拔萝卜	1	0	0	1	1.0
拔河	1	0	0	1	1.0
拔	0	1	0	1	1.0
拓宽	0	0	1	1	1.0
拐点	0	0	1	1	1.0
拐卖儿童	0	1	0	1	1.0
拎	0	1	0	1	1.0
拍电影	0	1	0	1	1.0
拍拍	0	1	0	1	1.0
拍手叫好	0	1	0	1	1.0
拌	1	0	0	1	1.0
拉面	1	0	0	1	1.0
拉车	0	1	0	1	1.0
拉肚子	1	0	0	1	1.0
拉稀	0	0	1	1	1.0
拉票	1	0	0	1	1.0
拉磨	0	1	0	1	1.0
拉撒	0	0	1	1	1.0
拉拉	1	0	0	1	1.0
拉开距离	0	1	0	1	1.0
拉开帷幕	0	1	0	1	1.0
拉屎	1	0	0	1	1.0
拉夫罗夫	1	0	0	1	1.0
拉夫	1	0	0	1	1.0
拉大	0	1	0	1	1.0
拉出去	1	0	0	1	1.0
拉出	1	0	0	1	1.0
拇指	0	1	0	1	1.0
拆迁	0	1	0	1	1.0
拆机	0	0	1	1	1.0
担起	0	1	0	1	1.0
担责任	1	0	0	1	1.0
担负	0	1	0	1	1.0
担任	1	0	0	1	1.0
担	0	1	0	1	1.0
抿嘴笑	1	0	0	1	1.0
抿嘴	1	0	0	1	1.0
抽血	0	0	1	1	1.0
抽烟	0	1	0	1	1.0
抽样调查	1	0	0	1	1.0
抽样	1	0	0	1	1.0
抽搐	0	0	1	1	1.0
押	1	0	0	1	1.0
抹掉	1	0	0	1	1.0
抵达	1	0	0	1	1.0
抵挡不住	1	0	0	1	1.0
抵挡	1	0	0	1	1.0
抵	1	0	0	1	1.0
抱抱	1	0	0	1	1.0
抱佛脚	0	1	0	1	1.0
披萨	0	0	1	1	1.0
披	0	1	0	1	1.0
抨击	0	1	0	1	1.0
报错	1	0	0	1	1.0
报销	0	1	0	1	1.0
报警器	0	0	1	1	1.0
报纸	1	0	0	1	1.0
报分	1	0	0	1	1.0
报佳音	1	0	0	1	1.0
护照	0	0	1	1	1.0
护工	0	0	1	1	1.0
护士	1	0	0	1	1.0
护人	0	0	1	1	1.0
护	0	0	1	1	1.0
抢鲜	0	0	1	1	1.0
抢钱	0	1	0	1	1.0
抢走了	0	1	0	1	1.0
抢点	0	0	1	1	1.0
抢拍	1	0	0	1	1.0
抢戏	1	0	0	1	1.0
抢占市场	0	1	0	1	1.0
抛开	0	1	0	1	1.0
抛	0	0	1	1	1.0
抚顺	0	1	0	1	1.0
折腰	0	0	1	1	1.0
折磨	1	0	0	1	1.0
折扣	1	0	0	1	1.0
折射出	0	1	0	1	1.0
折射	0	1	0	1	1.0
折中	0	1	0	1	1.0
抗衰老	0	0	1	1	1.0
抗击	1	0	0	1	1.0
抗争	0	1	0	1	1.0
抖	0	1	0	1	1.0
投降	0	1	0	1	1.0
投递	0	1	0	1	1.0
投弹手	1	0	0	1	1.0
投弹	1	0	0	1	1.0
投奔	0	1	0	1	1.0
投医	1	0	0	1	1.0
抓起	0	0	1	1	1.0
抓获	1	0	0	1	1.0
抓紧时间	1	0	0	1	1.0
抓紧	1	0	0	1	1.0
抓拍	0	1	0	1	1.0
抓手	0	1	0	1	1.0
抓好	0	0	1	1	1.0
抓住机会	1	0	0	1	1.0
抑或	0	1	0	1	1.0
把手	0	0	1	1	1.0
抄送	0	0	1	1	1.0
技能	0	0	1	1	1.0
技术革新	0	1	0	1	1.0
技俩	0	1	0	1	1.0
承载	0	0	1	1	1.0
承继	0	1	0	1	1.0
承	0	1	0	1	1.0
找麻烦	0	1	0	1	1.0
找死	1	0	0	1	1.0
找出	1	0	0	1	1.0
扼制	1	0	0	1	1.0
批准	0	1	0	1	1.0
扶起来	0	1	0	1	1.0
扶起	0	1	0	1	1.0
扶助	0	1	0	1	1.0
扰人	0	1	0	1	1.0
扮演着	1	0	0	1	1.0
扮演	1	0	0	1	1.0
扭扭	0	0	1	1	1.0
扬清厉俗	0	1	0	1	1.0
扬州	0	0	1	1	1.0
扬子晚报	0	0	1	1	1.0
扬子	0	0	1	1	1.0
扬声器	1	0	0	1	1.0
扬声	1	0	0	1	1.0
扬	1	0	0	1	1.0
扫清	0	0	1	1	1.0
扫描	1	0	0	1	1.0
扫帚	0	1	0	1	1.0
扫墓	1	0	0	1	1.0
扩招	0	1	0	1	1.0
扩建	0	1	0	1	1.0
扩展卡	0	1	0	1	1.0
扩	0	1	0	1	1.0
执行力	1	0	0	1	1.0
执着	1	0	0	1	1.0
执法机关	0	1	0	1	1.0
执政者	0	1	0	1	1.0
执导	1	0	0	1	1.0
扣肉	0	1	0	1	1.0
扣分	0	1	0	1	1.0
扞	0	1	0	1	1.0
扛着	0	1	0	1	1.0
托克	0	1	0	1	1.0
扔进	0	1	0	1	1.0
扔掉	0	1	0	1	1.0
打非	0	0	1	1	1.0
打针	1	0	0	1	1.0
打造	0	1	0	1	1.0
打车	0	1	0	1	1.0
打肿脸充胖子	0	1	0	1	1.0
打肿脸充	0	1	0	1	1.0
打肿	0	1	0	1	1.0
打耳光	0	1	0	1	1.0
打牌	1	0	0	1	1.0
打点	0	0	1	1	1.0
打消	0	1	0	1	1.0
打水漂	0	1	0	1	1.0
打水	0	1	0	1	1.0
打拼	0	1	0	1	1.0
打折	0	1	0	1	1.0
打扮	0	1	0	1	1.0
打战	0	1	0	1	1.0
打成平手	0	1	0	1	1.0
打工者	0	1	0	1	1.0
打坏	0	1	0	1	1.0
打圆场	0	0	1	1	1.0
打印	0	0	1	1	1.0
打击报复	1	0	0	1	1.0
打出	0	1	0	1	1.0
打交道	0	1	0	1	1.0
打乱	0	0	1	1	1.0
打不着	0	0	1	1	1.0
打不开	0	1	0	1	1.0
扒	0	1	0	1	1.0
扑通	1	0	0	1	1.0
扑街	0	1	0	1	1.0
扑灭	0	0	1	1	1.0
扎起	0	0	1	1	1.0
扎实	1	0	0	1	1.0
手链	1	0	0	1	1.0
手软	1	0	0	1	1.0
手足之情	1	0	0	1	1.0
手腕	0	1	0	1	1.0
手脚冰凉	0	0	1	1	1.0
手脚	0	0	1	1	1.0
手枪	1	0	0	1	1.0
手机网	0	1	0	1	1.0
手机短信	0	1	0	1	1.0
手机城	1	0	0	1	1.0
手术	1	0	0	1	1.0
手无寸铁	0	1	0	1	1.0
手掌	1	0	0	1	1.0
手工	0	0	1	1	1.0
手套	1	0	0	1	1.0
手写	1	0	0	1	1.0
手下	1	0	0	1	1.0
扇	0	1	0	1	1.0
所致	1	0	0	1	1.0
所能	0	1	0	1	1.0
所有者	0	1	0	1	1.0
所指	1	0	0	1	1.0
所剩	1	0	0	1	1.0
所作所为	0	1	0	1	1.0
所作	0	1	0	1	1.0
所为	0	1	0	1	1.0
房屋	0	1	0	1	1.0
房产	0	1	0	1	1.0
户口本	0	1	0	1	1.0
戴绿帽子	1	0	0	1	1.0
戴绿帽	1	0	0	1	1.0
戴眼镜	1	0	0	1	1.0
戮	1	0	0	1	1.0
截止	0	1	0	1	1.0
截	0	1	0	1	1.0
戚戚焉	1	0	0	1	1.0
戚戚	1	0	0	1	1.0
战队	0	1	0	1	1.0
战略伙伴	1	0	0	1	1.0
战报	0	1	0	1	1.0
战争状态	1	0	0	1	1.0
我行我素	1	0	0	1	1.0
我行	1	0	0	1	1.0
我俩	0	1	0	1	1.0
我为鱼肉	0	1	0	1	1.0
我中有你	0	1	0	1	1.0
成都市	0	1	0	1	1.0
成都地区	0	1	0	1	1.0
成败	0	0	1	1	1.0
成群结队	1	0	0	1	1.0
成群	1	0	0	1	1.0
成箱	0	1	0	1	1.0
成灾	0	1	0	1	1.0
成本价	1	0	0	1	1.0
成方圆	1	0	0	1	1.0
成方	1	0	0	1	1.0
成形	1	0	0	1	1.0
成年	0	1	0	1	1.0
成平	0	1	0	1	1.0
成堆	0	0	1	1	1.0
成品	0	0	1	1	1.0
成员国	0	1	0	1	1.0
成像	1	0	0	1	1.0
成倍增长	0	1	0	1	1.0
成佛	0	0	1	1	1.0
成事	1	0	0	1	1.0
戏曲	1	0	0	1	1.0
戈壁	0	1	0	1	1.0
懵	0	1	0	1	1.0
懒觉	1	0	0	1	1.0
懒猫	0	1	0	1	1.0
懂法	0	1	0	1	1.0
憨子	1	0	0	1	1.0
憧憬	1	0	0	1	1.0
憋着	0	1	0	1	1.0
憋不住	1	0	0	1	1.0
慰问	1	0	0	1	1.0
慨叹	1	0	0	1	1.0
慎	1	0	0	1	1.0
慌慌	1	0	0	1	1.0
慈爱	1	0	0	1	1.0
慈溪市	0	1	0	1	1.0
慈溪	0	1	0	1	1.0
慈悲为怀	0	1	0	1	1.0
慈	0	1	0	1	1.0
愧对	0	1	0	1	1.0
愧为	1	0	0	1	1.0
愤愤	0	1	0	1	1.0
愤世嫉俗	0	1	0	1	1.0
愤世	0	1	0	1	1.0
愤	0	1	0	1	1.0
愣	0	0	1	1	1.0
感言	0	0	1	1	1.0
感触	1	0	0	1	1.0
感觉良好	1	0	0	1	1.0
感知	1	0	0	1	1.0
感染	1	0	0	1	1.0
感慨	1	0	0	1	1.0
感想	0	0	1	1	1.0
感受一下	1	0	0	1	1.0
感化	0	1	0	1	1.0
感到遗憾	1	0	0	1	1.0
愚见	0	0	1	1	1.0
愚民	1	0	0	1	1.0
愚人节	1	0	0	1	1.0
愚人	1	0	0	1	1.0
意识形态	1	0	0	1	1.0
意淫	1	0	0	1	1.0
意欲	0	0	1	1	1.0
意料之中	0	1	0	1	1.0
意大利人	0	1	0	1	1.0
意外保险	1	0	0	1	1.0
意向	0	1	0	1	1.0
愈发	0	0	1	1	1.0
惹	0	1	0	1	1.0
想说爱	0	1	0	1	1.0
想来想去	0	0	1	1	1.0
想来	0	0	1	1	1.0
想想也是	0	1	0	1	1.0
想念	1	0	0	1	1.0
想必	0	1	0	1	1.0
想得到	1	0	0	1	1.0
想当年	1	0	0	1	1.0
想开	0	1	0	1	1.0
想尽	0	0	1	1	1.0
想去	0	0	1	1	1.0
想不通	0	1	0	1	1.0
想不起来	0	0	1	1	1.0
想不起	0	0	1	1	1.0
惯性	0	1	0	1	1.0
惯例	0	1	0	1	1.0
惯	0	1	0	1	1.0
惬意	1	0	0	1	1.0
惩治	0	1	0	1	1.0
惨白	0	0	1	1	1.0
惨状	0	1	0	1	1.0
惨淡	0	0	1	1	1.0
惨无人道	1	0	0	1	1.0
惨不忍睹	1	0	0	1	1.0
惠	0	1	0	1	1.0
惋惜	1	0	0	1	1.0
惊醒	0	1	0	1	1.0
惊艳	1	0	0	1	1.0
惊天	0	0	1	1	1.0
惊叹	0	0	1	1	1.0
惊人	1	0	0	1	1.0
情谊	0	1	0	1	1.0
情理	0	1	0	1	1.0
情有独钟	0	1	0	1	1.0
情报分析	1	0	0	1	1.0
情急	1	0	0	1	1.0
情侣	0	0	1	1	1.0
情不自禁	0	0	1	1	1.0
悲观	0	1	0	1	1.0
悲情	1	0	0	1	1.0
悲凉	0	1	0	1	1.0
悬赏	0	1	0	1	1.0
悬挂	1	0	0	1	1.0
悬念	0	1	0	1	1.0
悬崖	0	0	1	1	1.0
您们	1	0	0	1	1.0
患有	1	0	0	1	1.0
患	0	1	0	1	1.0
悠着点	0	0	1	1	1.0
悠着	0	0	1	1	1.0
悔恨	1	0	0	1	1.0
悍	0	1	0	1	1.0
恼人	0	1	0	1	1.0
恶狼	1	0	0	1	1.0
恶果	0	1	0	1	1.0
恶政	0	0	1	1	1.0
恶意	0	1	0	1	1.0
恶性循环	0	1	0	1	1.0
恶化趋势	0	1	0	1	1.0
恶劣影响	1	0	0	1	1.0
恶作剧	0	0	1	1	1.0
恶	0	1	0	1	1.0
恰恰	0	1	0	1	1.0
恰巧	0	0	1	1	1.0
恰到好处	1	0	0	1	1.0
恰似	0	0	1	1	1.0
恭祝	1	0	0	1	1.0
恭	0	0	1	1	1.0
恩平	1	0	0	1	1.0
恨之入骨	1	0	0	1	1.0
恢复正常	0	1	0	1	1.0
恐难	0	1	0	1	1.0
恐无	1	0	0	1	1.0
恐惧	1	0	0	1	1.0
恐怖活动	0	1	0	1	1.0
恍然大悟	1	0	0	1	1.0
恍然	1	0	0	1	1.0
恋	0	0	1	1	1.0
总队	0	1	0	1	1.0
总量	0	1	0	1	1.0
总计	1	0	0	1	1.0
总统令	1	0	0	1	1.0
总目	0	1	0	1	1.0
总数	0	1	0	1	1.0
总得	0	0	1	1	1.0
总局	0	1	0	1	1.0
总价	0	0	1	1	1.0
总人口	0	0	1	1	1.0
总书记	0	0	1	1	1.0
怪圈	0	1	0	1	1.0
怪事	0	1	0	1	1.0
怨天尤人	0	1	0	1	1.0
怨天	0	1	0	1	1.0
怨	0	0	1	1	1.0
性感女	0	0	1	1	1.0
性感	0	0	1	1	1.0
性情	0	0	1	1	1.0
性别歧视	0	1	0	1	1.0
急遽	0	0	1	1	1.0
急诊	0	1	0	1	1.0
急剧	0	1	0	1	1.0
急促	0	0	1	1	1.0
思议	1	0	0	1	1.0
思源	1	0	0	1	1.0
思想前卫	0	1	0	1	1.0
怕生	1	0	0	1	1.0
怒火	0	1	0	1	1.0
怒江	0	1	0	1	1.0
怎能不	0	0	1	1	1.0
怎么着	0	0	1	1	1.0
态	0	1	0	1	1.0
怀旧	1	0	0	1	1.0
怀抱	0	0	1	1	1.0
怀恋	1	0	0	1	1.0
怀化	0	0	1	1	1.0
怀了孕	0	0	1	1	1.0
忽明忽暗	0	1	0	1	1.0
忽明	0	1	0	1	1.0
念叨	0	1	0	1	1.0
快马加鞭	0	1	0	1	1.0
快速增长	0	1	0	1	1.0
快讯	0	1	0	1	1.0
快生了	1	0	0	1	1.0
快板儿	1	0	0	1	1.0
快板	1	0	0	1	1.0
快快乐乐	0	1	0	1	1.0
忧郁	0	0	1	1	1.0
忧民	0	1	0	1	1.0
忧国忧民	0	1	0	1	1.0
忧国	0	1	0	1	1.0
忠言	0	1	0	1	1.0
忠	1	0	0	1	1.0
忙活	0	0	1	1	1.0
志强	0	1	0	1	1.0
志在	1	0	0	1	1.0
忍过来	0	0	1	1	1.0
忍过	0	0	1	1	1.0
忍受	0	1	0	1	1.0
忌惮	0	0	1	1	1.0
忆起	1	0	0	1	1.0
必要性	1	0	0	1	1.0
必考	1	0	0	1	1.0
必竟	1	0	0	1	1.0
必然联系	0	0	1	1	1.0
必然结果	1	0	0	1	1.0
必有后福	0	0	1	1	1.0
必当	0	1	0	1	1.0
必定会	1	0	0	1	1.0
必修	1	0	0	1	1.0
心里话	0	1	0	1	1.0
心裁	0	1	0	1	1.0
心脏	0	1	0	1	1.0
心知肚明	1	0	0	1	1.0
心知	1	0	0	1	1.0
心眼	1	0	0	1	1.0
心目	0	1	0	1	1.0
心痛	1	0	0	1	1.0
心痒	1	0	0	1	1.0
心田	1	0	0	1	1.0
心甘情愿	0	1	0	1	1.0
心甘	0	1	0	1	1.0
心理专家	0	0	1	1	1.0
心照不宣	0	1	0	1	1.0
心照	0	1	0	1	1.0
心比天高	1	0	0	1	1.0
心欢	0	0	1	1	1.0
心机	0	0	1	1	1.0
心慌慌	1	0	0	1	1.0
心想事成	1	0	0	1	1.0
心底	1	0	0	1	1.0
心寒	0	1	0	1	1.0
心声	0	1	0	1	1.0
心力	1	0	0	1	1.0
心内	1	0	0	1	1.0
心不烦	0	1	0	1	1.0
德罗夫	0	1	0	1	1.0
德罗	0	1	0	1	1.0
德纳	0	1	0	1	1.0
德斯坦	0	0	1	1	1.0
德斯	0	0	1	1	1.0
德拉	0	1	0	1	1.0
德州	0	1	0	1	1.0
德国总理	0	0	1	1	1.0
微言	0	1	0	1	1.0
微视	0	0	1	1	1.0
微薄	0	1	0	1	1.0
微波炉	0	0	1	1	1.0
微波	0	0	1	1	1.0
微微	0	1	0	1	1.0
微克	0	0	1	1	1.0
循规蹈矩	0	1	0	1	1.0
循序渐进	1	0	0	1	1.0
循序	1	0	0	1	1.0
循	0	1	0	1	1.0
得救	0	0	1	1	1.0
得当	0	0	1	1	1.0
得以	1	0	0	1	1.0
得人心	1	0	0	1	1.0
徒步	0	1	0	1	1.0
徒增	0	1	0	1	1.0
徒	1	0	0	1	1.0
徐	0	1	0	1	1.0
律己	1	0	0	1	1.0
律动	1	0	0	1	1.0
很狡猾	1	0	0	1	1.0
很烦	1	0	0	1	1.0
很漂亮	0	0	1	1	1.0
很淡	0	1	0	1	1.0
很小	0	1	0	1	1.0
很多很多	1	0	0	1	1.0
很久没	1	0	0	1	1.0
待见	1	0	0	1	1.0
待毙	0	1	0	1	1.0
待机	1	0	0	1	1.0
待人接物	0	1	0	1	1.0
待人	0	1	0	1	1.0
待产室	1	0	0	1	1.0
径	1	0	0	1	1.0
征集	1	0	0	1	1.0
征程	1	0	0	1	1.0
征收	1	0	0	1	1.0
征地	0	0	1	1	1.0
征兆	0	1	0	1	1.0
往回	0	0	1	1	1.0
彼得罗	0	0	1	1	1.0
彼得大帝	0	1	0	1	1.0
彼一时	0	1	0	1	1.0
彻底解决	0	1	0	1	1.0
影音	0	1	0	1	1.0
影版	1	0	0	1	1.0
影片	1	0	0	1	1.0
影子	0	0	1	1	1.0
影像	1	0	0	1	1.0
影	0	0	1	1	1.0
彩花	1	0	0	1	1.0
彩票	0	0	1	1	1.0
彩头	1	0	0	1	1.0
形式主义	1	0	0	1	1.0
形容	0	1	0	1	1.0
当面	0	1	0	1	1.0
当街	0	1	0	1	1.0
当真	0	0	1	1	1.0
当晚	0	1	0	1	1.0
当家做主	0	1	0	1	1.0
当家	0	1	0	1	1.0
当官	0	1	0	1	1.0
当头一棒	1	0	0	1	1.0
当地人	0	1	0	1	1.0
当先	1	0	0	1	1.0
当众	1	0	0	1	1.0
当代	0	1	0	1	1.0
当事国	0	1	0	1	1.0
归还	1	0	0	1	1.0
归罪	1	0	0	1	1.0
归结到	0	0	1	1	1.0
归结	0	0	1	1	1.0
归来	1	0	0	1	1.0
归属	0	1	0	1	1.0
归咎于	0	0	1	1	1.0
强迫症	0	1	0	1	1.0
强盛	0	1	0	1	1.0
强烈建议	0	0	1	1	1.0
强烈呼吁	1	0	0	1	1.0
强弩之末	0	1	0	1	1.0
强奸民意	0	1	0	1	1.0
强国	1	0	0	1	1.0
强加于人	1	0	0	1	1.0
强加于	1	0	0	1	1.0
强加	1	0	0	1	1.0
强力	0	1	0	1	1.0
强制性	0	1	0	1	1.0
弱肉强食	0	1	0	1	1.0
弯路	0	0	1	1	1.0
弦	0	0	1	1	1.0
弥陀	0	0	1	1	1.0
张贴	0	1	0	1	1.0
张臭嘴	1	0	0	1	1.0
张灯结彩	1	0	0	1	1.0
张家	1	0	0	1	1.0
弟妹	1	0	0	1	1.0
弛	0	1	0	1	1.0
引述	0	1	0	1	1.0
引狼入室	0	1	0	1	1.0
引狼	0	1	0	1	1.0
引火烧身	1	0	0	1	1.0
引火	1	0	0	1	1.0
引信	1	0	0	1	1.0
引人注意	1	0	0	1	1.0
引人关注	0	0	1	1	1.0
弑	0	1	0	1	1.0
弊大于利	1	0	0	1	1.0
弊	0	1	0	1	1.0
弄完	0	0	1	1	1.0
弃物	0	1	0	1	1.0
异议	1	0	0	1	1.0
异性恋	0	0	1	1	1.0
异性	0	0	1	1	1.0
异域	1	0	0	1	1.0
异地	1	0	0	1	1.0
开阔	0	1	0	1	1.0
开门红	1	0	0	1	1.0
开销	1	0	0	1	1.0
开通	0	1	0	1	1.0
开诊	0	1	0	1	1.0
开药	0	0	1	1	1.0
开箱	0	0	1	1	1.0
开窍	0	0	1	1	1.0
开眼	0	1	0	1	1.0
开盘	1	0	0	1	1.0
开消	0	1	0	1	1.0
开枪	0	1	0	1	1.0
开春	0	0	1	1	1.0
开明	0	1	0	1	1.0
开支	0	1	0	1	1.0
开打	1	0	0	1	1.0
开店	0	0	1	1	1.0
开导	1	0	0	1	1.0
开头	0	1	0	1	1.0
开售	0	1	0	1	1.0
开口	1	0	0	1	1.0
开发商	0	1	0	1	1.0
开会	1	0	0	1	1.0
开交	0	0	1	1	1.0
开业	0	1	0	1	1.0
建言	0	1	0	1	1.0
建材	0	0	1	1	1.0
建成	0	1	0	1	1.0
建交	0	0	1	1	1.0
延误	0	1	0	1	1.0
延绵	1	0	0	1	1.0
延续性	0	1	0	1	1.0
延庆县	1	0	0	1	1.0
延庆	1	0	0	1	1.0
延安	0	1	0	1	1.0
延后	0	1	0	1	1.0
延	0	1	0	1	1.0
廊坊	0	0	1	1	1.0
康健	1	0	0	1	1.0
度日如年	1	0	0	1	1.0
度日	1	0	0	1	1.0
废纸	0	0	1	1	1.0
废物利用	0	1	0	1	1.0
废物	0	1	0	1	1.0
废弃物	0	1	0	1	1.0
废弃	0	1	0	1	1.0
废寝忘食	0	0	1	1	1.0
府	0	0	1	1	1.0
庚	0	1	0	1	1.0
庙	1	0	0	1	1.0
店门口	0	1	0	1	1.0
店门	0	1	0	1	1.0
店铺	0	1	0	1	1.0
店家	0	1	0	1	1.0
店主	0	0	1	1	1.0
底细	1	0	0	1	1.0
底板	0	1	0	1	1.0
底子	0	1	0	1	1.0
应酬	0	1	0	1	1.0
应运而生	0	0	1	1	1.0
应运	0	0	1	1	1.0
应景	0	1	0	1	1.0
应付	0	0	1	1	1.0
库尔德斯坦	0	0	1	1	1.0
库	1	0	0	1	1.0
庐山	1	0	0	1	1.0
序幕	1	0	0	1	1.0
床头	0	0	1	1	1.0
床位	0	1	0	1	1.0
庆阳	0	1	0	1	1.0
庆城	0	1	0	1	1.0
庄稼	0	0	1	1	1.0
庄	0	1	0	1	1.0
广西大学	1	0	0	1	1.0
广西	1	0	0	1	1.0
广田	1	0	0	1	1.0
广泛开展	0	1	0	1	1.0
广播网	0	0	1	1	1.0
广播电视	1	0	0	1	1.0
广州市	0	1	0	1	1.0
广大群众	0	1	0	1	1.0
广大干部	0	1	0	1	1.0
广场	0	1	0	1	1.0
广东省	0	1	0	1	1.0
幽默	1	0	0	1	1.0
幽幽	0	1	0	1	1.0
幼	1	0	0	1	1.0
幸运	0	0	1	1	1.0
幸福美满	1	0	0	1	1.0
幸	1	0	0	1	1.0
并行	1	0	0	1	1.0
并入	0	1	0	1	1.0
并不知道	1	0	0	1	1.0
并不比	0	0	1	1	1.0
并不多	0	0	1	1	1.0
年青人	0	0	1	1	1.0
年青	0	0	1	1	1.0
年限	0	0	1	1	1.0
年间	0	0	1	1	1.0
年长	1	0	0	1	1.0
年轮	1	0	0	1	1.0
年终奖金	1	0	0	1	1.0
年终奖	1	0	0	1	1.0
年终	1	0	0	1	1.0
年收入	0	1	0	1	1.0
年报	0	0	1	1	1.0
年初三	1	0	0	1	1.0
年内	0	0	1	1	1.0
年份	1	0	0	1	1.0
平米	0	0	1	1	1.0
平等待遇	0	1	0	1	1.0
平稳过渡	0	1	0	1	1.0
平稳	0	1	0	1	1.0
平湖	1	0	0	1	1.0
平淡	1	0	0	1	1.0
平板	0	1	0	1	1.0
平手	0	1	0	1	1.0
平息	1	0	0	1	1.0
平心而论	1	0	0	1	1.0
平心	1	0	0	1	1.0
平庸	1	0	0	1	1.0
平头	0	0	1	1	1.0
平天下	1	0	0	1	1.0
平均气温	0	1	0	1	1.0
平反昭雪	0	1	0	1	1.0
平反	0	1	0	1	1.0
干预	1	0	0	1	1.0
干部职工	0	1	0	1	1.0
干道	1	0	0	1	1.0
干系	0	1	0	1	1.0
干粮	1	0	0	1	1.0
干爹	0	1	0	1	1.0
干燥	0	0	1	1	1.0
干果	1	0	0	1	1.0
干干净净	0	1	0	1	1.0
干儿子	0	1	0	1	1.0
幂	0	0	1	1	1.0
常驻	0	0	1	1	1.0
常规	0	1	0	1	1.0
常人	1	0	0	1	1.0
帷幕	0	1	0	1	1.0
帮帮	0	1	0	1	1.0
帮主	0	1	0	1	1.0
席卷	1	0	0	1	1.0
带队	0	0	1	1	1.0
带走	1	0	0	1	1.0
带薪	0	1	0	1	1.0
带给	0	0	1	1	1.0
带环	0	0	1	1	1.0
带头	0	1	0	1	1.0
带上	1	0	0	1	1.0
帝国时代	0	1	0	1	1.0
帝国大厦	0	0	1	1	1.0
帝国主义	0	1	0	1	1.0
帕尔米	1	0	0	1	1.0
帐	0	1	0	1	1.0
希冀	1	0	0	1	1.0
希	0	0	1	1	1.0
师范生	0	1	0	1	1.0
师范大学	1	0	0	1	1.0
师出无名	0	1	0	1	1.0
师兄	0	1	0	1	1.0
帆	1	0	0	1	1.0
帅气	1	0	0	1	1.0
布置	1	0	0	1	1.0
布施	1	0	0	1	1.0
布娃娃	1	0	0	1	1.0
布丁	1	0	0	1	1.0
市报	1	0	0	1	1.0
市局	0	0	1	1	1.0
市容	0	1	0	1	1.0
市委书记	0	1	0	1	1.0
市场监管	0	1	0	1	1.0
市场前景	0	0	1	1	1.0
市南	1	0	0	1	1.0
市内	0	1	0	1	1.0
市中心	1	0	0	1	1.0
巾	1	0	0	1	1.0
巴黎和会	0	1	0	1	1.0
巴蜀	1	0	0	1	1.0
巴甫洛夫	0	0	1	1	1.0
巴甫洛	0	0	1	1	1.0
巴巴	1	0	0	1	1.0
巳	1	0	0	1	1.0
已有近	0	0	1	1	1.0
已久	1	0	0	1	1.0
己	0	1	0	1	1.0
差劲	1	0	0	1	1.0
差别	1	0	0	1	1.0
巩固	0	1	0	1	1.0
巧合	1	0	0	1	1.0
左邻右舍	1	0	0	1	1.0
左邻	1	0	0	1	1.0
左耳	0	0	1	1	1.0
工资待遇	0	1	0	1	1.0
工程项目	0	1	0	1	1.0
工学	1	0	0	1	1.0
工兵	1	0	0	1	1.0
工作者	0	1	0	1	1.0
工作室	0	1	0	1	1.0
工作人员	0	0	1	1	1.0
工人党	0	1	0	1	1.0
工业污染	1	0	0	1	1.0
巡防	0	0	1	1	1.0
巡演	1	0	0	1	1.0
巡查	1	0	0	1	1.0
巡	1	0	0	1	1.0
州	0	0	1	1	1.0
巅峰	1	0	0	1	1.0
崭新	1	0	0	1	1.0
崩溃	0	0	1	1	1.0
崔永元	1	0	0	1	1.0
岸区	0	1	0	1	1.0
岸	0	0	1	1	1.0
岳	0	1	0	1	1.0
岩	0	0	1	1	1.0
岛国	1	0	0	1	1.0
岗区	0	1	0	1	1.0
岔路	1	0	0	1	1.0
岂能	0	0	1	1	1.0
岁首	1	0	0	1	1.0
岁末	1	0	0	1	1.0
屹立	1	0	0	1	1.0
山高皇帝远	0	1	0	1	1.0
山高	0	1	0	1	1.0
山西路	0	0	1	1	1.0
山西太原	0	0	1	1	1.0
山药	1	0	0	1	1.0
山芋	1	0	0	1	1.0
山羊	0	0	1	1	1.0
山水	1	0	0	1	1.0
山村	1	0	0	1	1.0
山寺	0	0	1	1	1.0
山大	1	0	0	1	1.0
山呼	1	0	0	1	1.0
山下	1	0	0	1	1.0
屯兵	0	0	1	1	1.0
履职	0	0	1	1	1.0
履	0	1	0	1	1.0
屡试不爽	1	0	0	1	1.0
屡犯	0	0	1	1	1.0
屡次	1	0	0	1	1.0
屡屡	0	1	0	1	1.0
属实	0	0	1	1	1.0
属国	0	1	0	1	1.0
展览	1	0	0	1	1.0
展示	0	0	1	1	1.0
屋前	1	0	0	1	1.0
屋企	0	0	1	1	1.0
屈	1	0	0	1	1.0
居民点	1	0	0	1	1.0
居民区	1	0	0	1	1.0
居心	1	0	0	1	1.0
层次	0	1	0	1	1.0
层	0	1	0	1	1.0
局限性	0	0	1	1	1.0
局限	0	0	1	1	1.0
局部	0	1	0	1	1.0
局局长	0	1	0	1	1.0
尿血	0	1	0	1	1.0
尿片	0	0	1	1	1.0
尿崩	1	0	0	1	1.0
尿	1	0	0	1	1.0
尾灯	1	0	0	1	1.0
尾	1	0	0	1	1.0
尽量避免	0	0	1	1	1.0
尽量减少	0	1	0	1	1.0
尽职尽责	0	1	0	1	1.0
尽职	0	1	0	1	1.0
尽情玩乐	1	0	0	1	1.0
尽失	0	1	0	1	1.0
尼克松	0	0	1	1	1.0
尼克	0	0	1	1	1.0
尸位素餐	1	0	0	1	1.0
尸位	1	0	0	1	1.0
就读	1	0	0	1	1.0
就职	0	1	0	1	1.0
就此	0	0	1	1	1.0
就事论事	0	0	1	1	1.0
就业指导	1	0	0	1	1.0
尤为	1	0	0	1	1.0
尝试	1	0	0	1	1.0
尝尝	0	0	1	1	1.0
尘封	1	0	0	1	1.0
尖锐	1	0	0	1	1.0
尔斯	1	0	0	1	1.0
尔康	0	0	1	1	1.0
少许	1	0	0	1	1.0
少男	0	1	0	1	1.0
少爷	0	0	1	1	1.0
少废话	1	0	0	1	1.0
少少	0	1	0	1	1.0
少子	1	0	0	1	1.0
少壮	0	0	1	1	1.0
少先队员	0	1	0	1	1.0
少先队	0	1	0	1	1.0
尐	0	0	1	1	1.0
小黑	0	1	0	1	1.0
小麦	0	1	0	1	1.0
小鸟依人	0	0	1	1	1.0
小鸟	0	0	1	1	1.0
小饼	0	1	0	1	1.0
小镇	0	1	0	1	1.0
小钱	1	0	0	1	1.0
小钢炮	1	0	0	1	1.0
小轿车	0	1	0	1	1.0
小贩	1	0	0	1	1.0
小说吧	0	1	0	1	1.0
小表弟	1	0	0	1	1.0
小船	0	0	1	1	1.0
小舅	1	0	0	1	1.0
小脚	1	0	0	1	1.0
小笼包	1	0	0	1	1.0
小笼	1	0	0	1	1.0
小票	0	0	1	1	1.0
小眼	0	1	0	1	1.0
小看	1	0	0	1	1.0
小男孩	0	1	0	1	1.0
小生意	0	0	1	1	1.0
小生	0	0	1	1	1.0
小瓶	0	1	0	1	1.0
小王子	0	1	0	1	1.0
小狗	1	0	0	1	1.0
小牛	0	0	1	1	1.0
小民	0	1	0	1	1.0
小步	0	1	0	1	1.0
小手	1	0	0	1	1.0
小心翼翼	0	0	1	1	1.0
小幅	0	0	1	1	1.0
小常识	1	0	0	1	1.0
小屁孩	0	1	0	1	1.0
小家具	1	0	0	1	1.0
小家伙	1	0	0	1	1.0
小宝宝	0	1	0	1	1.0
小学同学	0	0	1	1	1.0
小媳妇	1	0	0	1	1.0
小姑子	1	0	0	1	1.0
小姑	1	0	0	1	1.0
小姐姐	1	0	0	1	1.0
小妹妹	1	0	0	1	1.0
小女生	1	0	0	1	1.0
小女孩	1	0	0	1	1.0
小城	1	0	0	1	1.0
小圆点	0	1	0	1	1.0
小喽啰	0	1	0	1	1.0
小吃	1	0	0	1	1.0
小号	0	0	1	1	1.0
小叔子	0	0	1	1	1.0
小叔	0	0	1	1	1.0
小分队	1	0	0	1	1.0
小分	1	0	0	1	1.0
小兄弟	0	0	1	1	1.0
小伙子	0	1	0	1	1.0
小人物	0	1	0	1	1.0
小人国	1	0	0	1	1.0
小于	0	1	0	1	1.0
小丫头	1	0	0	1	1.0
尊贵	1	0	0	1	1.0
尊老爱幼	1	0	0	1	1.0
尊老	1	0	0	1	1.0
尉迟	0	0	1	1	1.0
将领	1	0	0	1	1.0
将军	0	1	0	1	1.0
射出	0	1	0	1	1.0
封面	0	1	0	1	1.0
封锁	1	0	0	1	1.0
封建统治	1	0	0	1	1.0
封号	0	0	1	1	1.0
封信	1	0	0	1	1.0
寿终	0	0	1	1	1.0
导读	0	0	1	1	1.0
导语	1	0	0	1	1.0
导航	0	1	0	1	1.0
导火索	0	0	1	1	1.0
导火	0	0	1	1	1.0
导	0	0	1	1	1.0
寻衅滋事	1	0	0	1	1.0
寻衅	1	0	0	1	1.0
寻常	0	0	1	1	1.0
寻	0	0	1	1	1.0
寺庙	1	0	0	1	1.0
对错	1	0	0	1	1.0
对话	1	0	0	1	1.0
对策	0	1	0	1	1.0
对立面	0	1	0	1	1.0
对方	1	0	0	1	1.0
对接	0	0	1	1	1.0
对抗	1	0	0	1	1.0
寸铁	0	1	0	1	1.0
寡助	0	1	0	1	1.0
察觉到	0	0	1	1	1.0
察觉	0	0	1	1	1.0
察	0	1	0	1	1.0
寒门	0	1	0	1	1.0
寒心	0	0	1	1	1.0
寒山寺	0	0	1	1	1.0
寒冷	1	0	0	1	1.0
富含	1	0	0	1	1.0
富兰克林	0	1	0	1	1.0
富兰克	0	1	0	1	1.0
密码	0	0	1	1	1.0
密布	0	0	1	1	1.0
密山	0	1	0	1	1.0
密友	1	0	0	1	1.0
密切相关	1	0	0	1	1.0
密切	1	0	0	1	1.0
密云	1	0	0	1	1.0
密不可分	0	0	1	1	1.0
寄希望于	0	1	0	1	1.0
寄	1	0	0	1	1.0
宿迁	0	1	0	1	1.0
宿舍楼	0	1	0	1	1.0
宿舍	0	1	0	1	1.0
宾客	1	0	0	1	1.0
宽度	1	0	0	1	1.0
容错过	1	0	0	1	1.0
容错	1	0	0	1	1.0
容忍	1	0	0	1	1.0
容	0	1	0	1	1.0
家风	1	0	0	1	1.0
家资	0	1	0	1	1.0
家暴	0	1	0	1	1.0
家政	1	0	0	1	1.0
家庭聚会	1	0	0	1	1.0
家庭教育	1	0	0	1	1.0
家庭收入	1	0	0	1	1.0
家庭作业	0	0	1	1	1.0
家常	1	0	0	1	1.0
家学	1	0	0	1	1.0
家境	0	0	1	1	1.0
家务	1	0	0	1	1.0
家产	0	1	0	1	1.0
家事	0	0	1	1	1.0
家中	0	1	0	1	1.0
宵夜	0	1	0	1	1.0
害死	0	0	1	1	1.0
害命	0	0	1	1	1.0
宰相	0	0	1	1	1.0
宰割	0	1	0	1	1.0
宫颈	1	0	0	1	1.0
宫口	1	0	0	1	1.0
室外	0	1	0	1	1.0
宣告	0	1	0	1	1.0
客观规律	0	1	0	1	1.0
客源	0	0	1	1	1.0
客栈	0	1	0	1	1.0
客属	1	0	0	1	1.0
审核	0	1	0	1	1.0
审查	0	0	1	1	1.0
审慎	1	0	0	1	1.0
实验	0	0	1	1	1.0
实际操作	1	0	0	1	1.0
实际意义	0	1	0	1	1.0
实质性	0	1	0	1	1.0
实质	0	1	0	1	1.0
实证	0	0	1	1	1.0
实枪	0	1	0	1	1.0
实有	0	1	0	1	1.0
实情	0	1	0	1	1.0
实属	0	1	0	1	1.0
实实在在	0	1	0	1	1.0
实实在	0	1	0	1	1.0
实体店	0	1	0	1	1.0
实事	0	1	0	1	1.0
实为	0	1	0	1	1.0
宝马	0	0	1	1	1.0
宝通	0	1	0	1	1.0
宝贵	1	0	0	1	1.0
宝贝疙瘩	1	0	0	1	1.0
宝典	0	0	1	1	1.0
宜	0	1	0	1	1.0
定西	0	1	0	1	1.0
定点医院	0	1	0	1	1.0
定点	0	1	0	1	1.0
定制	0	0	1	1	1.0
定做	0	0	1	1	1.0
定会	1	0	0	1	1.0
定下	1	0	0	1	1.0
官逼民反	0	1	0	1	1.0
官老爷	0	1	0	1	1.0
官方消息	0	1	0	1	1.0
官府	0	1	0	1	1.0
官僚机构	0	1	0	1	1.0
官位	1	0	0	1	1.0
宗子	1	0	0	1	1.0
完败	1	0	0	1	1.0
完蛋	0	1	0	1	1.0
完胜	1	0	0	1	1.0
完结	1	0	0	1	1.0
完满	0	0	1	1	1.0
完毕	0	1	0	1	1.0
完成使命	0	1	0	1	1.0
完小	1	0	0	1	1.0
完完全全	0	1	0	1	1.0
完全符合	0	1	0	1	1.0
完全同意	0	0	1	1	1.0
安静下来	0	0	1	1	1.0
安胎	1	0	0	1	1.0
安监局	0	1	0	1	1.0
安然	1	0	0	1	1.0
安拉	1	0	0	1	1.0
安抚	0	1	0	1	1.0
安息	1	0	0	1	1.0
安徽	1	0	0	1	1.0
安庆	0	1	0	1	1.0
安居乐业	0	1	0	1	1.0
安居	0	1	0	1	1.0
安定	0	0	1	1	1.0
安安静静	0	1	0	1	1.0
安哥	1	0	0	1	1.0
安分	0	0	1	1	1.0
安全系数	0	1	0	1	1.0
安全法	0	1	0	1	1.0
安全感	0	1	0	1	1.0
安全意识	0	1	0	1	1.0
安全带	0	0	1	1	1.0
安人	1	0	0	1	1.0
守纪	0	1	0	1	1.0
守望	1	0	0	1	1.0
守寡	0	1	0	1	1.0
宇宙	0	1	0	1	1.0
宁静	0	1	0	1	1.0
宁波市	0	1	0	1	1.0
宁愿	0	1	0	1	1.0
宁乡	0	1	0	1	1.0
孱弱	0	1	0	1	1.0
学长	0	1	0	1	1.0
学费	0	1	0	1	1.0
学说话	1	0	0	1	1.0
学说	1	0	0	1	1.0
学科	0	0	1	1	1.0
学生家长	1	0	0	1	1.0
学生会	0	0	1	1	1.0
学期	0	0	1	1	1.0
学学	1	0	0	1	1.0
学员	0	0	1	1	1.0
学历	0	1	0	1	1.0
学前教育	1	0	0	1	1.0
学前	1	0	0	1	1.0
学刊	1	0	0	1	1.0
学分	1	0	0	1	1.0
孤独寂寞	0	1	0	1	1.0
孤	0	0	1	1	1.0
季	0	1	0	1	1.0
孝顺父母	0	1	0	1	1.0
孝敬老人	0	1	0	1	1.0
孝敬	0	1	0	1	1.0
孝	0	1	0	1	1.0
孙立平	0	0	1	1	1.0
孙悟空	1	0	0	1	1.0
孙云晓	1	0	0	1	1.0
孙	0	1	0	1	1.0
存货	0	1	0	1	1.0
存疑	1	0	0	1	1.0
存活	0	0	1	1	1.0
存储空间	0	0	1	1	1.0
存储容量	0	0	1	1	1.0
孕晚期	1	0	0	1	1.0
孕早期	1	0	0	1	1.0
孕前	1	0	0	1	1.0
子弹	1	0	0	1	1.0
子弟	0	1	0	1	1.0
子夜	0	1	0	1	1.0
子会	0	1	0	1	1.0
嬷嬷	0	1	0	1	1.0
嬛	0	1	0	1	1.0
嫡子	1	0	0	1	1.0
嫡	1	0	0	1	1.0
嫌累	0	1	0	1	1.0
嫂子	1	0	0	1	1.0
嫁祸	0	1	0	1	1.0
媲美	0	1	0	1	1.0
婷婷	0	1	0	1	1.0
婵	0	1	0	1	1.0
婴幼儿	0	1	0	1	1.0
婴幼	0	1	0	1	1.0
婧	0	1	0	1	1.0
婢	0	0	1	1	1.0
婚龄	0	1	0	1	1.0
婚期	0	0	1	1	1.0
婚恋	0	1	0	1	1.0
婚嫁	1	0	0	1	1.0
婚娶	0	1	0	1	1.0
婚姻法	0	1	0	1	1.0
婚内	0	1	0	1	1.0
婚丧嫁娶	0	1	0	1	1.0
婊子	0	1	0	1	1.0
娱乐活动	1	0	0	1	1.0
娘家	1	0	0	1	1.0
娇小	1	0	0	1	1.0
娄	0	1	0	1	1.0
娃子	0	1	0	1	1.0
威风凛凛	0	1	0	1	1.0
威风	0	1	0	1	1.0
姿态	0	1	0	1	1.0
姿势	0	1	0	1	1.0
姨	0	0	1	1	1.0
姥姥家	0	0	1	1	1.0
姜	0	1	0	1	1.0
委员会	0	1	0	1	1.0
委会	1	0	0	1	1.0
委	0	1	0	1	1.0
姓名	0	0	1	1	1.0
姑苏	0	0	1	1	1.0
姑子	1	0	0	1	1.0
姑姑	1	0	0	1	1.0
姐妹花	1	0	0	1	1.0
姐俩	0	0	1	1	1.0
始祖	1	0	0	1	1.0
始于	0	1	0	1	1.0
妻子	1	0	0	1	1.0
妹夫	1	0	0	1	1.0
妳	0	1	0	1	1.0
妮	0	1	0	1	1.0
妥贴	0	1	0	1	1.0
妞	1	0	0	1	1.0
妖孽	1	0	0	1	1.0
妖	0	1	0	1	1.0
妓	0	1	0	1	1.0
妊娠	1	0	0	1	1.0
妇幼医院	0	0	1	1	1.0
妇幼保健	1	0	0	1	1.0
妇孺	1	0	0	1	1.0
妇女节	1	0	0	1	1.0
妇人之仁	0	0	1	1	1.0
妄想	1	0	0	1	1.0
妄动	1	0	0	1	1.0
妄	0	1	0	1	1.0
如皋市	1	0	0	1	1.0
如皋	1	0	0	1	1.0
如火如荼	0	1	0	1	1.0
如沐春风	1	0	0	1	1.0
如梭	0	1	0	1	1.0
如愿	1	0	0	1	1.0
如山	0	0	1	1	1.0
如前	0	1	0	1	1.0
好闻	0	0	1	1	1.0
好酷	0	1	0	1	1.0
好运	1	0	0	1	1.0
好赚	0	1	0	1	1.0
好评	1	0	0	1	1.0
好自为之	1	0	0	1	1.0
好笑	0	1	0	1	1.0
好生	1	0	0	1	1.0
好汉	0	1	0	1	1.0
好比	0	1	0	1	1.0
好极了	0	1	0	1	1.0
好戏	1	0	0	1	1.0
好彩头	1	0	0	1	1.0
好山好水	1	0	0	1	1.0
好孩子	0	0	1	1	1.0
好好儿	1	0	0	1	1.0
好坏	1	0	0	1	1.0
好喝	1	0	0	1	1.0
好几部	1	0	0	1	1.0
好人	0	1	0	1	1.0
好事儿	0	1	0	1	1.0
好了吗	1	0	0	1	1.0
好书	1	0	0	1	1.0
好下场	0	1	0	1	1.0
奸商	0	0	1	1	1.0
奸	1	0	0	1	1.0
奶酪	1	0	0	1	1.0
奴性	0	1	0	1	1.0
女职工	0	1	0	1	1.0
女老师	0	0	1	1	1.0
女童	0	1	0	1	1.0
女神	0	0	1	1	1.0
女方	0	0	1	1	1.0
女娲	1	0	0	1	1.0
女同胞	0	1	0	1	1.0
女司机	1	0	0	1	1.0
女医生	0	1	0	1	1.0
奥迪	0	0	1	1	1.0
奥运	1	0	0	1	1.0
奥斯卡	0	0	1	1	1.0
奢望	1	0	0	1	1.0
奢	0	1	0	1	1.0
套路	0	1	0	1	1.0
套用	1	0	0	1	1.0
套牢	1	0	0	1	1.0
套套	1	0	0	1	1.0
奖章	1	0	0	1	1.0
奖品	0	0	1	1	1.0
奖	0	0	1	1	1.0
奕奕	1	0	0	1	1.0
奕	1	0	0	1	1.0
奔驰	0	0	1	1	1.0
奔跑	0	0	1	1	1.0
奔波	0	1	0	1	1.0
奔小康	0	0	1	1	1.0
奔回	1	0	0	1	1.0
奔命	1	0	0	1	1.0
契机	0	0	1	1	1.0
契合点	1	0	0	1	1.0
契合	1	0	0	1	1.0
契	0	1	0	1	1.0
奏	1	0	0	1	1.0
奎	1	0	0	1	1.0
奋勇	0	1	0	1	1.0
奉还	0	0	1	1	1.0
奉行	0	1	0	1	1.0
奉献	1	0	0	1	1.0
奈	1	0	0	1	1.0
奇效	0	1	0	1	1.0
夺目	0	1	0	1	1.0
夺命	0	0	1	1	1.0
夺	1	0	0	1	1.0
夹击	0	0	1	1	1.0
头路	0	1	0	1	1.0
头脑	1	0	0	1	1.0
头羊	1	0	0	1	1.0
头晕	1	0	0	1	1.0
头子	0	1	0	1	1.0
头发	0	0	1	1	1.0
头功	0	1	0	1	1.0
头儿	0	1	0	1	1.0
头像	0	0	1	1	1.0
头一回	0	0	1	1	1.0
失道寡助	0	1	0	1	1.0
失误	0	1	0	1	1.0
失衡	0	0	1	1	1.0
失眠	0	0	1	1	1.0
失控	0	1	0	1	1.0
失所	1	0	0	1	1.0
失口	1	0	0	1	1.0
失事	1	0	0	1	1.0
失业	0	1	0	1	1.0
央行	0	0	1	1	1.0
夭寿	0	1	0	1	1.0
太难受	0	1	0	1	1.0
太阳神	0	1	0	1	1.0
太粗	0	0	1	1	1.0
太空	0	0	1	1	1.0
太短	1	0	0	1	1.0
太烂	1	0	0	1	1.0
太棒	1	0	0	1	1.0
太极拳	1	0	0	1	1.0
太极	1	0	0	1	1.0
太晚	1	0	0	1	1.0
太平天国	0	0	1	1	1.0
太合	1	0	0	1	1.0
太原市	1	0	0	1	1.0
太会	1	0	0	1	1.0
太久	1	0	0	1	1.0
天黑	0	1	0	1	1.0
天骄	0	0	1	1	1.0
天雷	0	1	0	1	1.0
天长	0	1	0	1	1.0
天蝎座	1	0	0	1	1.0
天蝎	1	0	0	1	1.0
天虹	1	0	0	1	1.0
天罡	0	1	0	1	1.0
天真	1	0	0	1	1.0
天生	0	0	1	1	1.0
天理难容	1	0	0	1	1.0
天理	1	0	0	1	1.0
天王	0	1	0	1	1.0
天津路	0	1	0	1	1.0
天津师范大学	1	0	0	1	1.0
天津市	0	1	0	1	1.0
天河城	0	1	0	1	1.0
天气预报	0	1	0	1	1.0
天气晴朗	1	0	0	1	1.0
天气形势	0	1	0	1	1.0
天暗	0	0	1	1	1.0
天星	1	0	0	1	1.0
天时地利人和	1	0	0	1	1.0
天时地利	1	0	0	1	1.0
天时	1	0	0	1	1.0
天方夜谭	0	0	1	1	1.0
天方夜	0	0	1	1	1.0
天方	0	0	1	1	1.0
天数	0	1	0	1	1.0
天平	0	0	1	1	1.0
天子	1	0	0	1	1.0
天天点	1	0	0	1	1.0
天大	0	1	0	1	1.0
天壤之别	1	0	0	1	1.0
天壤	1	0	0	1	1.0
天堂	0	1	0	1	1.0
天国	0	0	1	1	1.0
天同	1	0	0	1	1.0
天佑	1	0	0	1	1.0
天书	0	0	1	1	1.0
天下无难事	1	0	0	1	1.0
大黄	0	1	0	1	1.0
大马路	0	1	0	1	1.0
大马	0	1	0	1	1.0
大雪	0	1	0	1	1.0
大雨天	0	1	0	1	1.0
大集	1	0	0	1	1.0
大难不死	0	0	1	1	1.0
大难	0	0	1	1	1.0
大院	0	1	0	1	1.0
大闺女	0	0	1	1	1.0
大门口	1	0	0	1	1.0
大门	1	0	0	1	1.0
大部份	0	1	0	1	1.0
大转盘	1	0	0	1	1.0
大跌眼镜	1	0	0	1	1.0
大赢家	0	0	1	1	1.0
大计	0	1	0	1	1.0
大行其道	0	0	1	1	1.0
大行	0	0	1	1	1.0
大蛇丸	0	0	1	1	1.0
大葱	1	0	0	1	1.0
大菜	1	0	0	1	1.0
大节	1	0	0	1	1.0
大肚子	1	0	0	1	1.0
大肚	1	0	0	1	1.0
大米	0	0	1	1	1.0
大笔	1	0	0	1	1.0
大笑	0	1	0	1	1.0
大窑湾	0	1	0	1	1.0
大福	1	0	0	1	1.0
大祸	0	1	0	1	1.0
大神	1	0	0	1	1.0
大碗	0	0	1	1	1.0
大白	0	0	1	1	1.0
大病	0	1	0	1	1.0
大灶	1	0	0	1	1.0
大火	0	0	1	1	1.0
大清	0	1	0	1	1.0
大波	0	0	1	1	1.0
大气质量	0	1	0	1	1.0
大步	0	1	0	1	1.0
大棒	0	1	0	1	1.0
大林	0	1	0	1	1.0
大方	1	0	0	1	1.0
大排量	1	0	0	1	1.0
大把大把	0	1	0	1	1.0
大房子	0	1	0	1	1.0
大房	0	1	0	1	1.0
大戏	1	0	0	1	1.0
大意	0	1	0	1	1.0
大惊小怪	0	0	1	1	1.0
大悟县	1	0	0	1	1.0
大快朵颐	1	0	0	1	1.0
大忌	0	1	0	1	1.0
大庙	1	0	0	1	1.0
大庆	0	1	0	1	1.0
大年初三	1	0	0	1	1.0
大干	0	1	0	1	1.0
大师	0	0	1	1	1.0
大山	1	0	0	1	1.0
大屠杀	0	1	0	1	1.0
大宛	0	0	1	1	1.0
大娘	1	0	0	1	1.0
大好事	1	0	0	1	1.0
大好	1	0	0	1	1.0
大头	0	1	0	1	1.0
大夫	0	1	0	1	1.0
大大小小	1	0	0	1	1.0
大大增加	0	1	0	1	1.0
大大减少	0	1	0	1	1.0
大增	0	1	0	1	1.0
大圣	1	0	0	1	1.0
大团结	0	1	0	1	1.0
大团圆	1	0	0	1	1.0
大嘴巴	0	0	1	1	1.0
大哭	1	0	0	1	1.0
大呼小叫	0	1	0	1	1.0
大同	1	0	0	1	1.0
大吃大喝	0	1	0	1	1.0
大发	1	0	0	1	1.0
大半夜	0	1	0	1	1.0
大势	0	1	0	1	1.0
大功率	1	0	0	1	1.0
大功告成	0	1	0	1	1.0
大刀阔斧	0	1	0	1	1.0
大刀	0	1	0	1	1.0
大兵	0	1	0	1	1.0
大儿子	1	0	0	1	1.0
大儿	1	0	0	1	1.0
大便	0	1	0	1	1.0
大会	0	1	0	1	1.0
大伙儿	0	0	1	1	1.0
大众日报	0	0	1	1	1.0
大人物	0	1	0	1	1.0
大于利	1	0	0	1	1.0
大乱	1	0	0	1	1.0
大义	0	1	0	1	1.0
大为	0	1	0	1	1.0
大中华	1	0	0	1	1.0
大中	1	0	0	1	1.0
大不如前	0	1	0	1	1.0
大不一样	1	0	0	1	1.0
大三	1	0	0	1	1.0
大丈夫	1	0	0	1	1.0
够花	0	1	0	1	1.0
够种	1	0	0	1	1.0
够劲	1	0	0	1	1.0
夜里	1	0	0	1	1.0
夜空	0	1	0	1	1.0
夜明珠	1	0	0	1	1.0
夜明	1	0	0	1	1.0
多长时间	1	0	0	1	1.0
多花钱	1	0	0	1	1.0
多胞胎	0	0	1	1	1.0
多种多样	0	0	1	1	1.0
多种不同	0	0	1	1	1.0
多福	1	0	0	1	1.0
多点	0	0	1	1	1.0
多样化	1	0	0	1	1.0
多方面	1	0	0	1	1.0
多摩	1	0	0	1	1.0
多得很	0	1	0	1	1.0
多平方公里	1	0	0	1	1.0
多岁	0	1	0	1	1.0
多少岁	1	0	0	1	1.0
多子	1	0	0	1	1.0
多天	0	1	0	1	1.0
多多益善	0	1	0	1	1.0
多多少少	0	1	0	1	1.0
多分钟	0	1	0	1	1.0
多分	0	1	0	1	1.0
多位	0	0	1	1	1.0
多代	1	0	0	1	1.0
多万元	0	0	1	1	1.0
多一点	0	0	1	1	1.0
多一些	0	1	0	1	1.0
外设	1	0	0	1	1.0
外观设计	0	1	0	1	1.0
外突	1	0	0	1	1.0
外相	0	0	1	1	1.0
外电报道	0	0	1	1	1.0
外电	0	0	1	1	1.0
外环线	0	1	0	1	1.0
外来	0	1	0	1	1.0
外星人	0	1	0	1	1.0
外星	0	1	0	1	1.0
外援	1	0	0	1	1.0
外患	1	0	0	1	1.0
外婆	1	0	0	1	1.0
外太空	0	0	1	1	1.0
外国人	1	0	0	1	1.0
外务省	0	0	1	1	1.0
外务	0	0	1	1	1.0
外出	1	0	0	1	1.0
外交途径	0	1	0	1	1.0
夏至	0	1	0	1	1.0
夏	1	0	0	1	1.0
复旦大学	1	0	0	1	1.0
复旦	1	0	0	1	1.0
复位	1	0	0	1	1.0
复	0	0	1	1	1.0
备受	0	1	0	1	1.0
处警	0	1	0	1	1.0
处死	0	1	0	1	1.0
处女作	0	0	1	1	1.0
处在	0	0	1	1	1.0
壹	0	0	1	1	1.0
声称	1	0	0	1	1.0
声响	0	1	0	1	1.0
声势	1	0	0	1	1.0
声光电	0	1	0	1	1.0
声光	0	1	0	1	1.0
壮观	0	1	0	1	1.0
壮年	0	1	0	1	1.0
士	0	1	0	1	1.0
壁立千仞	0	0	1	1	1.0
壁立	0	0	1	1	1.0
墨尔本	1	0	0	1	1.0
增长速度	0	1	0	1	1.0
增长率	1	0	0	1	1.0
增重	1	0	0	1	1.0
增派	1	0	0	1	1.0
增强版	1	0	0	1	1.0
增强	1	0	0	1	1.0
增幅	0	1	0	1	1.0
墙面	0	1	0	1	1.0
墙上	0	1	0	1	1.0
墙	1	0	0	1	1.0
境外	1	0	0	1	1.0
填补	1	0	0	1	1.0
填写	0	0	1	1	1.0
填	1	0	0	1	1.0
塞进	0	1	0	1	1.0
塞车	0	1	0	1	1.0
塞住	0	0	1	1	1.0
塔尔图	1	0	0	1	1.0
塔利	0	0	1	1	1.0
塔伊	1	0	0	1	1.0
塔	1	0	0	1	1.0
塑料	0	0	1	1	1.0
塑形	1	0	0	1	1.0
塑	1	0	0	1	1.0
堪察加	0	0	1	1	1.0
堪察	0	0	1	1	1.0
堪	0	0	1	1	1.0
堆积如山	0	0	1	1	1.0
堂皇	0	1	0	1	1.0
基金	1	0	0	1	1.0
基层人民	0	1	0	1	1.0
基尼	0	0	1	1	1.0
域性	0	0	1	1	1.0
城镇化	0	1	0	1	1.0
城里	1	0	0	1	1.0
城西	0	1	0	1	1.0
城市管理者	1	0	0	1	1.0
城市污染	0	1	0	1	1.0
城市形象	1	0	0	1	1.0
城市化	0	0	1	1	1.0
城外	0	0	1	1	1.0
城堡	1	0	0	1	1.0
城内	0	1	0	1	1.0
城乡	1	0	0	1	1.0
埋汰	0	0	1	1	1.0
埋怨	0	0	1	1	1.0
埋单	1	0	0	1	1.0
垮掉	0	1	0	1	1.0
垫	1	0	0	1	1.0
垄断	0	1	0	1	1.0
垃圾桶	0	1	0	1	1.0
垃圾处理	0	1	0	1	1.0
坪坝	0	0	1	1	1.0
坦白说	0	1	0	1	1.0
坦白讲	1	0	0	1	1.0
坤	0	0	1	1	1.0
坡路	1	0	0	1	1.0
坠毁	0	1	0	1	1.0
坠楼	0	1	0	1	1.0
坠	0	0	1	1	1.0
坟山	0	1	0	1	1.0
坝区	0	0	1	1	1.0
坚持下去	0	1	0	1	1.0
坚定	0	1	0	1	1.0
坚信	1	0	0	1	1.0
块儿	0	0	1	1	1.0
坑里	1	0	0	1	1.0
坑害	0	1	0	1	1.0
坐车	1	0	0	1	1.0
坐诊	0	1	0	1	1.0
坐牢	1	0	0	1	1.0
坐火车	0	1	0	1	1.0
坐地铁	0	0	1	1	1.0
坐以待毙	0	1	0	1	1.0
坏死	0	1	0	1	1.0
坏掉	1	0	0	1	1.0
坏人	0	1	0	1	1.0
均衡	0	1	0	1	1.0
场面话	0	0	1	1	1.0
场地	1	0	0	1	1.0
地面部队	1	0	0	1	1.0
地震	0	1	0	1	1.0
地表	0	1	0	1	1.0
地盘	0	0	1	1	1.0
地瓜	0	0	1	1	1.0
地理位置	0	0	1	1	1.0
地理	0	0	1	1	1.0
地步	1	0	0	1	1.0
地板	1	0	0	1	1.0
地形	0	0	1	1	1.0
地域	0	0	1	1	1.0
地坪	0	1	0	1	1.0
地址	1	0	0	1	1.0
地图	0	1	0	1	1.0
地区性	0	0	1	1	1.0
地动山摇	0	1	0	1	1.0
地动	0	1	0	1	1.0
地利人和	1	0	0	1	1.0
地利	1	0	0	1	1.0
地儿	0	1	0	1	1.0
地中海	0	1	0	1	1.0
地中	0	1	0	1	1.0
地下室	0	1	0	1	1.0
地下	0	1	0	1	1.0
圩	0	1	0	1	1.0
在读	1	0	0	1	1.0
在职	0	1	0	1	1.0
在编	1	0	0	1	1.0
在生活中	0	0	1	1	1.0
在案	0	1	0	1	1.0
在手	1	0	0	1	1.0
在我心中	1	0	0	1	1.0
在实践中	0	0	1	1	1.0
在世	0	1	0	1	1.0
圣诞老人	1	0	0	1	1.0
圣诞礼物	0	0	1	1	1.0
圣诞树	1	0	0	1	1.0
圣诞卡	1	0	0	1	1.0
圣诗	1	0	0	1	1.0
圣母	1	0	0	1	1.0
土黄色	0	0	1	1	1.0
土黄	0	0	1	1	1.0
土耳其政府	0	1	0	1	1.0
土耳其人	1	0	0	1	1.0
土尔其	0	1	0	1	1.0
土包子	1	0	0	1	1.0
土包	1	0	0	1	1.0
圈钱	0	1	0	1	1.0
圈里	1	0	0	1	1.0
圈套	0	1	0	1	1.0
圈围	1	0	0	1	1.0
圆脸	0	0	1	1	1.0
圆点	0	1	0	1	1.0
圆滑	1	0	0	1	1.0
圆月	1	0	0	1	1.0
圆弧	1	0	0	1	1.0
圆场	0	0	1	1	1.0
圆圆的	1	0	0	1	1.0
圆圆	1	0	0	1	1.0
圆	1	0	0	1	1.0
图集	1	0	0	1	1.0
图说	1	0	0	1	1.0
图森	1	0	0	1	1.0
图样	0	1	0	1	1.0
图文	1	0	0	1	1.0
图库	0	0	1	1	1.0
国际部	0	1	0	1	1.0
国际法	0	1	0	1	1.0
国际事务	1	0	0	1	1.0
国贼	0	1	0	1	1.0
国航	0	1	0	1	1.0
国联军	0	1	0	1	1.0
国联	0	1	0	1	1.0
国策	0	1	0	1	1.0
国税	1	0	0	1	1.0
国王	0	1	0	1	1.0
国歌	1	0	0	1	1.0
国库	0	1	0	1	1.0
国家邮政局	0	0	1	1	1.0
国家级	0	1	0	1	1.0
国家有关	0	0	1	1	1.0
国家所有	0	1	0	1	1.0
国大	0	0	1	1	1.0
国境	0	0	1	1	1.0
国土	0	1	0	1	1.0
国务秘书	1	0	0	1	1.0
国利民	0	0	1	1	1.0
国利	0	0	1	1	1.0
国内新闻	1	0	0	1	1.0
国会	1	0	0	1	1.0
国企	1	0	0	1	1.0
国产品牌	0	1	0	1	1.0
国主	0	1	0	1	1.0
固有	0	0	1	1	1.0
固执	1	0	0	1	1.0
固定资产	1	0	0	1	1.0
固体废弃物	0	1	0	1	1.0
固体	0	1	0	1	1.0
围追堵截	0	1	0	1	1.0
围追	0	1	0	1	1.0
围绕	0	1	0	1	1.0
围炉	1	0	0	1	1.0
围桌	1	0	0	1	1.0
困扰	0	1	0	1	1.0
困境	0	0	1	1	1.0
囤	0	1	0	1	1.0
团队	0	0	1	1	1.0
团购	1	0	0	1	1.0
团年饭	0	1	0	1	1.0
团委	1	0	0	1	1.0
团圆节	1	0	0	1	1.0
团圆夜	1	0	0	1	1.0
团体	0	1	0	1	1.0
囡	0	1	0	1	1.0
因果	1	0	0	1	1.0
因地制宜	0	1	0	1	1.0
因人而异	1	0	0	1	1.0
因人	1	0	0	1	1.0
回龙观	0	1	0	1	1.0
回龙	0	1	0	1	1.0
回避	0	1	0	1	1.0
回过头来	0	1	0	1	1.0
回购	0	1	0	1	1.0
回访	0	0	1	1	1.0
回生	0	1	0	1	1.0
回炉	0	0	1	1	1.0
回民	0	1	0	1	1.0
回暖	0	0	1	1	1.0
回族	0	1	0	1	1.0
回旋	1	0	0	1	1.0
回敬	1	0	0	1	1.0
回放	1	0	0	1	1.0
回报	1	0	0	1	1.0
回手	1	0	0	1	1.0
回想	0	1	0	1	1.0
回忆起	1	0	0	1	1.0
回得去	0	0	1	1	1.0
回得	0	0	1	1	1.0
回家路上	0	1	0	1	1.0
回家吧	0	1	0	1	1.0
回娘家	1	0	0	1	1.0
回头路	0	1	0	1	1.0
回响	0	0	1	1	1.0
回味无穷	0	0	1	1	1.0
回不来	0	1	0	1	1.0
四遍	1	0	0	1	1.0
四边	0	1	0	1	1.0
四轮	0	1	0	1	1.0
四起	0	0	1	1	1.0
四等	0	0	1	1	1.0
四百	0	1	0	1	1.0
四点	0	1	0	1	1.0
四溅	0	0	1	1	1.0
四海	1	0	0	1	1.0
四朵	1	0	0	1	1.0
四川盆地	0	1	0	1	1.0
四川	0	1	0	1	1.0
四岁	0	0	1	1	1.0
四届	1	0	0	1	1.0
四射	0	0	1	1	1.0
四响	0	0	1	1	1.0
四周	0	1	0	1	1.0
四号线	1	0	0	1	1.0
四号	1	0	0	1	1.0
四叶草	0	0	1	1	1.0
四叶	0	0	1	1	1.0
四口	1	0	0	1	1.0
四十几岁	0	1	0	1	1.0
四十五分	1	0	0	1	1.0
四十五	1	0	0	1	1.0
四分之三	0	1	0	1	1.0
四分之一	0	1	0	1	1.0
四位	0	1	0	1	1.0
四五岁	1	0	0	1	1.0
四五	1	0	0	1	1.0
四万	0	1	0	1	1.0
嚷	0	1	0	1	1.0
嚎哭	0	1	0	1	1.0
嚎	0	0	1	1	1.0
噼啪	0	1	0	1	1.0
噶	0	1	0	1	1.0
噪声污染	0	1	0	1	1.0
噜	1	0	0	1	1.0
噗	1	0	0	1	1.0
噌	1	0	0	1	1.0
嘿嘿嘿	0	0	1	1	1.0
嘿嘿	0	0	1	1	1.0
嘿	1	0	0	1	1.0
嘲热	0	0	1	1	1.0
嘟囔	0	0	1	1	1.0
嘟嘟	0	1	0	1	1.0
嘞	0	0	1	1	1.0
嘚	0	0	1	1	1.0
嘉陵江	1	0	0	1	1.0
嘉陵	1	0	0	1	1.0
嘉许	1	0	0	1	1.0
嘉兴	0	1	0	1	1.0
嘈	1	0	0	1	1.0
嗲	0	1	0	1	1.0
喽啰	0	1	0	1	1.0
喽	1	0	0	1	1.0
喷花	0	1	0	1	1.0
喷出来	1	0	0	1	1.0
喝醉酒	0	0	1	1	1.0
喝醉	0	0	1	1	1.0
喝酒	0	1	0	1	1.0
喝西北风	0	0	1	1	1.0
喝茶	1	0	0	1	1.0
喝水	1	0	0	1	1.0
喜马拉雅	0	1	0	1	1.0
喜马拉	0	1	0	1	1.0
喜闻乐见	0	1	0	1	1.0
喜闻	0	1	0	1	1.0
喜酒	0	0	1	1	1.0
喜洋洋	0	1	0	1	1.0
喜洋	0	1	0	1	1.0
喜怒哀乐	1	0	0	1	1.0
喜怒	1	0	0	1	1.0
喜帖	0	0	1	1	1.0
喜好	0	1	0	1	1.0
喜剧效果	0	0	1	1	1.0
喜剧	0	0	1	1	1.0
喜事	0	1	0	1	1.0
喜临门	0	0	1	1	1.0
喘息	0	0	1	1	1.0
喘	0	1	0	1	1.0
喊话	0	1	0	1	1.0
喇叭声	0	0	1	1	1.0
善良	0	1	0	1	1.0
善心	1	0	0	1	1.0
善举	0	1	0	1	1.0
喂饱	1	0	0	1	1.0
啼笑皆非	1	0	0	1	1.0
啼笑	1	0	0	1	1.0
啪	1	0	0	1	1.0
啧啧	0	0	1	1	1.0
啧	0	0	1	1	1.0
啥子	0	1	0	1	1.0
啤	0	1	0	1	1.0
啊呀呀	1	0	0	1	1.0
啊呀	1	0	0	1	1.0
商铺	0	1	0	1	1.0
商量余地	0	1	0	1	1.0
商讨	0	1	0	1	1.0
商船队	0	1	0	1	1.0
商船	0	1	0	1	1.0
商户	0	1	0	1	1.0
商定	0	1	0	1	1.0
商城	0	1	0	1	1.0
商圈	1	0	0	1	1.0
商品	0	1	0	1	1.0
商业模式	0	0	1	1	1.0
商业区	0	1	0	1	1.0
商业化	1	0	0	1	1.0
商丘	0	0	1	1	1.0
商	1	0	0	1	1.0
唾骂	0	1	0	1	1.0
唾液酸	1	0	0	1	1.0
唾液	1	0	0	1	1.0
唾	1	0	0	1	1.0
唻	1	0	0	1	1.0
唱戏	1	0	0	1	1.0
唱反调	0	1	0	1	1.0
唱反	0	1	0	1	1.0
唱功	0	0	1	1	1.0
唯美	0	0	1	1	1.0
唯有	1	0	0	1	1.0
唯恐天下	0	0	1	1	1.0
唯恐	0	0	1	1	1.0
唯利是图	0	1	0	1	1.0
售罄	0	0	1	1	1.0
售后	0	1	0	1	1.0
售卖	0	1	0	1	1.0
售出	0	1	0	1	1.0
唠叨	0	0	1	1	1.0
唐朝	1	0	0	1	1.0
唐僧	1	0	0	1	1.0
唐一菲	1	0	0	1	1.0
唇齿	1	0	0	1	1.0
哼	0	1	0	1	1.0
哺乳室	0	0	1	1	1.0
哺乳	0	0	1	1	1.0
哲理	1	0	0	1	1.0
哲学	0	1	0	1	1.0
哲	0	0	1	1	1.0
哭闹	0	0	1	1	1.0
哭笑不得	0	1	0	1	1.0
哭求	0	0	1	1	1.0
哪边	0	0	1	1	1.0
哪家	1	0	0	1	1.0
哪位	0	1	0	1	1.0
哪些因素	1	0	0	1	1.0
哥哥妹妹	1	0	0	1	1.0
哥们儿	1	0	0	1	1.0
哔	0	1	0	1	1.0
哑巴亏	1	0	0	1	1.0
哑巴	1	0	0	1	1.0
哎呀	1	0	0	1	1.0
响亮	0	1	0	1	1.0
哉	1	0	0	1	1.0
哈迈德	0	0	1	1	1.0
哈罗	1	0	0	1	1.0
哈巴狗	1	0	0	1	1.0
哈巴	1	0	0	1	1.0
哈尔滨铁路局	0	1	0	1	1.0
哈哈笑	1	0	0	1	1.0
哈哈大笑	0	1	0	1	1.0
品鉴	1	0	0	1	1.0
品牌效应	0	0	1	1	1.0
哀乐	1	0	0	1	1.0
咳嗽	0	1	0	1	1.0
咳	0	0	1	1	1.0
咱家	1	0	0	1	1.0
咬牙切齿	0	1	0	1	1.0
咬伤	0	1	0	1	1.0
咫尺	1	0	0	1	1.0
咖喱鸡	0	0	1	1	1.0
咖喱	0	0	1	1	1.0
咖	0	0	1	1	1.0
咕噜	1	0	0	1	1.0
咒	0	1	0	1	1.0
和平奖	1	0	0	1	1.0
和	1	0	0	1	1.0
咋样	1	0	0	1	1.0
咋搞	1	0	0	1	1.0
咋个	0	1	0	1	1.0
咄咄逼人	0	0	1	1	1.0
咄咄怪事	0	1	0	1	1.0
命题	0	0	1	1	1.0
命令	0	1	0	1	1.0
呼声	0	1	0	1	1.0
呼唤	0	0	1	1	1.0
呼和浩特	0	1	0	1	1.0
呼呼	0	0	1	1	1.0
呼之欲出	0	0	1	1	1.0
呼	1	0	0	1	1.0
呵护	0	1	0	1	1.0
味蕾	1	0	0	1	1.0
呱唧	1	0	0	1	1.0
呱呱	1	0	0	1	1.0
周正	0	0	1	1	1.0
周易	1	0	0	1	1.0
周围环境	0	1	0	1	1.0
周刊	0	1	0	1	1.0
周二	0	0	1	1	1.0
周三	0	0	1	1	1.0
呛鼻	0	1	0	1	1.0
呕吐	1	0	0	1	1.0
告白	1	0	0	1	1.0
告状	0	1	0	1	1.0
告成	0	1	0	1	1.0
呈现出	1	0	0	1	1.0
呈	1	0	0	1	1.0
呃	1	0	0	1	1.0
吾国	0	1	0	1	1.0
吼吼	0	0	1	1	1.0
吼	0	1	0	1	1.0
吸金	1	0	0	1	1.0
吸烟	1	0	0	1	1.0
吸收	0	0	1	1	1.0
吸取教训	0	1	0	1	1.0
吸取	0	1	0	1	1.0
吸	0	1	0	1	1.0
吵架	1	0	0	1	1.0
吴江	0	1	0	1	1.0
启蒙教育	0	0	1	1	1.0
启蒙	0	0	1	1	1.0
启发	0	1	0	1	1.0
听证	0	1	0	1	1.0
听筒	0	1	0	1	1.0
听取	0	1	0	1	1.0
听力	0	1	0	1	1.0
听众	0	0	1	1	1.0
听不懂	1	0	0	1	1.0
含糊	0	1	0	1	1.0
含硫	1	0	0	1	1.0
含意	0	0	1	1	1.0
含冤	0	0	1	1	1.0
含	0	1	0	1	1.0
否决	0	1	0	1	1.0
否	1	0	0	1	1.0
吓跑	0	1	0	1	1.0
吓死人	1	0	0	1	1.0
吓坏	0	1	0	1	1.0
吓呆了	1	0	0	1	1.0
吓呆	1	0	0	1	1.0
吓不倒	1	0	0	1	1.0
向来都是	1	0	0	1	1.0
向心力	1	0	0	1	1.0
向心	1	0	0	1	1.0
向东	0	1	0	1	1.0
向下	0	0	1	1	1.0
吐痰	0	0	1	1	1.0
吏	0	1	0	1	1.0
后遗症	0	1	0	1	1.0
后遗	0	1	0	1	1.0
后腿	1	0	0	1	1.0
后脚	0	1	0	1	1.0
后羿	1	0	0	1	1.0
后继	0	1	0	1	1.0
后福	0	0	1	1	1.0
后知后觉	0	0	1	1	1.0
后生	1	0	0	1	1.0
后期	1	0	0	1	1.0
后尘	0	1	0	1	1.0
后妈	0	0	1	1	1.0
后发制人	0	0	1	1	1.0
后发	0	0	1	1	1.0
后勤	1	0	0	1	1.0
后人	0	1	0	1	1.0
名额	0	0	1	1	1.0
名词	1	0	0	1	1.0
名状	1	0	0	1	1.0
名曰	0	1	0	1	1.0
名星	1	0	0	1	1.0
名单	0	0	1	1	1.0
名不虚传	1	0	0	1	1.0
名下	0	0	1	1	1.0
同贺	0	0	1	1	1.0
同等	0	0	1	1	1.0
同盟国	1	0	0	1	1.0
同班同学	0	0	1	1	1.0
同班	0	0	1	1	1.0
同犯	1	0	0	1	1.0
同流合污	0	1	0	1	1.0
同流合	0	1	0	1	1.0
同根	0	1	0	1	1.0
同日	0	0	1	1	1.0
同族	1	0	0	1	1.0
同情心	1	0	0	1	1.0
同情	1	0	0	1	1.0
同庆	1	0	0	1	1.0
同年	0	0	1	1	1.0
同堂	1	0	0	1	1.0
同仁	0	1	0	1	1.0
同于	1	0	0	1	1.0
吊打	1	0	0	1	1.0
吊唁	1	0	0	1	1.0
吊	1	0	0	1	1.0
吉莫	1	0	0	1	1.0
吉林长春	0	0	1	1	1.0
吉林	0	0	1	1	1.0
吉他	1	0	0	1	1.0
合集	0	1	0	1	1.0
合规	1	0	0	1	1.0
合肥	1	0	0	1	1.0
合约	0	0	1	1	1.0
合租	1	0	0	1	1.0
合理性	1	0	0	1	1.0
合理合法	0	0	1	1	1.0
合法政府	0	1	0	1	1.0
合影	1	0	0	1	1.0
合合	0	1	0	1	1.0
合力	0	1	0	1	1.0
合剂	0	0	1	1	1.0
合体	0	0	1	1	1.0
合乎情理	0	1	0	1	1.0
合乎	0	1	0	1	1.0
各路人马	0	0	1	1	1.0
各行	0	1	0	1	1.0
各色	0	1	0	1	1.0
各自为政	0	1	0	1	1.0
各级	1	0	0	1	1.0
各样	1	0	0	1	1.0
各有所好	1	0	0	1	1.0
各式各样	1	0	0	1	1.0
各式	1	0	0	1	1.0
各学科	0	0	1	1	1.0
各个方面	1	0	0	1	1.0
吃饱	0	0	1	1	1.0
吃软饭	0	1	0	1	1.0
吃软	0	1	0	1	1.0
吃螃蟹	1	0	0	1	1.0
吃晚饭	0	0	1	1	1.0
吃惊	1	0	0	1	1.0
吃得消	0	1	0	1	1.0
吃喝拉撒	0	0	1	1	1.0
叹	0	0	1	1	1.0
司法考试	0	1	0	1	1.0
号码	0	0	1	1	1.0
号牌	1	0	0	1	1.0
号召力	1	0	0	1	1.0
叶草	0	0	1	1	1.0
叶	0	0	1	1	1.0
右边	1	0	0	1	1.0
右侧	0	1	0	1	1.0
右下角	0	1	0	1	1.0
右下	0	1	0	1	1.0
台阶	0	0	1	1	1.0
台词	1	0	0	1	1.0
台湾人	1	0	0	1	1.0
台历	0	0	1	1	1.0
台前	1	0	0	1	1.0
台上	1	0	0	1	1.0
可谓	0	1	0	1	1.0
可言	0	1	0	1	1.0
可行	0	1	0	1	1.0
可能性	0	0	1	1	1.0
可耻	1	0	0	1	1.0
可用	0	1	0	1	1.0
可望	0	0	1	1	1.0
可收	0	1	0	1	1.0
可控	0	1	0	1	1.0
可回忆	1	0	0	1	1.0
可喜	0	0	1	1	1.0
可分	0	0	1	1	1.0
可信	0	0	1	1	1.0
可乘之机	1	0	0	1	1.0
可乐	1	0	0	1	1.0
可不可以	0	1	0	1	1.0
可不	0	1	0	1	1.0
叮叮	1	0	0	1	1.0
召开	0	0	1	1	1.0
叫板	0	0	1	1	1.0
叫屈	0	1	0	1	1.0
叫好	0	1	0	1	1.0
只能靠	0	1	0	1	1.0
只用	0	1	0	1	1.0
只怕	1	0	0	1	1.0
另一回事	1	0	0	1	1.0
另一回	1	0	0	1	1.0
句号	1	0	0	1	1.0
古风	1	0	0	1	1.0
古道热肠	0	1	0	1	1.0
古道	0	1	0	1	1.0
古诗	0	0	1	1	1.0
古时候	1	0	0	1	1.0
古时	1	0	0	1	1.0
古建筑	0	1	0	1	1.0
古建	0	1	0	1	1.0
古城堡	1	0	0	1	1.0
古兰经	0	0	1	1	1.0
古兰	0	0	1	1	1.0
古人	0	1	0	1	1.0
口舌	0	0	1	1	1.0
口罩	0	1	0	1	1.0
口水	0	1	0	1	1.0
口气	0	0	1	1	1.0
口径	0	1	0	1	1.0
口头	1	0	0	1	1.0
口味	1	0	0	1	1.0
口吻	1	0	0	1	1.0
口令	0	1	0	1	1.0
叠加	1	0	0	1	1.0
叙政府	0	1	0	1	1.0
变相处理	0	1	0	1	1.0
变相	0	1	0	1	1.0
变样	0	1	0	1	1.0
变本加厉	0	1	0	1	1.0
变本	0	1	0	1	1.0
变更	1	0	0	1	1.0
变差	1	0	0	1	1.0
变味	0	1	0	1	1.0
变动	0	0	1	1	1.0
变冷	0	0	1	1	1.0
受骗	1	0	0	1	1.0
受让	0	1	0	1	1.0
受罪	0	1	0	1	1.0
受热捧	1	0	0	1	1.0
受热	1	0	0	1	1.0
受惊	0	1	0	1	1.0
受害者	1	0	0	1	1.0
受害	1	0	0	1	1.0
受孕率	0	0	1	1	1.0
受孕	0	0	1	1	1.0
受够了	1	0	0	1	1.0
受够	1	0	0	1	1.0
受制	0	1	0	1	1.0
取经	0	1	0	1	1.0
取回	0	1	0	1	1.0
取向	0	1	0	1	1.0
取决于	1	0	0	1	1.0
取决	1	0	0	1	1.0
取代	0	1	0	1	1.0
取义	1	0	0	1	1.0
叔子	0	0	1	1	1.0
发飙	0	0	1	1	1.0
发酵	0	1	0	1	1.0
发话	0	0	1	1	1.0
发证	0	1	0	1	1.0
发誓	0	0	1	1	1.0
发表文章	0	0	1	1	1.0
发表意见	0	0	1	1	1.0
发表声明	1	0	0	1	1.0
发育	1	0	0	1	1.0
发给	0	1	0	1	1.0
发短信	0	1	0	1	1.0
发短	0	1	0	1	1.0
发生源	0	1	0	1	1.0
发生争执	0	0	1	1	1.0
发现自己	0	1	0	1	1.0
发泄	1	0	0	1	1.0
发来	1	0	0	1	1.0
发文	1	0	0	1	1.0
发挥作用	1	0	0	1	1.0
发扬光大	1	0	0	1	1.0
发帖子	0	0	1	1	1.0
发帖	0	0	1	1	1.0
发布厅	1	0	0	1	1.0
发展壮大	0	1	0	1	1.0
发展中国家	0	1	0	1	1.0
发威	1	0	0	1	1.0
发售日	0	1	0	1	1.0
发出声音	0	1	0	1	1.0
发几张	0	0	1	1	1.0
发兵	1	0	0	1	1.0
发光	1	0	0	1	1.0
发作	0	1	0	1	1.0
发亮	0	0	1	1	1.0
反驳	0	1	0	1	1.0
反顾	1	0	0	1	1.0
反转	0	0	1	1	1.0
反贼	0	1	0	1	1.0
反调	0	1	0	1	1.0
反目	1	0	0	1	1.0
反潮流	0	0	1	1	1.0
反派	1	0	0	1	1.0
反方	0	1	0	1	1.0
反攻	1	0	0	1	1.0
反推	1	0	0	1	1.0
反手	0	0	1	1	1.0
反恐怖	0	1	0	1	1.0
反差	1	0	0	1	1.0
反对票	0	1	0	1	1.0
反复	0	0	1	1	1.0
反噬	0	0	1	1	1.0
反制	1	0	0	1	1.0
反击战	1	0	0	1	1.0
反光	0	1	0	1	1.0
双龙	1	0	0	1	1.0
双面	0	1	0	1	1.0
双重标准	1	0	0	1	1.0
双行	0	0	1	1	1.0
双职工	1	0	0	1	1.0
双眼皮	0	1	0	1	1.0
双眼	0	1	0	1	1.0
双核	0	1	0	1	1.0
双杠	1	0	0	1	1.0
双机	1	0	0	1	1.0
双手赞成	0	0	1	1	1.0
双子星	0	1	0	1	1.0
双子	0	1	0	1	1.0
双喜临门	0	0	1	1	1.0
双喜	0	0	1	1	1.0
双亲	0	0	1	1	1.0
友好相处	0	0	1	1	1.0
友好	0	0	1	1	1.0
友善	0	1	0	1	1.0
友军	0	1	0	1	1.0
及至	0	0	1	1	1.0
及时处理	0	1	0	1	1.0
参谋长	0	0	1	1	1.0
参谋	0	0	1	1	1.0
参观	0	0	1	1	1.0
参战	1	0	0	1	1.0
参加考试	0	0	1	1	1.0
参与感	1	0	0	1	1.0
县区	1	0	0	1	1.0
去过	1	0	0	1	1.0
去掉	0	1	0	1	1.0
去世	0	0	1	1	1.0
厮	1	0	0	1	1.0
厨师	1	0	0	1	1.0
厦门岛	0	0	1	1	1.0
厦	1	0	0	1	1.0
原配	0	0	1	1	1.0
原著	1	0	0	1	1.0
原生态	0	1	0	1	1.0
原汁原味	0	1	0	1	1.0
原汁	0	1	0	1	1.0
原料	1	0	0	1	1.0
原形	0	1	0	1	1.0
原封	0	1	0	1	1.0
原始时代	0	1	0	1	1.0
原型机	0	0	1	1	1.0
原型	0	0	1	1	1.0
原味	0	1	0	1	1.0
原名	0	0	1	1	1.0
原则性	1	0	0	1	1.0
原住民	0	1	0	1	1.0
厚重	1	0	0	1	1.0
厚道	1	0	0	1	1.0
厚脸皮	0	1	0	1	1.0
厚脸	0	1	0	1	1.0
厚点	1	0	0	1	1.0
厚德	0	1	0	1	1.0
厚度	1	0	0	1	1.0
厌恶	0	1	0	1	1.0
压舱	1	0	0	1	1.0
压抑	0	1	0	1	1.0
压惊	0	1	0	1	1.0
压低	0	1	0	1	1.0
厉行	0	1	0	1	1.0
历年	0	0	1	1	1.0
历史性	1	0	0	1	1.0
历代	0	1	0	1	1.0
厅级	0	1	0	1	1.0
厅	0	0	1	1	1.0
厂矿	1	0	0	1	1.0
厂	0	0	1	1	1.0
卿	0	0	1	1	1.0
卸货	1	0	0	1	1.0
卸责任	0	1	0	1	1.0
卸责	0	1	0	1	1.0
卸甲	0	1	0	1	1.0
卷土重来	0	1	0	1	1.0
却说	0	1	0	1	1.0
即墨	1	0	0	1	1.0
即告	0	0	1	1	1.0
即刻起	0	1	0	1	1.0
即刻	0	1	0	1	1.0
危在旦夕	1	0	0	1	1.0
危及	1	0	0	1	1.0
危	0	1	0	1	1.0
印第安人	1	0	0	1	1.0
印第安	1	0	0	1	1.0
卫生院	0	0	1	1	1.0
卫生间	0	0	1	1	1.0
卫生部	0	1	0	1	1.0
卫国战争	1	0	0	1	1.0
卢瑟	0	1	0	1	1.0
卢	0	0	1	1	1.0
卡菲	1	0	0	1	1.0
卡死	0	1	0	1	1.0
卡斯皮	0	0	1	1	1.0
卡斯	0	0	1	1	1.0
卡德罗夫	0	1	0	1	1.0
卡德	0	1	0	1	1.0
卡塔尔	0	0	1	1	1.0
卡塔	0	0	1	1	1.0
卡住	0	1	0	1	1.0
占据	1	0	0	1	1.0
占多数	0	1	0	1	1.0
占优势	0	1	0	1	1.0
占优	0	1	0	1	1.0
占上风	0	1	0	1	1.0
博鳌	0	0	1	1	1.0
博物馆	0	1	0	1	1.0
博物	0	1	0	1	1.0
博大	1	0	0	1	1.0
博基尼	0	0	1	1	1.0
南非	0	1	0	1	1.0
南部	0	1	0	1	1.0
南通	1	0	0	1	1.0
南边	0	1	0	1	1.0
南路	0	0	1	1	1.0
南萨哈林斯克	0	0	1	1	1.0
南瓜	0	0	1	1	1.0
南极	0	1	0	1	1.0
南来北往	0	0	1	1	1.0
南来	0	0	1	1	1.0
南昌市	0	1	0	1	1.0
南开	1	0	0	1	1.0
南岸区	0	1	0	1	1.0
南岸	0	1	0	1	1.0
南岭村	1	0	0	1	1.0
南岭	1	0	0	1	1.0
南区	1	0	0	1	1.0
南北	0	1	0	1	1.0
南侧	0	1	0	1	1.0
南京城	0	1	0	1	1.0
南亚地区	0	0	1	1	1.0
南亚	0	0	1	1	1.0
卖身	0	1	0	1	1.0
卖家	0	0	1	1	1.0
卖场	0	0	1	1	1.0
卖国贼	0	1	0	1	1.0
卖国	0	1	0	1	1.0
卖出	0	0	1	1	1.0
卖光	0	0	1	1	1.0
单身贵族	1	0	0	1	1.0
单调	0	0	1	1	1.0
单行道	0	0	1	1	1.0
单行	0	0	1	1	1.0
单练	1	0	0	1	1.0
单极	1	0	0	1	1.0
单式	1	0	0	1	1.0
单名	0	1	0	1	1.0
单县	1	0	0	1	1.0
单卡	0	1	0	1	1.0
单单	0	1	0	1	1.0
单体	0	1	0	1	1.0
卑鄙无耻	0	1	0	1	1.0
卑鄙	0	1	0	1	1.0
协调员	1	0	0	1	1.0
协处理器	0	0	1	1	1.0
华语	0	0	1	1	1.0
华盛顿	1	0	0	1	1.0
华盛	1	0	0	1	1.0
华强北	0	1	0	1	1.0
华尔街日报	0	0	1	1	1.0
华尔街	0	0	1	1	1.0
华大使	1	0	0	1	1.0
华夏民族	1	0	0	1	1.0
华北石油	0	1	0	1	1.0
华北	0	1	0	1	1.0
华侨	1	0	0	1	1.0
华人华侨	1	0	0	1	1.0
半醒	0	1	0	1	1.0
半自动化	0	1	0	1	1.0
半自动	0	1	0	1	1.0
半睡半醒	0	1	0	1	1.0
半生不熟	0	1	0	1	1.0
半生	0	1	0	1	1.0
半点	0	0	1	1	1.0
半数	0	1	0	1	1.0
半年前	1	0	0	1	1.0
半左右	0	0	1	1	1.0
半小时	0	0	1	1	1.0
半儿	0	0	1	1	1.0
半个世纪	1	0	0	1	1.0
午餐	1	0	0	1	1.0
午间	1	0	0	1	1.0
午夜	1	0	0	1	1.0
午	1	0	0	1	1.0
升迁	0	1	0	1	1.0
升起	1	0	0	1	1.0
升	0	1	0	1	1.0
千门万户	1	0	0	1	1.0
千遍	0	1	0	1	1.0
千辆	0	1	0	1	1.0
千篇一律	1	0	0	1	1.0
千篇	1	0	0	1	1.0
千百遍	0	1	0	1	1.0
千百年	0	0	1	1	1.0
千山	0	1	0	1	1.0
千家	1	0	0	1	1.0
千头万绪	1	0	0	1	1.0
千头	1	0	0	1	1.0
千名	0	1	0	1	1.0
千公里	0	1	0	1	1.0
千万头	0	1	0	1	1.0
千万别	1	0	0	1	1.0
十颗	0	1	0	1	1.0
十面	0	1	0	1	1.0
十米	0	0	1	1	1.0
十来天	0	0	1	1	1.0
十来	0	0	1	1	1.0
十月	0	0	1	1	1.0
十年代	0	0	1	1	1.0
十岁	1	0	0	1	1.0
十封信	1	0	0	1	1.0
十封	1	0	0	1	1.0
十字路口	0	0	1	1	1.0
十字路	0	0	1	1	1.0
十字星	1	0	0	1	1.0
十多岁	0	1	0	1	1.0
十多分钟	0	1	0	1	1.0
十多分	0	1	0	1	1.0
十多个	1	0	0	1	1.0
十多万元	0	0	1	1	1.0
十四	1	0	0	1	1.0
十分钟	1	0	0	1	1.0
十分复杂	0	1	0	1	1.0
十几里	1	0	0	1	1.0
十几天	1	0	0	1	1.0
十几万	0	0	1	1	1.0
十八天	0	0	1	1	1.0
十元	0	0	1	1	1.0
十五年	1	0	0	1	1.0
十五分	1	0	0	1	1.0
十五六岁	1	0	0	1	1.0
十五六	1	0	0	1	1.0
十五万	0	1	0	1	1.0
十九号	1	0	0	1	1.0
十九	1	0	0	1	1.0
十个月	1	0	0	1	1.0
十三幺	1	0	0	1	1.0
十万元	0	1	0	1	1.0
十一楼	1	0	0	1	1.0
十一月	0	0	1	1	1.0
匿名	0	0	1	1	1.0
医药	0	0	1	1	1.0
医病	1	0	0	1	1.0
医疗保险	1	0	0	1	1.0
医护人员	0	0	1	1	1.0
医护	0	0	1	1	1.0
医患	0	1	0	1	1.0
医师	1	0	0	1	1.0
医	0	1	0	1	1.0
区域环境	1	0	0	1	1.0
区域性	0	0	1	1	1.0
区域化	0	0	1	1	1.0
区别对待	1	0	0	1	1.0
区分	0	0	1	1	1.0
匹配	0	1	0	1	1.0
匹夫	1	0	0	1	1.0
匪	1	0	0	1	1.0
北风	0	0	1	1	1.0
北非	1	0	0	1	1.0
北青报	0	0	1	1	1.0
北边	0	1	0	1	1.0
北疆	0	0	1	1	1.0
北地	1	0	0	1	1.0
北国	1	0	0	1	1.0
北侧	0	1	0	1	1.0
北京大学法学院	0	0	1	1	1.0
北京大学	0	0	1	1	1.0
北京地铁	1	0	0	1	1.0
化装	0	0	1	1	1.0
化粪池	0	1	0	1	1.0
化碳	0	1	0	1	1.0
化氮	0	1	0	1	1.0
化氢	0	1	0	1	1.0
化州	0	1	0	1	1.0
化学物质	0	1	0	1	1.0
化学	0	1	0	1	1.0
化妆品	0	1	0	1	1.0
化妆	0	1	0	1	1.0
匆匆	0	0	1	1	1.0
匆	0	1	0	1	1.0
包装盒	0	0	1	1	1.0
包袱	0	1	0	1	1.0
包庇	1	0	0	1	1.0
勾连	0	1	0	1	1.0
勾当	1	0	0	1	1.0
勤政	0	1	0	1	1.0
勤劳勇敢	1	0	0	1	1.0
勤俭节约	0	1	0	1	1.0
勤俭	0	1	0	1	1.0
勤	1	0	0	1	1.0
勒索	1	0	0	1	1.0
勒死	0	0	1	1	1.0
勋	1	0	0	1	1.0
勇斗	1	0	0	1	1.0
勇于	0	1	0	1	1.0
势必会	0	1	0	1	1.0
势头	0	1	0	1	1.0
势	0	0	1	1	1.0
劳逸结合	0	1	0	1	1.0
劳逸	0	1	0	1	1.0
劳资	0	1	0	1	1.0
劳动量	0	1	0	1	1.0
劳动节	0	1	0	1	1.0
劳动就业	0	1	0	1	1.0
劳作	0	1	0	1	1.0
劲儿	1	0	0	1	1.0
劫持	0	0	1	1	1.0
劫	0	1	0	1	1.0
助纣为虐	0	0	1	1	1.0
助手	1	0	0	1	1.0
助力	0	1	0	1	1.0
动量	0	1	0	1	1.0
动画	0	0	1	1	1.0
动漫	1	0	0	1	1.0
动武	1	0	0	1	1.0
动机	0	0	1	1	1.0
动摇	1	0	0	1	1.0
动态	1	0	0	1	1.0
动员	1	0	0	1	1.0
动动	1	0	0	1	1.0
务实	1	0	0	1	1.0
加鞭	0	1	0	1	1.0
加速	0	0	1	1	1.0
加考	0	0	1	1	1.0
加紧	0	1	0	1	1.0
加盟店	0	0	1	1	1.0
加班费	1	0	0	1	1.0
加点	0	1	0	1	1.0
加深	1	0	0	1	1.0
加收	0	1	0	1	1.0
加持	0	1	0	1	1.0
加快脚步	1	0	0	1	1.0
加快	1	0	0	1	1.0
加工业	0	0	1	1	1.0
加工	0	0	1	1	1.0
加增	0	1	0	1	1.0
加价	0	0	1	1	1.0
加以解决	0	0	1	1	1.0
加于	1	0	0	1	1.0
功课	1	0	0	1	1.0
功能性	1	0	0	1	1.0
功能化	0	0	1	1	1.0
功德	0	1	0	1	1.0
办证	0	1	0	1	1.0
办校	0	1	0	1	1.0
办事效率	0	1	0	1	1.0
劝告	0	1	0	1	1.0
力道	0	0	1	1	1.0
力证	0	0	1	1	1.0
力行	0	1	0	1	1.0
力荐	1	0	0	1	1.0
力所能及	0	1	0	1	1.0
力争	0	1	0	1	1.0
劈	0	1	0	1	1.0
割舍	1	0	0	1	1.0
割爱	0	1	0	1	1.0
割地	0	1	0	1	1.0
割	0	1	0	1	1.0
副职	0	0	1	1	1.0
副局长	0	1	0	1	1.0
副外长	1	0	0	1	1.0
副作用	1	0	0	1	1.0
剪影	1	0	0	1	1.0
剩余	0	1	0	1	1.0
剧痛	1	0	0	1	1.0
剧烈	0	1	0	1	1.0
剥开	1	0	0	1	1.0
剖腹产	1	0	0	1	1.0
剖腹	1	0	0	1	1.0
剖	1	0	0	1	1.0
前途	0	0	1	1	1.0
前辈	1	0	0	1	1.0
前路	1	0	0	1	1.0
前赴后继	0	1	0	1	1.0
前言	0	0	1	1	1.0
前脚	0	1	0	1	1.0
前线	0	1	0	1	1.0
前期	0	1	0	1	1.0
前日	0	1	0	1	1.0
前方	0	0	1	1	1.0
前往	0	0	1	1	1.0
前台	0	1	0	1	1.0
前卫	0	1	0	1	1.0
前几日	0	1	0	1	1.0
前些年	0	1	0	1	1.0
前些	0	1	0	1	1.0
前不久	0	1	0	1	1.0
削足适履	0	1	0	1	1.0
削弱	0	0	1	1	1.0
削减	0	1	0	1	1.0
剂	1	0	0	1	1.0
刻舟求剑	0	1	0	1	1.0
刻意	1	0	0	1	1.0
刻	0	1	0	1	1.0
刺耳	1	0	0	1	1.0
刺痛	0	1	0	1	1.0
刺伤	0	1	0	1	1.0
刹时	1	0	0	1	1.0
刹	1	0	0	1	1.0
券商	1	0	0	1	1.0
刷牙	1	0	0	1	1.0
刷屏	0	1	0	1	1.0
制造矛盾	0	1	0	1	1.0
制造事端	1	0	0	1	1.0
制造业	0	0	1	1	1.0
制衡	1	0	0	1	1.0
制版	0	1	0	1	1.0
制止	1	0	0	1	1.0
制服	1	0	0	1	1.0
制宜	0	1	0	1	1.0
制动	0	1	0	1	1.0
制作方法	0	0	1	1	1.0
制作方	0	0	1	1	1.0
制	0	1	0	1	1.0
到访	0	1	0	1	1.0
到来之际	1	0	0	1	1.0
到期	0	0	1	1	1.0
到头来	1	0	0	1	1.0
到处跑	1	0	0	1	1.0
刮风下雨	0	1	0	1	1.0
刮过	1	0	0	1	1.0
别针	0	0	1	1	1.0
别跟我	0	1	0	1	1.0
别理	1	0	0	1	1.0
别样	1	0	0	1	1.0
别有用心	1	0	0	1	1.0
别扭	0	1	0	1	1.0
别家	0	1	0	1	1.0
别国	1	0	0	1	1.0
别出心裁	0	1	0	1	1.0
别以为	1	0	0	1	1.0
利空	0	0	1	1	1.0
利益集团	1	0	0	1	1.0
利益者	0	0	1	1	1.0
利益冲突	0	0	1	1	1.0
利率	0	1	0	1	1.0
利是	0	1	0	1	1.0
利弊	0	1	0	1	1.0
利好	0	0	1	1	1.0
利多	0	1	0	1	1.0
利国利民	0	0	1	1	1.0
利国	0	0	1	1	1.0
刨	1	0	0	1	1.0
判刑	0	1	0	1	1.0
初现	1	0	0	1	1.0
初十	0	0	1	1	1.0
初六	1	0	0	1	1.0
初八	0	0	1	1	1.0
初体验	1	0	0	1	1.0
创意	0	1	0	1	1.0
创卫	1	0	0	1	1.0
刚过去	1	0	0	1	1.0
刚性	0	0	1	1	1.0
刘女士	0	0	1	1	1.0
列车员	0	0	1	1	1.0
列表	0	1	0	1	1.0
列	1	0	0	1	1.0
划分	0	1	0	1	1.0
划	1	0	0	1	1.0
刑拘	0	1	0	1	1.0
刊载	0	0	1	1	1.0
刊物	1	0	0	1	1.0
切齿	0	1	0	1	1.0
切身感受	1	0	0	1	1.0
切身	1	0	0	1	1.0
切莫	1	0	0	1	1.0
切腹	1	0	0	1	1.0
切断	1	0	0	1	1.0
切掉	0	1	0	1	1.0
切实	0	0	1	1	1.0
切割	1	0	0	1	1.0
切利	0	1	0	1	1.0
切	0	0	1	1	1.0
分队	1	0	0	1	1.0
分钱	1	0	0	1	1.0
分辩	0	1	0	1	1.0
分身乏术	0	0	1	1	1.0
分身	0	0	1	1	1.0
分说	0	1	0	1	1.0
分级	0	1	0	1	1.0
分类	0	1	0	1	1.0
分泌	0	0	1	1	1.0
分期	0	0	1	1	1.0
分心	0	1	0	1	1.0
分开	1	0	0	1	1.0
分崩离析	1	0	0	1	1.0
分场	0	1	0	1	1.0
分合	0	1	0	1	1.0
分化	1	0	0	1	1.0
分割	0	1	0	1	1.0
分利	0	1	0	1	1.0
分分合合	0	1	0	1	1.0
分分	0	1	0	1	1.0
分公司	0	1	0	1	1.0
分不清楚	0	1	0	1	1.0
分不清	0	1	0	1	1.0
分不开	1	0	0	1	1.0
刁民	0	1	0	1	1.0
刁	1	0	0	1	1.0
刀笔	0	1	0	1	1.0
刀子	0	1	0	1	1.0
刀口	0	1	0	1	1.0
刀具厂	0	1	0	1	1.0
刀俎	0	1	0	1	1.0
击毙	1	0	0	1	1.0
击毁	0	1	0	1	1.0
出难题	1	0	0	1	1.0
出阵	1	0	0	1	1.0
出门在外	0	1	0	1	1.0
出钱	0	1	0	1	1.0
出远门	0	1	0	1	1.0
出轨	0	0	1	1	1.0
出车祸	0	1	0	1	1.0
出车	0	1	0	1	1.0
出身	0	1	0	1	1.0
出自	1	0	0	1	1.0
出生日期	1	0	0	1	1.0
出生人数	0	0	1	1	1.0
出版社	1	0	0	1	1.0
出版	1	0	0	1	1.0
出点	0	1	0	1	1.0
出海	1	0	0	1	1.0
出新	0	1	0	1	1.0
出彩	0	1	0	1	1.0
出奇	0	0	1	1	1.0
出声	0	1	0	1	1.0
出勤	0	1	0	1	1.0
出关	0	1	0	1	1.0
出入口	0	0	1	1	1.0
出众	1	0	0	1	1.0
出份子	0	0	1	1	1.0
出世	0	1	0	1	1.0
凸显出	0	1	0	1	1.0
凶手	0	1	0	1	1.0
凶器	0	1	0	1	1.0
凯撒大帝	1	0	0	1	1.0
凯撒	1	0	0	1	1.0
凭良心	1	0	0	1	1.0
凤凰卫视	0	0	1	1	1.0
几里	1	0	0	1	1.0
几部	1	0	0	1	1.0
几秒钟	0	0	1	1	1.0
几秒	0	0	1	1	1.0
几百米	1	0	0	1	1.0
几率	1	0	0	1	1.0
几款	1	0	0	1	1.0
几架	0	1	0	1	1.0
几朵	0	0	1	1	1.0
几月	1	0	0	1	1.0
几无二致	1	0	0	1	1.0
几招	1	0	0	1	1.0
几把	0	1	0	1	1.0
几座	0	0	1	1	1.0
几家愁	0	1	0	1	1.0
几处	0	1	0	1	1.0
几圈	1	0	0	1	1.0
几台	1	0	0	1	1.0
几十米	0	0	1	1	1.0
几十元	0	0	1	1	1.0
几十个	0	1	0	1	1.0
几何	1	0	0	1	1.0
几任	0	1	0	1	1.0
几代	0	1	0	1	1.0
几亿	1	0	0	1	1.0
几万块	1	0	0	1	1.0
凛凛	0	1	0	1	1.0
减速	1	0	0	1	1.0
减弱	1	0	0	1	1.0
减小	0	0	1	1	1.0
减压	1	0	0	1	1.0
减低	1	0	0	1	1.0
减产	0	1	0	1	1.0
准谱	0	1	0	1	1.0
准确无误	0	1	0	1	1.0
准确	0	1	0	1	1.0
准时	0	0	1	1	1.0
准妈妈	1	0	0	1	1.0
凄惨	0	1	0	1	1.0
净空	0	0	1	1	1.0
冷色调	1	0	0	1	1.0
冷色	1	0	0	1	1.0
冷清	0	1	0	1	1.0
冷淡	0	1	0	1	1.0
冷战	1	0	0	1	1.0
冷寂	0	0	1	1	1.0
冷嘲热讽	0	0	1	1	1.0
冷嘲	0	0	1	1	1.0
冷冰冰	0	1	0	1	1.0
冷不丁	1	0	0	1	1.0
决议	0	1	0	1	1.0
决裂	1	0	0	1	1.0
决策层	0	0	1	1	1.0
决定性	0	1	0	1	1.0
决不	0	1	0	1	1.0
决一死战	0	1	0	1	1.0
冲锋枪	0	0	1	1	1.0
冲锋	0	0	1	1	1.0
冲过来	1	0	0	1	1.0
冲过	1	0	0	1	1.0
冰鞋	0	0	1	1	1.0
冰雪	1	0	0	1	1.0
冰凉	0	0	1	1	1.0
冰冰	0	1	0	1	1.0
冰	0	0	1	1	1.0
冬至	1	0	0	1	1.0
冬春	1	0	0	1	1.0
冥冥之中	0	0	1	1	1.0
冥冥	0	0	1	1	1.0
冥	0	1	0	1	1.0
冤案	0	1	0	1	1.0
冤枉	1	0	0	1	1.0
冤大头	0	1	0	1	1.0
冠冕堂皇	0	1	0	1	1.0
冠冕	0	1	0	1	1.0
农家院	1	0	0	1	1.0
农家	1	0	0	1	1.0
农地	1	0	0	1	1.0
农业	1	0	0	1	1.0
农	0	1	0	1	1.0
军费	1	0	0	1	1.0
军舰	1	0	0	1	1.0
军火	1	0	0	1	1.0
军旗	1	0	0	1	1.0
军方	0	1	0	1	1.0
军官	1	0	0	1	1.0
军力	1	0	0	1	1.0
军事基地	0	1	0	1	1.0
军中	1	0	0	1	1.0
写道	0	0	1	1	1.0
写给	1	0	0	1	1.0
写字台	0	0	1	1	1.0
写字	0	0	1	1	1.0
写到	0	0	1	1	1.0
写信	1	0	0	1	1.0
写下	0	0	1	1	1.0
冒出来	1	0	0	1	1.0
冒出	1	0	0	1	1.0
再起	0	1	0	1	1.0
再现	0	1	0	1	1.0
再来一个	1	0	0	1	1.0
再来	1	0	0	1	1.0
再战	1	0	0	1	1.0
再也不会	0	1	0	1	1.0
内需	1	0	0	1	1.0
内部矛盾	1	0	0	1	1.0
内部测试	0	0	1	1	1.0
内衣	0	0	1	1	1.0
内环	1	0	0	1	1.0
内斯特	0	1	0	1	1.0
内斯	0	1	0	1	1.0
内忧外患	1	0	0	1	1.0
内忧	1	0	0	1	1.0
内心独白	0	1	0	1	1.0
内幕	0	0	1	1	1.0
内存不足	0	1	0	1	1.0
内在	0	1	0	1	1.0
内向	1	0	0	1	1.0
内分泌	0	0	1	1	1.0
内分	0	0	1	1	1.0
兼职	0	0	1	1	1.0
兼得	1	0	0	1	1.0
养育之恩	1	0	0	1	1.0
养肥	0	1	0	1	1.0
养父母	0	1	0	1	1.0
养父	0	1	0	1	1.0
养护	0	0	1	1	1.0
养家糊口	0	1	0	1	1.0
养分	0	0	1	1	1.0
养儿防老	1	0	0	1	1.0
养下来	0	1	0	1	1.0
兹	1	0	0	1	1.0
典范	1	0	0	1	1.0
典礼	1	0	0	1	1.0
其妻	1	0	0	1	1.0
其余	0	0	1	1	1.0
其他费用	1	0	0	1	1.0
其他同学	0	0	1	1	1.0
其人	1	0	0	1	1.0
其事	1	0	0	1	1.0
兵马未动	0	1	0	1	1.0
兵马	0	1	0	1	1.0
兵团	1	0	0	1	1.0
兴起	1	0	0	1	1.0
兴许	0	1	0	1	1.0
兴师问罪	0	1	0	1	1.0
兴师	0	1	0	1	1.0
关门	1	0	0	1	1.0
关键词	0	0	1	1	1.0
关键点	1	0	0	1	1.0
关联	0	0	1	1	1.0
关紧	0	0	1	1	1.0
关照	0	1	0	1	1.0
关怀	1	0	0	1	1.0
关切	0	0	1	1	1.0
关乎	1	0	0	1	1.0
共鸣	0	1	0	1	1.0
共谋	1	0	0	1	1.0
共荣圈	0	1	0	1	1.0
共犯	1	0	0	1	1.0
共同社	0	0	1	1	1.0
共同奋斗	0	1	0	1	1.0
共创	0	1	0	1	1.0
共产党员	0	1	0	1	1.0
共产党	0	1	0	1	1.0
共产主义	0	1	0	1	1.0
共事	1	0	0	1	1.0
共乐	0	0	1	1	1.0
兰博基尼	0	0	1	1	1.0
兰博基	0	0	1	1	1.0
兰克	0	1	0	1	1.0
兮兮	1	0	0	1	1.0
六部	0	0	1	1	1.0
六斤	0	1	0	1	1.0
六岁	1	0	0	1	1.0
六千	0	0	1	1	1.0
六十五	1	0	0	1	1.0
六十	1	0	0	1	1.0
六位	0	0	1	1	1.0
六七十万	0	0	1	1	1.0
六七十	0	0	1	1	1.0
六七	0	0	1	1	1.0
六一	1	0	0	1	1.0
公车	0	1	0	1	1.0
公约	0	0	1	1	1.0
公立	0	1	0	1	1.0
公牛	0	1	0	1	1.0
公款	0	1	0	1	1.0
公权力	0	1	0	1	1.0
公映	1	0	0	1	1.0
公敌	1	0	0	1	1.0
公报	1	0	0	1	1.0
公平竞争	0	0	1	1	1.0
公家	1	0	0	1	1.0
公安消防	0	1	0	1	1.0
公安分局	0	0	1	1	1.0
公婆	0	1	0	1	1.0
公告栏	0	1	0	1	1.0
公共秩序	1	0	0	1	1.0
公共服务	0	1	0	1	1.0
公共安全	0	0	1	1	1.0
公共事业	1	0	0	1	1.0
公公	0	0	1	1	1.0
公元前	1	0	0	1	1.0
公元	1	0	0	1	1.0
公休	1	0	0	1	1.0
公交网	0	1	0	1	1.0
公交线路	0	1	0	1	1.0
公交线	0	1	0	1	1.0
公义	0	1	0	1	1.0
八项	0	0	1	1	1.0
八门	1	0	0	1	1.0
八竿子打不着	0	0	1	1	1.0
八点	0	1	0	1	1.0
八月	0	1	0	1	1.0
八斤	1	0	0	1	1.0
八天	0	0	1	1	1.0
八大	1	0	0	1	1.0
八国联军	0	1	0	1	1.0
八国	0	1	0	1	1.0
八卦拳	1	0	0	1	1.0
八万块	0	0	1	1	1.0
八万	0	0	1	1	1.0
全面禁止	1	0	0	1	1.0
全部都是	1	0	0	1	1.0
全身心	0	0	1	1	1.0
全职太太	0	1	0	1	1.0
全网	0	0	1	1	1.0
全线	0	0	1	1	1.0
全省	0	1	0	1	1.0
全盘考虑	0	1	0	1	1.0
全盘	0	1	0	1	1.0
全球华语	0	0	1	1	1.0
全球华人	0	0	1	1	1.0
全文	0	1	0	1	1.0
全攻略	1	0	0	1	1.0
全攻	1	0	0	1	1.0
全意	0	1	0	1	1.0
全开	1	0	0	1	1.0
全场	1	0	0	1	1.0
全县	0	1	0	1	1.0
全免	0	1	0	1	1.0
全体	1	0	0	1	1.0
全会	1	0	0	1	1.0
入骨	1	0	0	1	1.0
入货	0	1	0	1	1.0
入网	0	0	1	1	1.0
入眠	0	0	1	1	1.0
入狱	0	0	1	1	1.0
入室	0	1	0	1	1.0
入学	0	1	0	1	1.0
入境	1	0	0	1	1.0
入场	0	0	1	1	1.0
入土为安	1	0	0	1	1.0
入口	0	0	1	1	1.0
入冬	0	0	1	1	1.0
入伙	0	0	1	1	1.0
兜里	0	1	0	1	1.0
党派	0	1	0	1	1.0
党委	0	1	0	1	1.0
党和国家	1	0	0	1	1.0
党员	0	1	0	1	1.0
党专政	0	1	0	1	1.0
兔子	0	1	0	1	1.0
免试	0	1	0	1	1.0
免得	0	1	0	1	1.0
免不了	0	1	0	1	1.0
免	0	1	0	1	1.0
克里米亚	0	1	0	1	1.0
光鲜	0	1	0	1	1.0
光阴	0	1	0	1	1.0
光说不练	1	0	0	1	1.0
光线	0	1	0	1	1.0
光电	0	1	0	1	1.0
光环	0	1	0	1	1.0
光灯	0	0	1	1	1.0
光棍	0	0	1	1	1.0
光明网	0	1	0	1	1.0
光彩夺目	0	1	0	1	1.0
光彩	0	1	0	1	1.0
光大	1	0	0	1	1.0
先锋	1	0	0	1	1.0
先进	1	0	0	1	1.0
先觉	0	1	0	1	1.0
先祖	1	0	0	1	1.0
先知先觉	0	1	0	1	1.0
先知	0	1	0	1	1.0
先查	1	0	0	1	1.0
先头	0	1	0	1	1.0
先前	1	0	0	1	1.0
先于	0	1	0	1	1.0
充足	0	0	1	1	1.0
充好	0	1	0	1	1.0
充分说明	0	1	0	1	1.0
充分考虑	0	1	0	1	1.0
充分利用	0	1	0	1	1.0
充值	1	0	0	1	1.0
兄长	0	1	0	1	1.0
元月	0	1	0	1	1.0
元宵夜	0	1	0	1	1.0
兀	0	1	0	1	1.0
儿童节	1	0	0	1	1.0
儿童医院	0	0	1	1	1.0
儿科	0	1	0	1	1.0
儿孙	1	0	0	1	1.0
儿媳妇	0	0	1	1	1.0
儿媳	0	0	1	1	1.0
儿女	0	1	0	1	1.0
儒教	0	1	0	1	1.0
儒家	0	0	1	1	1.0
儋州	0	0	1	1	1.0
僧	0	0	1	1	1.0
僚机	0	1	0	1	1.0
催动	1	0	0	1	1.0
储油	1	0	0	1	1.0
储存	0	1	0	1	1.0
储备	1	0	0	1	1.0
傍晚	1	0	0	1	1.0
傈僳族	0	1	0	1	1.0
傈僳	0	1	0	1	1.0
傀儡政权	0	1	0	1	1.0
傀儡	0	1	0	1	1.0
偷走	0	1	0	1	1.0
偷窃	0	1	0	1	1.0
偷着乐	1	0	0	1	1.0
偷盗	0	1	0	1	1.0
偷渡	1	0	0	1	1.0
偷拿	0	0	1	1	1.0
偷懒	1	0	0	1	1.0
偷情	0	1	0	1	1.0
偷偷	0	1	0	1	1.0
偶遇	0	0	1	1	1.0
偶然	1	0	0	1	1.0
健身	0	0	1	1	1.0
健在	0	1	0	1	1.0
健全	0	1	0	1	1.0
健健康康	0	0	1	1	1.0
健	1	0	0	1	1.0
停诊	0	1	0	1	1.0
停火协议	0	1	0	1	1.0
停滞	0	0	1	1	1.0
停放	0	1	0	1	1.0
停办	0	1	0	1	1.0
做梦	1	0	0	1	1.0
做文章	1	0	0	1	1.0
做客	1	0	0	1	1.0
做做	1	0	0	1	1.0
做伴	1	0	0	1	1.0
做不了	0	1	0	1	1.0
做一套	0	1	0	1	1.0
偏见	0	0	1	1	1.0
偏要	0	0	1	1	1.0
偏爱	1	0	0	1	1.0
偏安一隅	1	0	0	1	1.0
偏安	1	0	0	1	1.0
偏偏	0	1	0	1	1.0
偌大	0	1	0	1	1.0
假装	0	1	0	1	1.0
假日酒店	0	0	1	1	1.0
假冒	0	0	1	1	1.0
倾斜	0	1	0	1	1.0
倾情	0	1	0	1	1.0
值钱	0	0	1	1	1.0
值班员	1	0	0	1	1.0
值得注意	0	0	1	1	1.0
值得尊重	0	1	0	1	1.0
值得一提的是	1	0	0	1	1.0
值得一提	1	0	0	1	1.0
值不值得	0	0	1	1	1.0
债转股	0	1	0	1	1.0
债	1	0	0	1	1.0
倩	0	1	0	1	1.0
借钱	1	0	0	1	1.0
借鉴	1	0	0	1	1.0
借车	0	1	0	1	1.0
借此	0	0	1	1	1.0
借助	0	0	1	1	1.0
倒霉事	0	1	0	1	1.0
倒逼	1	0	0	1	1.0
倒计时	1	0	0	1	1.0
倒计	1	0	0	1	1.0
倒角	1	0	0	1	1.0
倒数	0	0	1	1	1.0
倒打一耙	0	0	1	1	1.0
倒好	1	0	0	1	1.0
倒不如	0	0	1	1	1.0
倍儿	0	1	0	1	1.0
俱往	0	0	1	1	1.0
俱	0	0	1	1	1.0
修车	0	1	0	1	1.0
修路	0	0	1	1	1.0
修正案	0	1	0	1	1.0
修正	0	1	0	1	1.0
信阳	1	0	0	1	1.0
信贷	1	0	0	1	1.0
信用度	0	1	0	1	1.0
信用	0	1	0	1	1.0
信教	1	0	0	1	1.0
信心	0	1	0	1	1.0
信不信	1	0	0	1	1.0
保险金	0	0	1	1	1.0
保镖	0	0	1	1	1.0
保质期	0	0	1	1	1.0
保质	0	0	1	1	1.0
保证书	0	0	1	1	1.0
保洁	0	1	0	1	1.0
保护色	1	0	0	1	1.0
保护局	0	0	1	1	1.0
保平安	1	0	0	1	1.0
保平	1	0	0	1	1.0
保密	0	0	1	1	1.0
保家卫国	0	0	1	1	1.0
保家	0	0	1	1	1.0
保定	1	0	0	1	1.0
保守思想	0	1	0	1	1.0
保存	0	1	0	1	1.0
保命	1	0	0	1	1.0
保养	1	0	0	1	1.0
保修	0	0	1	1	1.0
保住	1	0	0	1	1.0
俗语	0	1	0	1	1.0
俗话说	0	0	1	1	1.0
俗话	0	0	1	1	1.0
俗化	0	1	0	1	1.0
俄罗斯外交部	1	0	0	1	1.0
俄总统	1	0	0	1	1.0
俄外交部	1	0	0	1	1.0
促成	1	0	0	1	1.0
便民	0	0	1	1	1.0
便携性	1	0	0	1	1.0
便捷	0	0	1	1	1.0
侵略军	0	1	0	1	1.0
侵扰	0	1	0	1	1.0
侵害	0	1	0	1	1.0
侵占	0	1	0	1	1.0
侵入	1	0	0	1	1.0
侯赛因	0	1	0	1	1.0
侧击	0	0	1	1	1.0
侧	0	1	0	1	1.0
侦察	0	1	0	1	1.0
侥幸	1	0	0	1	1.0
依稀记得	1	0	0	1	1.0
依稀	1	0	0	1	1.0
依法行政	0	1	0	1	1.0
依托	0	1	0	1	1.0
依人	0	0	1	1	1.0
供需	0	0	1	1	1.0
供应线	1	0	0	1	1.0
供奉	1	0	0	1	1.0
供参考	1	0	0	1	1.0
供养	0	1	0	1	1.0
例外	1	0	0	1	1.0
使用者	0	1	0	1	1.0
使用暴力	0	0	1	1	1.0
使唤	1	0	0	1	1.0
使命	0	1	0	1	1.0
使劲	1	0	0	1	1.0
佳音	1	0	0	1	1.0
佳肴	1	0	0	1	1.0
佳佳	1	0	0	1	1.0
佬	1	0	0	1	1.0
佩戴	0	0	1	1	1.0
佣	0	0	1	1	1.0
你追我赶	1	0	0	1	1.0
你们好	1	0	0	1	1.0
你中有我	0	1	0	1	1.0
作风	1	0	0	1	1.0
作派	0	1	0	1	1.0
作法	0	1	0	1	1.0
作案工具	1	0	0	1	1.0
作案	1	0	0	1	1.0
作揖	1	0	0	1	1.0
作息	1	0	0	1	1.0
作怪	0	0	1	1	1.0
作废	0	0	1	1	1.0
作声	1	0	0	1	1.0
作假	0	1	0	1	1.0
作人	0	0	1	1	1.0
作乐	0	1	0	1	1.0
佛脚	0	1	0	1	1.0
余辆	0	0	1	1	1.0
余篇	0	1	0	1	1.0
余孽	0	1	0	1	1.0
余姚	0	1	0	1	1.0
余位	1	0	0	1	1.0
余万	0	0	1	1	1.0
余	0	0	1	1	1.0
何罪之有	0	1	0	1	1.0
何等	1	0	0	1	1.0
何种	1	0	0	1	1.0
何物	0	1	0	1	1.0
何止	0	1	0	1	1.0
何来	0	1	0	1	1.0
何意	0	0	1	1	1.0
何必当初	0	1	0	1	1.0
何德何能	0	1	0	1	1.0
何德何	0	1	0	1	1.0
何尝	0	1	0	1	1.0
何妨	1	0	0	1	1.0
何其	0	1	0	1	1.0
何人	0	1	0	1	1.0
何为	1	0	0	1	1.0
体贴	0	1	0	1	1.0
体育运动	0	1	0	1	1.0
体育	0	1	0	1	1.0
体积小	1	0	0	1	1.0
体味	1	0	0	1	1.0
体制	1	0	0	1	1.0
体内	0	1	0	1	1.0
佐证	1	0	0	1	1.0
佐	0	0	1	1	1.0
住民	0	1	0	1	1.0
住校	0	0	1	1	1.0
低阶	0	1	0	1	1.0
低速	1	0	0	1	1.0
低调	1	0	0	1	1.0
低等	0	1	0	1	1.0
低电量	1	0	0	1	1.0
低成本	0	1	0	1	1.0
低劣	1	0	0	1	1.0
低位	1	0	0	1	1.0
似地	0	1	0	1	1.0
伺机	1	0	0	1	1.0
伸手不见五指	0	1	0	1	1.0
伸手不见	0	1	0	1	1.0
伸手	0	1	0	1	1.0
伸	1	0	0	1	1.0
伴随	1	0	0	1	1.0
伴娘	1	0	0	1	1.0
估摸	1	0	0	1	1.0
估估	0	1	0	1	1.0
伯	1	0	0	1	1.0
伪满州国	0	1	0	1	1.0
伪满	0	1	0	1	1.0
伦西亚	1	0	0	1	1.0
伦次	1	0	0	1	1.0
伤财	0	1	0	1	1.0
伤脑筋	1	0	0	1	1.0
伤者	0	0	1	1	1.0
伤痕累累	0	1	0	1	1.0
伤痕	0	1	0	1	1.0
伤情	0	0	1	1	1.0
伤口	1	0	0	1	1.0
伤及	0	1	0	1	1.0
伤力	1	0	0	1	1.0
伤亡事故	1	0	0	1	1.0
传统节目	1	0	0	1	1.0
传统武术	1	0	0	1	1.0
传统意义	1	0	0	1	1.0
传统产业	1	0	0	1	1.0
传染	1	0	0	1	1.0
传来	1	0	0	1	1.0
传教士	0	0	1	1	1.0
传教	0	0	1	1	1.0
传宗接代	0	1	0	1	1.0
传宗	0	1	0	1	1.0
传媒	0	0	1	1	1.0
传出	0	0	1	1	1.0
伟人	0	1	0	1	1.0
会馆	1	0	0	1	1.0
会长	0	1	0	1	1.0
会计学院	1	0	0	1	1.0
会计学	1	0	0	1	1.0
会计	1	0	0	1	1.0
会心一笑	0	1	0	1	1.0
会心	0	1	0	1	1.0
会主	0	1	0	1	1.0
伙食	0	0	1	1	1.0
优越感	1	0	0	1	1.0
优越	1	0	0	1	1.0
优良	0	0	1	1	1.0
优惠政策	0	1	0	1	1.0
优惠	0	1	0	1	1.0
优待	0	1	0	1	1.0
优异	0	0	1	1	1.0
优化	0	0	1	1	1.0
优劣	1	0	0	1	1.0
优于	1	0	0	1	1.0
优	0	1	0	1	1.0
众口难调	1	0	0	1	1.0
众口	1	0	0	1	1.0
众人	0	1	0	1	1.0
休闲	0	0	1	1	1.0
休憩	1	0	0	1	1.0
伏羲女娲	1	0	0	1	1.0
伏羲	1	0	0	1	1.0
伎俩	0	1	0	1	1.0
伊玛目	1	0	0	1	1.0
伊玛	1	0	0	1	1.0
伊斯兰教	1	0	0	1	1.0
企	0	1	0	1	1.0
仿	0	1	0	1	1.0
份儿	0	1	0	1	1.0
任由	0	1	0	1	1.0
任劳任怨	0	0	1	1	1.0
任劳	0	0	1	1	1.0
任何人	0	1	0	1	1.0
任何一方	0	0	1	1	1.0
任人宰割	0	1	0	1	1.0
任人	0	1	0	1	1.0
价格战	0	0	1	1	1.0
仪器	1	0	0	1	1.0
仪	0	0	1	1	1.0
以防	0	1	0	1	1.0
以致	0	1	0	1	1.0
以备	0	1	0	1	1.0
以下几点	1	0	0	1	1.0
以下内容	0	0	1	1	1.0
令箭	0	1	0	1	1.0
令人满意	0	1	0	1	1.0
令人堪忧	0	1	0	1	1.0
代码	0	0	1	1	1.0
代理人	1	0	0	1	1.0
代理	1	0	0	1	1.0
代名词	1	0	0	1	1.0
代名	1	0	0	1	1.0
仙女山	0	1	0	1	1.0
仙女	0	1	0	1	1.0
付出代价	0	0	1	1	1.0
他家	1	0	0	1	1.0
他俩	0	0	1	1	1.0
仓促	1	0	0	1	1.0
从长远看	0	1	0	1	1.0
从良	0	1	0	1	1.0
从此以后	1	0	0	1	1.0
从来不	0	1	0	1	1.0
从头到尾	0	1	0	1	1.0
从头	0	1	0	1	1.0
从古到今	0	1	0	1	1.0
从今年起	0	1	0	1	1.0
从今天起	0	1	0	1	1.0
从严	0	0	1	1	1.0
从业人员	0	0	1	1	1.0
从业	0	0	1	1	1.0
仍旧	1	0	0	1	1.0
介	0	1	0	1	1.0
今非昔比	0	0	1	1	1.0
今晨	0	1	0	1	1.0
今春	0	1	0	1	1.0
今宵	1	0	0	1	1.0
今夜	1	0	0	1	1.0
今冬	0	1	0	1	1.0
仇敌	0	1	0	1	1.0
仇必报	0	1	0	1	1.0
仇	0	1	0	1	1.0
仅限于	0	0	1	1	1.0
仅次于	1	0	0	1	1.0
仅剩	0	1	0	1	1.0
仁义之师	0	1	0	1	1.0
亿美金	0	1	0	1	1.0
亿多	0	1	0	1	1.0
人贩子	0	1	0	1	1.0
人类文明	1	0	0	1	1.0
人眼	0	1	0	1	1.0
人生哲理	1	0	0	1	1.0
人满为患	0	1	0	1	1.0
人流	0	0	1	1	1.0
人气	0	1	0	1	1.0
人民阵线	0	1	0	1	1.0
人民网	0	0	1	1	1.0
人民政府	0	1	0	1	1.0
人次	1	0	0	1	1.0
人影	1	0	0	1	1.0
人工	0	0	1	1	1.0
人大	0	0	1	1	1.0
人命关天	1	0	0	1	1.0
人员伤亡	0	0	1	1	1.0
人口素质	0	0	1	1	1.0
人口比例	0	0	1	1	1.0
人口普查	1	0	0	1	1.0
人口数量	1	0	0	1	1.0
人口数	1	0	0	1	1.0
人口密度	0	0	1	1	1.0
人口减少	0	1	0	1	1.0
人力车	0	1	0	1	1.0
人力物力	0	1	0	1	1.0
人体工学	1	0	0	1	1.0
人体	1	0	0	1	1.0
人云亦云	1	0	0	1	1.0
人云	1	0	0	1	1.0
人事	0	0	1	1	1.0
人为因素	0	1	0	1	1.0
人为刀俎	0	1	0	1	1.0
亵渎	1	0	0	1	1.0
亲近	0	1	0	1	1.0
亲身经历	1	0	0	1	1.0
亲自	0	1	0	1	1.0
亲爹	0	1	0	1	1.0
亲手	1	0	0	1	1.0
亲戚朋友	1	0	0	1	1.0
亲戚家	1	0	0	1	1.0
亲密关系	1	0	0	1	1.0
亲密	1	0	0	1	1.0
亲家	1	0	0	1	1.0
亲子	1	0	0	1	1.0
亲吻	0	1	0	1	1.0
亲口	1	0	0	1	1.0
亲历	1	0	0	1	1.0
亲切	1	0	0	1	1.0
亮相	1	0	0	1	1.0
京津地区	0	1	0	1	1.0
京津	0	1	0	1	1.0
京报	0	1	0	1	1.0
京城	0	1	0	1	1.0
京剧	1	0	0	1	1.0
产道	0	0	1	1	1.0
产能	0	0	1	1	1.0
产油国	0	1	0	1	1.0
产油	0	1	0	1	1.0
产品质量	0	0	1	1	1.0
产业链	0	0	1	1	1.0
产下	0	0	1	1	1.0
亦可覆舟	0	1	0	1	1.0
亦可	0	1	0	1	1.0
交集	0	0	1	1	1.0
交钱	0	1	0	1	1.0
交道	0	1	0	1	1.0
交通法规	1	0	0	1	1.0
交通广播	0	0	1	1	1.0
交通委	0	0	1	1	1.0
交警大队	0	0	1	1	1.0
交管局	0	1	0	1	1.0
交火	0	0	1	1	1.0
交流经验	0	1	0	1	1.0
交响曲	1	0	0	1	1.0
交响	1	0	0	1	1.0
交叉口	1	0	0	1	1.0
交叉	1	0	0	1	1.0
交出	0	0	1	1	1.0
亚心	1	0	0	1	1.0
亚尔	1	0	0	1	1.0
亚太	1	0	0	1	1.0
亚大	0	1	0	1	1.0
亚丁	0	1	0	1	1.0
井盖	0	1	0	1	1.0
井然	0	1	0	1	1.0
井	1	0	0	1	1.0
五路	0	1	0	1	1.0
五角大楼	0	0	1	1	1.0
五角	0	0	1	1	1.0
五花八门	1	0	0	1	1.0
五花	1	0	0	1	1.0
五胎	0	1	0	1	1.0
五米	1	0	0	1	1.0
五点	0	1	0	1	1.0
五湖四海	1	0	0	1	1.0
五湖	1	0	0	1	1.0
五晚	0	0	1	1	1.0
五星	0	1	0	1	1.0
五指	0	1	0	1	1.0
五成	0	0	1	1	1.0
五彩缤纷	1	0	0	1	1.0
五彩	1	0	0	1	1.0
五常	1	0	0	1	1.0
五十年	0	1	0	1	1.0
五分钟	1	0	0	1	1.0
五六岁	1	0	0	1	1.0
五六位	0	0	1	1	1.0
五中全会	1	0	0	1	1.0
五中	1	0	0	1	1.0
五个	0	0	1	1	1.0
五万	0	1	0	1	1.0
互赠	1	0	0	1	1.0
互惠	1	0	0	1	1.0
互信	1	0	0	1	1.0
云游	0	0	1	1	1.0
云层	1	0	0	1	1.0
于洪区	0	0	1	1	1.0
于洪	0	0	1	1	1.0
于此	0	0	1	1	1.0
二道	0	0	1	1	1.0
二路	0	1	0	1	1.0
二舅	1	0	0	1	1.0
二老	0	0	1	1	1.0
二维码	1	0	0	1	1.0
二维	1	0	0	1	1.0
二男一女	0	1	0	1	1.0
二环	1	0	0	1	1.0
二炮	0	0	1	1	1.0
二氧化氮	0	1	0	1	1.0
二次世界大战	0	0	1	1	1.0
二楼	1	0	0	1	1.0
二月	1	0	0	1	1.0
二战	0	1	0	1	1.0
二弟	1	0	0	1	1.0
二年	0	0	1	1	1.0
二季度	0	0	1	1	1.0
二季	0	0	1	1	1.0
二姐	1	0	0	1	1.0
二奶	0	0	1	1	1.0
二女儿	0	0	1	1	1.0
二只	0	0	1	1	1.0
二十多分钟	0	1	0	1	1.0
二十多	0	1	0	1	1.0
二十分钟	1	0	0	1	1.0
二十分	1	0	0	1	1.0
二十八	0	1	0	1	1.0
二十五万	0	1	0	1	1.0
二十五	0	1	0	1	1.0
二十万元	0	1	0	1	1.0
二十万	0	1	0	1	1.0
二八	0	1	0	1	1.0
二人	0	0	1	1	1.0
二三百万	0	1	0	1	1.0
二三百	0	1	0	1	1.0
二三十年	0	0	1	1	1.0
二三十	0	0	1	1	1.0
事权	0	0	1	1	1.0
事态	1	0	0	1	1.0
事实证明	0	0	1	1	1.0
事实如此	0	1	0	1	1.0
事宜	1	0	0	1	1.0
事业单位	0	1	0	1	1.0
争辩	1	0	0	1	1.0
争执不下	0	1	0	1	1.0
争夺战	1	0	0	1	1.0
争夺	1	0	0	1	1.0
争产	1	0	0	1	1.0
了然	0	1	0	1	1.0
了不起	1	0	0	1	1.0
乱麻	1	0	0	1	1.0
乱飞	1	0	0	1	1.0
乱纪	0	1	0	1	1.0
乱搞	1	0	0	1	1.0
乱局	0	0	1	1	1.0
乱套	1	0	0	1	1.0
乱冲	0	0	1	1	1.0
乱七八糟	0	1	0	1	1.0
买回去	0	1	0	1	1.0
买回	0	1	0	1	1.0
书写	0	1	0	1	1.0
乡间	1	0	0	1	1.0
乡镇	1	0	0	1	1.0
也门	0	1	0	1	1.0
乞	0	0	1	1	1.0
九江	1	0	0	1	1.0
九月份	1	0	0	1	1.0
九月	1	0	0	1	1.0
九号	1	0	0	1	1.0
九华	1	0	0	1	1.0
九十多岁	0	1	0	1	1.0
九十多	0	1	0	1	1.0
九十	0	1	0	1	1.0
乘火打劫	0	1	0	1	1.0
乘	1	0	0	1	1.0
乖巧	1	0	0	1	1.0
乖乖	0	1	0	1	1.0
乔迁	0	1	0	1	1.0
乔老爷	0	1	0	1	1.0
乔帮主	0	1	0	1	1.0
乒乓	0	1	0	1	1.0
乐得	0	1	0	1	1.0
乐团	1	0	0	1	1.0
乐器	0	1	0	1	1.0
乐呵呵	0	0	1	1	1.0
乐事	0	0	1	1	1.0
乐乎	1	0	0	1	1.0
乐业	0	1	0	1	1.0
乐一乐	1	0	0	1	1.0
乏术	0	0	1	1	1.0
乍暖还寒	0	0	1	1	1.0
乍暖	0	0	1	1	1.0
乌龙	1	0	0	1	1.0
乌烟瘴气	0	1	0	1	1.0
乌市	0	0	1	1	1.0
乌云密布	0	0	1	1	1.0
乌云	0	0	1	1	1.0
之用	1	0	0	1	1.0
之年	0	0	1	1	1.0
之劳	0	1	0	1	1.0
之举	0	0	1	1	1.0
之为	0	1	0	1	1.0
义无反顾	1	0	0	1	1.0
义和团	0	0	1	1	1.0
久远	0	1	0	1	1.0
久拖不决	0	1	0	1	1.0
久拖	0	1	0	1	1.0
久久	0	1	0	1	1.0
乃至	1	0	0	1	1.0
乃	1	0	0	1	1.0
举足轻重	1	0	0	1	1.0
举足	1	0	0	1	1.0
举起	0	1	0	1	1.0
举手之劳	0	1	0	1	1.0
丽水	0	0	1	1	1.0
丽丽	0	1	0	1	1.0
主观	1	0	0	1	1.0
主见	1	0	0	1	1.0
主编	1	0	0	1	1.0
主管	1	0	0	1	1.0
主干道	1	0	0	1	1.0
主干	1	0	0	1	1.0
主导权	1	0	0	1	1.0
主子	1	0	0	1	1.0
主动权	0	1	0	1	1.0
主办	0	1	0	1	1.0
主体	0	1	0	1	1.0
主任医师	1	0	0	1	1.0
为数不多	1	0	0	1	1.0
为数	1	0	0	1	1.0
丹阳	1	0	0	1	1.0
丹江	0	0	1	1	1.0
丹丹	0	0	1	1	1.0
临门	0	0	1	1	1.0
临汾	1	0	0	1	1.0
临到	0	1	0	1	1.0
串子	1	0	0	1	1.0
串亲戚	1	0	0	1	1.0
丰收	1	0	0	1	1.0
中重度	0	1	0	1	1.0
中部	0	1	0	1	1.0
中路	1	0	0	1	1.0
中计	0	1	0	1	1.0
中营	0	1	0	1	1.0
中考	0	0	1	1	1.0
中老年人	0	1	0	1	1.0
中老年	0	1	0	1	1.0
中策	0	0	1	1	1.0
中等	0	1	0	1	1.0
中立	0	1	0	1	1.0
中科院	0	0	1	1	1.0
中科	0	0	1	1	1.0
中牟县	0	0	1	1	1.0
中牟	0	0	1	1	1.0
中海	0	1	0	1	1.0
中毒	1	0	0	1	1.0
中档	0	0	1	1	1.0
中旬	1	0	0	1	1.0
中方	0	0	1	1	1.0
中招	0	1	0	1	1.0
中心站	0	0	1	1	1.0
中庸之道	1	0	0	1	1.0
中庸	1	0	0	1	1.0
中年	0	1	0	1	1.0
中山西路	0	0	1	1	1.0
中山大道	1	0	0	1	1.0
中小学生	0	1	0	1	1.0
中小学	0	1	0	1	1.0
中小	0	1	0	1	1.0
中学毕业	0	1	0	1	1.0
中央集权	0	0	1	1	1.0
中央政府	0	0	1	1	1.0
中央台	0	1	0	1	1.0
中坚力量	0	1	0	1	1.0
中坚	0	1	0	1	1.0
中土	1	0	0	1	1.0
中国青年报	0	0	1	1	1.0
中国空军	1	0	0	1	1.0
中国日报	1	0	0	1	1.0
中国国情	0	1	0	1	1.0
中南部	0	1	0	1	1.0
中南	0	1	0	1	1.0
中华苏维埃共和国	0	1	0	1	1.0
中医院	0	1	0	1	1.0
中加	1	0	0	1	1.0
中共	1	0	0	1	1.0
中产	0	1	0	1	1.0
中东部	0	1	0	1	1.0
中东地区	1	0	0	1	1.0
中东国家	0	1	0	1	1.0
中下旬	0	0	1	1	1.0
中下	0	0	1	1	1.0
丫头	1	0	0	1	1.0
个性化	1	0	0	1	1.0
个儿	0	1	0	1	1.0
个体	0	1	0	1	1.0
个人行为	0	1	0	1	1.0
个人所有	0	1	0	1	1.0
个人信息	0	0	1	1	1.0
丨	0	0	1	1	1.0
丧钟	0	0	1	1	1.0
丧失	0	1	0	1	1.0
丧偶	0	0	1	1	1.0
丧事	0	1	0	1	1.0
丧	0	0	1	1	1.0
严父	1	0	0	1	1.0
严格执行	1	0	0	1	1.0
严整	0	1	0	1	1.0
严抓	0	1	0	1	1.0
严惩	0	1	0	1	1.0
严实	0	0	1	1	1.0
严厉打击	1	0	0	1	1.0
严严实实	0	0	1	1	1.0
严严	0	0	1	1	1.0
两难	0	0	1	1	1.0
两起	0	0	1	1	1.0
两米	0	0	1	1	1.0
两根	0	0	1	1	1.0
两条腿	0	1	0	1	1.0
两日游	0	0	1	1	1.0
两日	0	0	1	1	1.0
两把	0	0	1	1	1.0
两岸三地	1	0	0	1	1.0
两岸	1	0	0	1	1.0
两套	0	1	0	1	1.0
两声	1	0	0	1	1.0
两国关系	0	0	1	1	1.0
两国	0	0	1	1	1.0
两句话	1	0	0	1	1.0
两句	1	0	0	1	1.0
两口	1	0	0	1	1.0
两千块	1	0	0	1	1.0
两分钟	0	1	0	1	1.0
两分	0	1	0	1	1.0
两全其美	0	1	0	1	1.0
两全	0	1	0	1	1.0
两侧	0	0	1	1	1.0
两份	1	0	0	1	1.0
两件事	0	1	0	1	1.0
两件	0	1	0	1	1.0
两三倍	0	1	0	1	1.0
两三	0	1	0	1	1.0
两万六千	0	0	1	1	1.0
两万	0	0	1	1	1.0
丢饭碗	0	1	0	1	1.0
丢盔卸甲	0	1	0	1	1.0
丢掉	1	0	0	1	1.0
丢弃	1	0	0	1	1.0
丢失	1	0	0	1	1.0
丢下	1	0	0	1	1.0
丝	1	0	0	1	1.0
东风	0	1	0	1	1.0
东门	0	0	1	1	1.0
东站	1	0	0	1	1.0
东突厥	1	0	0	1	1.0
东直	0	0	1	1	1.0
东湖路	1	0	0	1	1.0
东湖	1	0	0	1	1.0
东海岸	0	0	1	1	1.0
东海	0	0	1	1	1.0
东来	0	1	0	1	1.0
东方	0	1	0	1	1.0
东平湖	1	0	0	1	1.0
东平	1	0	0	1	1.0
东山再起	0	1	0	1	1.0
东山	0	1	0	1	1.0
东奔西走	1	0	0	1	1.0
东奔西	1	0	0	1	1.0
东南亚地区	0	0	1	1	1.0
东南亚	0	0	1	1	1.0
东南	0	0	1	1	1.0
东北方	1	0	0	1	1.0
东京	0	1	0	1	1.0
东东	1	0	0	1	1.0
东三省	1	0	0	1	1.0
丘	0	0	1	1	1.0
世间	1	0	0	1	1.0
世界杯	0	0	1	1	1.0
世博	1	0	0	1	1.0
世俗化	0	1	0	1	1.0
世俗	0	1	0	1	1.0
世代相传	1	0	0	1	1.0
世仇	0	1	0	1	1.0
专题	0	1	0	1	1.0
专车接送	0	1	0	1	1.0
专访	0	1	0	1	1.0
专用道	0	0	1	1	1.0
专注	1	0	0	1	1.0
专栏	0	1	0	1	1.0
专杀	0	1	0	1	1.0
专政	0	1	0	1	1.0
专拣	1	0	0	1	1.0
专属	1	0	0	1	1.0
专家教授	0	0	1	1	1.0
专家学者	1	0	0	1	1.0
专利	0	1	0	1	1.0
专人	0	1	0	1	1.0
专	0	1	0	1	1.0
丑化	0	1	0	1	1.0
与时俱进	0	1	0	1	1.0
与日俱增	1	0	0	1	1.0
与其说	0	0	1	1	1.0
不顺	0	1	0	1	1.0
不靠	0	1	0	1	1.0
不难理解	1	0	0	1	1.0
不难	1	0	0	1	1.0
不问	0	1	0	1	1.0
不配	0	1	0	1	1.0
不道德	0	1	0	1	1.0
不适感	0	0	1	1	1.0
不适	0	0	1	1	1.0
不足为凭	0	0	1	1	1.0
不赖	1	0	0	1	1.0
不语	1	0	0	1	1.0
不论	0	0	1	1	1.0
不讲道理	0	1	0	1	1.0
不言而喻	1	0	0	1	1.0
不言	1	0	0	1	1.0
不解	0	1	0	1	1.0
不要紧	1	0	0	1	1.0
不虚	1	0	0	1	1.0
不良	1	0	0	1	1.0
不至于	0	1	0	1	1.0
不自禁	0	0	1	1	1.0
不自	0	0	1	1	1.0
不能自己	1	0	0	1	1.0
不能不要	0	1	0	1	1.0
不肯	0	1	0	1	1.0
不绝	1	0	0	1	1.0
不约而同	1	0	0	1	1.0
不约	1	0	0	1	1.0
不算什么	0	0	1	1	1.0
不甘落后	0	0	1	1	1.0
不甘	0	0	1	1	1.0
不熟	0	1	0	1	1.0
不烦	0	1	0	1	1.0
不灵敏	0	0	1	1	1.0
不济	1	0	0	1	1.0
不来	0	1	0	1	1.0
不景气	0	0	1	1	1.0
不是故意	0	1	0	1	1.0
不易	0	1	0	1	1.0
不明	0	0	1	1	1.0
不时之需	0	1	0	1	1.0
不断完善	0	0	1	1	1.0
不料	0	0	1	1	1.0
不振	0	1	0	1	1.0
不择手段	0	1	0	1	1.0
不择	0	1	0	1	1.0
不打自招	1	0	0	1	1.0
不成比例	1	0	0	1	1.0
不成方圆	1	0	0	1	1.0
不愧为	1	0	0	1	1.0
不愧	1	0	0	1	1.0
不惮	0	1	0	1	1.0
不息	0	0	1	1	1.0
不忍	1	0	0	1	1.0
不必要	0	0	1	1	1.0
不得好死	0	1	0	1	1.0
不当	0	0	1	1	1.0
不幸遇难	0	1	0	1	1.0
不尽相同	1	0	0	1	1.0
不容乐观	1	0	0	1	1.0
不安	1	0	0	1	1.0
不妙	0	0	1	1	1.0
不如意	1	0	0	1	1.0
不好过	0	1	0	1	1.0
不失	0	0	1	1	1.0
不太想	1	0	0	1	1.0
不太好	0	1	0	1	1.0
不太会	1	0	0	1	1.0
不大想	0	1	0	1	1.0
不大不小	1	0	0	1	1.0
不复存在	0	0	1	1	1.0
不复	0	0	1	1	1.0
不堪重负	0	1	0	1	1.0
不在少数	0	0	1	1	1.0
不听话	0	1	0	1	1.0
不含糊	0	1	0	1	1.0
不含	0	1	0	1	1.0
不可理喻	1	0	0	1	1.0
不可收拾	0	1	0	1	1.0
不可思议	1	0	0	1	1.0
不可开交	0	0	1	1	1.0
不前	0	1	0	1	1.0
不分场合	0	1	0	1	1.0
不分	0	1	0	1	1.0
不公	0	1	0	1	1.0
不值钱	0	0	1	1	1.0
不信	1	0	0	1	1.0
不俗	1	0	0	1	1.0
不作声	1	0	0	1	1.0
不作	1	0	0	1	1.0
不休	0	1	0	1	1.0
不介意	0	0	1	1	1.0
不亦乐乎	1	0	0	1	1.0
不亚于	1	0	0	1	1.0
不予理睬	0	1	0	1	1.0
不予	0	1	0	1	1.0
不乐意	0	0	1	1	1.0
不一而足	1	0	0	1	1.0
下饭	0	0	1	1	1.0
下风	0	0	1	1	1.0
下雨	0	1	0	1	1.0
下限	0	1	0	1	1.0
下逐客令	0	1	0	1	1.0
下过	0	1	0	1	1.0
下辈子	1	0	0	1	1.0
下辈	1	0	0	1	1.0
下调	0	0	1	1	1.0
下课后	1	0	0	1	1.0
下角	0	1	0	1	1.0
下行	0	1	0	1	1.0
下结论	0	1	0	1	1.0
下水道	0	1	0	1	1.0
下有小	1	0	0	1	1.0
下有	1	0	0	1	1.0
下星期	0	0	1	1	1.0
下旬	0	0	1	1	1.0
下探	1	0	0	1	1.0
下意识	1	0	0	1	1.0
下岗	0	1	0	1	1.0
下属	0	1	0	1	1.0
下层	0	1	0	1	1.0
下垂	1	0	0	1	1.0
下坡路	1	0	0	1	1.0
下坡	1	0	0	1	1.0
下图	1	0	0	1	1.0
下周一	0	0	1	1	1.0
下同	0	0	1	1	1.0
下发	0	1	0	1	1.0
下单	0	1	0	1	1.0
下列	0	0	1	1	1.0
下个月	1	0	0	1	1.0
下下	0	1	0	1	1.0
上风	0	1	0	1	1.0
上车	1	0	0	1	1.0
上调	0	1	0	1	1.0
上课	0	1	0	1	1.0
上街	0	0	1	1	1.0
上级	0	1	0	1	1.0
上端	0	1	0	1	1.0
上班族	0	1	0	1	1.0
上演	0	0	1	1	1.0
上榜	0	1	0	1	1.0
上楼	0	0	1	1	1.0
上档次	0	0	1	1	1.0
上档	0	0	1	1	1.0
上有老下有小	1	0	0	1	1.0
上有老	1	0	0	1	1.0
上有	1	0	0	1	1.0
上映	0	0	1	1	1.0
上当受骗	1	0	0	1	1.0
上岗证	0	1	0	1	1.0
上山	1	0	0	1	1.0
上层	0	1	0	1	1.0
上头	0	1	0	1	1.0
上周末	0	0	1	1	1.0
上半年	0	1	0	1	1.0
上半	0	1	0	1	1.0
上位	0	1	0	1	1.0
上代	0	1	0	1	1.0
上书	0	0	1	1	1.0
上个世纪	0	1	0	1	1.0
上上网	0	0	1	1	1.0
上上	0	0	1	1	1.0
三项	1	0	0	1	1.0
三门峡	0	1	0	1	1.0
三门	0	1	0	1	1.0
三部曲	0	0	1	1	1.0
三部	0	0	1	1	1.0
三遍	0	1	0	1	1.0
三角旗	1	0	0	1	1.0
三角	1	0	0	1	1.0
三股	1	0	0	1	1.0
三禁	0	1	0	1	1.0
三百多	1	0	0	1	1.0
三百六十五天	1	0	0	1	1.0
三百六十五	1	0	0	1	1.0
三百六十	1	0	0	1	1.0
三百六	1	0	0	1	1.0
三百万	0	1	0	1	1.0
三流	0	1	0	1	1.0
三段式	0	0	1	1	1.0
三段	0	0	1	1	1.0
三条	1	0	0	1	1.0
三月	0	0	1	1	1.0
三明	1	0	0	1	1.0
三捆	0	1	0	1	1.0
三打	1	0	0	1	1.0
三思	0	1	0	1	1.0
三岔路口	1	0	0	1	1.0
三岔路	1	0	0	1	1.0
三岔	1	0	0	1	1.0
三姑	1	0	0	1	1.0
三围	1	0	0	1	1.0
三四百	0	1	0	1	1.0
三四家	1	0	0	1	1.0
三口	1	0	0	1	1.0
三千块	1	0	0	1	1.0
三十岁	1	0	0	1	1.0
三十多年	1	0	0	1	1.0
三十多万	1	0	0	1	1.0
三十万	0	1	0	1	1.0
三八妇女节	1	0	0	1	1.0
三八	1	0	0	1	1.0
三份	1	0	0	1	1.0
三代同堂	1	0	0	1	1.0
三代人	1	0	0	1	1.0
三代	1	0	0	1	1.0
三亚市	0	1	0	1	1.0
三万	0	0	1	1	1.0
丈母娘	0	1	0	1	1.0
丈母	0	1	0	1	1.0
丈夫	1	0	0	1	1.0
万里	1	0	0	1	1.0
万象	1	0	0	1	1.0
万能钥匙	0	1	0	1	1.0
万美元	0	1	0	1	1.0
万紫千红	1	0	0	1	1.0
万科	0	0	1	1	1.0
万步	0	1	0	1	1.0
万斤	0	1	0	1	1.0
万户	1	0	0	1	1.0
万左右	0	0	1	1	1.0
万岁	1	0	0	1	1.0
万家灯火	1	0	0	1	1.0
万头	0	1	0	1	1.0
万利	0	1	0	1	1.0
万六	0	0	1	1	1.0
万人次	1	0	0	1	1.0
万事如意	1	0	0	1	1.0
万事	1	0	0	1	1.0
七零八落	1	0	0	1	1.0
七零八	1	0	0	1	1.0
七章	0	1	0	1	1.0
七点钟	0	1	0	1	1.0
七夕	1	0	0	1	1.0
七喜	1	0	0	1	1.0
七十年代	0	0	1	1	1.0
七十年	0	0	1	1	1.0
丁香	1	0	0	1	1.0
丁点	0	1	0	1	1.0
一首	1	0	0	1	1.0
一飞冲天	1	0	0	1	1.0
一顶	0	0	1	1	1.0
一面之词	1	0	0	1	1.0
一集	0	0	1	1	1.0
一隅	1	0	0	1	1.0
一阵风	1	0	0	1	1.0
一阵子	1	0	0	1	1.0
一阵一阵	0	1	0	1	1.0
一门	0	1	0	1	1.0
一键	0	1	0	1	1.0
一针	0	1	0	1	1.0
一道	0	0	1	1	1.0
一通	1	0	0	1	1.0
一轮	0	1	0	1	1.0
一车	0	1	0	1	1.0
一身正气	0	1	0	1	1.0
一路货	0	1	0	1	1.0
一趟	0	1	0	1	1.0
一贯作风	1	0	0	1	1.0
一角	0	1	0	1	1.0
一视同仁	0	1	0	1	1.0
一袋	0	0	1	1	1.0
一般来说	0	0	1	1	1.0
一经	0	1	0	1	1.0
一线希望	1	0	0	1	1.0
一纸空文	1	0	0	1	1.0
一米	1	0	0	1	1.0
一笔一画	1	0	0	1	1.0
一笔	1	0	0	1	1.0
一站	0	1	0	1	1.0
一碗	1	0	0	1	1.0
一眨眼	1	0	0	1	1.0
一眨	1	0	0	1	1.0
一目了然	0	1	0	1	1.0
一目	0	1	0	1	1.0
一盘棋	0	1	0	1	1.0
一盘	0	1	0	1	1.0
一百年	0	0	1	1	1.0
一百二	0	1	0	1	1.0
一百万	0	1	0	1	1.0
一番	1	0	0	1	1.0
一片狼藉	0	0	1	1	1.0
一点半	0	1	0	1	1.0
一点一滴	0	1	0	1	1.0
一滴水	0	1	0	1	1.0
一清二白	1	0	0	1	1.0
一氧化碳	0	1	0	1	1.0
一氧化氮	0	1	0	1	1.0
一气呵成	1	0	0	1	1.0
一段路	1	0	0	1	1.0
一次次	0	0	1	1	1.0
一楼	1	0	0	1	1.0
一桶	1	0	0	1	1.0
一根	0	0	1	1	1.0
一村	1	0	0	1	1.0
一期	1	0	0	1	1.0
一晃	0	1	0	1	1.0
一时间	0	0	1	1	1.0
一时半会	1	0	0	1	1.0
一时之间	0	0	1	1	1.0
一新	1	0	0	1	1.0
一文	1	0	0	1	1.0
一整天	0	0	1	1	1.0
一整	0	0	1	1	1.0
一捋	0	1	0	1	1.0
一打	1	0	0	1	1.0
一年到头	1	0	0	1	1.0
一席谈	0	0	1	1	1.0
一席	0	0	1	1	1.0
一字排开	0	0	1	1	1.0
一头	1	0	0	1	1.0
一天天	0	1	0	1	1.0
一大群	1	0	0	1	1.0
一大步	0	1	0	1	1.0
一大半	0	1	0	1	1.0
一夜间	0	0	1	1	1.0
一夕之间	0	0	1	1	1.0
一夕	0	0	1	1	1.0
一声令下	0	1	0	1	1.0
一塌糊涂	1	0	0	1	1.0
一堂	1	0	0	1	1.0
一块儿	0	0	1	1	1.0
一团糟	0	0	1	1	1.0
一呼百应	0	1	0	1	1.0
一周年	0	0	1	1	1.0
一员	1	0	0	1	1.0
一口气	0	0	1	1	1.0
一厢情愿	1	0	0	1	1.0
一厢	1	0	0	1	1.0
一半左右	0	0	1	1	1.0
一半儿	0	0	1	1	1.0
一千二百万	0	1	0	1	1.0
一千二百	0	1	0	1	1.0
一千二	0	1	0	1	1.0
一千	0	1	0	1	1.0
一包	0	0	1	1	1.0
一剑	0	1	0	1	1.0
一刻起	1	0	0	1	1.0
一则	0	1	0	1	1.0
一切顺利	1	0	0	1	1.0
一切正常	0	0	1	1	1.0
一切办法	0	0	1	1	1.0
一切众生	0	1	0	1	1.0
一分钱	1	0	0	1	1.0
一分钟	0	0	1	1	1.0
一准	1	0	0	1	1.0
一写到	0	0	1	1	1.0
一党制	0	1	0	1	1.0
一倍	0	1	0	1	1.0
一例	0	0	1	1	1.0
一体化	0	1	0	1	1.0
一亮	1	0	0	1	1.0
一事	0	1	0	1	1.0
一乐	1	0	0	1	1.0
一举	0	1	0	1	1.0
一个男孩	0	0	1	1	1.0
一个劲儿	1	0	0	1	1.0
一两米	0	0	1	1	1.0
一两句话	1	0	0	1	1.0
一两句	1	0	0	1	1.0
一两个	1	0	0	1	1.0
一下子	1	0	0	1	1.0
一下下	0	1	0	1	1.0
一上午	1	0	0	1	1.0
一上	1	0	0	1	1.0
一万步	0	1	0	1	1.0
一万	0	1	0	1	1.0
一丁点	0	1	0	1	1.0
一丁	0	1	0	1	1.0
一一	0	1	0	1	1.0
zyxu4zj	1	0	0	1	1.0
zuowenren	1	0	0	1	1.0
zuo	0	1	0	1	1.0
zuk	0	0	1	1	1.0
zr9kpno	0	0	1	1	1.0
zoxaaic	1	0	0	1	1.0
zoo	0	1	0	1	1.0
zk	0	1	0	1	1.0
zhuzhu1027	1	0	0	1	1.0
z5p	1	0	0	1	1.0
z5c	1	0	0	1	1.0
z3	0	0	1	1	1.0
yuan	0	0	1	1	1.0
yjj	1	0	0	1	1.0
year	0	1	0	1	1.0
y4m3d	0	0	1	1	1.0
xb	1	0	0	1	1.0
x640	0	0	1	1	1.0
work	1	0	0	1	1.0
wonder	0	0	1	1	1.0
with	1	0	0	1	1.0
why	1	0	0	1	1.0
white	0	0	1	1	1.0
what	0	1	0	1	1.0
weibo	1	0	0	1	1.0
wechat	1	0	0	1	1.0
wdb	1	0	0	1	1.0
watch	1	0	0	1	1.0
wait	1	0	0	1	1.0
vsd5s	0	1	0	1	1.0
vsd5	0	1	0	1	1.0
vsd3	0	1	0	1	1.0
vr	0	1	0	1	1.0
volte	0	0	1	1	1.0
vivox5play	0	0	1	1	1.0
vivi	1	0	0	1	1.0
vista	1	0	0	1	1.0
victoria	0	0	1	1	1.0
via	1	0	0	1	1.0
valencia	1	0	0	1	1.0
v70	1	0	0	1	1.0
v7	0	0	1	1	1.0
user	1	0	0	1	1.0
update	0	0	1	1	1.0
up	0	0	1	1	1.0
uibeshort	1	0	0	1	1.0
uibe	1	0	0	1	1.0
ui	1	0	0	1	1.0
ty	0	1	0	1	1.0
tv	1	0	0	1	1.0
true	0	0	1	1	1.0
tone	0	0	1	1	1.0
to	1	0	0	1	1.0
tmb	0	1	0	1	1.0
thyanjiuyuan	1	0	0	1	1.0
thien	1	0	0	1	1.0
the	1	0	0	1	1.0
tg	0	1	0	1	1.0
term	1	0	0	1	1.0
temple	1	0	0	1	1.0
te	0	0	1	1	1.0
tc	0	1	0	1	1.0
talk	0	0	1	1	1.0
ta	1	0	0	1	1.0
sys	1	0	0	1	1.0
swift	0	0	1	1	1.0
sv	0	0	1	1	1.0
suki	0	0	1	1	1.0
su27	1	0	0	1	1.0
streaming	0	0	1	1	1.0
steve	0	1	0	1	1.0
stanford	0	0	1	1	1.0
splus	0	1	0	1	1.0
special	1	0	0	1	1.0
sorry	0	1	0	1	1.0
soc	0	1	0	1	1.0
sk	0	1	0	1	1.0
short	1	0	0	1	1.0
shift	1	0	0	1	1.0
shi	1	0	0	1	1.0
shenzhen	0	1	0	1	1.0
shares	1	0	0	1	1.0
sex	0	0	1	1	1.0
seven	0	1	0	1	1.0
setting	1	0	0	1	1.0
selfie	1	0	0	1	1.0
season	0	1	0	1	1.0
sd	0	1	0	1	1.0
sana	0	1	0	1	1.0
sally	0	1	0	1	1.0
s4	0	0	1	1	1.0
s	0	1	0	1	1.0
rzfufu1	0	0	1	1	1.0
rwprszj	0	0	1	1	1.0
rwhbash	0	0	1	1	1.0
rwh0hkq	0	0	1	1	1.0
rw7kj0a	1	0	0	1	1.0
rw7irid	0	1	0	1	1.0
rw7e7ei	0	0	1	1	1.0
rw51ahq	0	1	0	1	1.0
rqyfala	1	0	0	1	1.0
rqxtmpw	0	1	0	1	1.0
rqtr5lb	0	1	0	1	1.0
rqtl0wl	0	0	1	1	1.0
rql5qm1	0	1	0	1	1.0
rqjei7u	0	1	0	1	1.0
rqisw7b	0	0	1	1	1.0
rqcmzun	0	1	0	1	1.0
rq5ytwp	0	0	1	1	1.0
rq5lbud	0	1	0	1	1.0
rq52gid	0	1	0	1	1.0
rq0krhx	1	0	0	1	1.0
rq0jryk	1	0	0	1	1.0
rq0ia2g	0	0	1	1	1.0
rpu0pi2	0	1	0	1	1.0
rossiya1	1	0	0	1	1.0
root	0	0	1	1	1.0
rom	1	0	0	1	1.0
rocher	1	0	0	1	1.0
rgdkmus	0	0	1	1	1.0
recorded	1	0	0	1	1.0
raxljk8	0	0	1	1	1.0
r4qlws6	0	0	1	1	1.0
qd	0	1	0	1	1.0
pyd	0	0	1	1	1.0
py	0	0	1	1	1.0
psv	0	0	1	1	1.0
program	1	0	0	1	1.0
pro6	0	0	1	1	1.0
pp	0	0	1	1	1.0
police	1	0	0	1	1.0
po	1	0	0	1	1.0
pm	1	0	0	1	1.0
piapia	0	1	0	1	1.0
phone5se	0	0	1	1	1.0
periscope	0	0	1	1	1.0
pencil	1	0	0	1	1.0
pe	1	0	0	1	1.0
pb	1	0	0	1	1.0
pass	0	1	0	1	1.0
park	0	0	1	1	1.0
pad	1	0	0	1	1.0
p2p	0	1	0	1	1.0
p12	1	0	0	1	1.0
p10	1	0	0	1	1.0
out	0	1	0	1	1.0
os	0	0	1	1	1.0
one	0	1	0	1	1.0
off	1	0	0	1	1.0
of	1	0	0	1	1.0
nuke	1	0	0	1	1.0
nowhereelse	0	0	1	1	1.0
not	1	0	0	1	1.0
nos	0	0	1	1	1.0
nn	1	0	0	1	1.0
nina	0	1	0	1	1.0
night	1	0	0	1	1.0
nexus	1	0	0	1	1.0
neinei	1	0	0	1	1.0
ne	0	1	0	1	1.0
nbszyy	0	1	0	1	1.0
nbs	0	0	1	1	1.0
nb	0	1	0	1	1.0
nankai	1	0	0	1	1.0
myfm	0	0	1	1	1.0
mx2	0	1	0	1	1.0
mp3	0	0	1	1	1.0
moira	1	0	0	1	1.0
mod	0	1	0	1	1.0
mmnews	0	0	1	1	1.0
mini4	0	0	1	1	1.0
mimo	0	1	0	1	1.0
meizu	0	0	1	1	1.0
me	0	0	1	1	1.0
max2	0	0	1	1	1.0
maldijie	1	0	0	1	1.0
mai	0	1	0	1	1.0
mah	1	0	0	1	1.0
m8	0	0	1	1	1.0
m7	0	1	0	1	1.0
m3	0	0	1	1	1.0
m2	0	0	1	1	1.0
lyn8751	1	0	0	1	1.0
lte	0	1	0	1	1.0
lsls	1	0	0	1	1.0
low	1	0	0	1	1.0
logo	1	0	0	1	1.0
lofter	0	1	0	1	1.0
liya	0	0	1	1	1.0
livephoto	1	0	0	1	1.0
liberal	0	0	1	1	1.0
let	1	0	0	1	1.0
leo	0	0	1	1	1.0
kxrgt6	0	1	0	1	1.0
know	0	0	1	1	1.0
kirkland	1	0	0	1	1.0
kfc	1	0	0	1	1.0
kart	0	0	1	1	1.0
kakao	0	0	1	1	1.0
jump	0	0	1	1	1.0
jobs	0	1	0	1	1.0
jb	0	1	0	1	1.0
james	0	0	1	1	1.0
itunse	0	1	0	1	1.0
it	1	0	0	1	1.0
is9	0	0	1	1	1.0
iphono	0	0	1	1	1.0
iphoneses	0	1	0	1	1.0
iphonese5	0	0	1	1	1.0
iphoneplus	0	0	1	1	1.0
iphonen	0	0	1	1	1.0
iphonemos	0	0	1	1	1.0
iphone9	0	0	1	1	1.0
iphone8s	0	0	1	1	1.0
iphone8	0	0	1	1	1.0
iphone7s	0	0	1	1	1.0
iphone6p	1	0	0	1	1.0
iphone4	1	0	0	1	1.0
ipadpro	0	1	0	1	1.0
ip5	0	1	0	1	1.0
ios7	0	1	0	1	1.0
important	1	0	0	1	1.0
imissu	0	0	1	1	1.0
ii	0	1	0	1	1.0
ihs	0	0	1	1	1.0
ihone	0	1	0	1	1.0
ifixit	1	0	0	1	1.0
ifix	0	0	1	1	1.0
ic	0	1	0	1	1.0
i6	0	1	0	1	1.0
hydrakoo	0	0	1	1	1.0
hugo	1	0	0	1	1.0
htc	0	1	0	1	1.0
hi	0	0	1	1	1.0
hhhhhhh	1	0	0	1	1.0
hau	1	0	0	1	1.0
happy	0	1	0	1	1.0
hallo	0	1	0	1	1.0
guan	1	0	0	1	1.0
grace	0	0	1	1	1.0
gpu	1	0	0	1	1.0
gps	0	0	1	1	1.0
gov	0	1	0	1	1.0
girls	0	0	1	1	1.0
giphone	0	0	1	1	1.0
get	1	0	0	1	1.0
gdp1	0	1	0	1	1.0
gdp	0	1	0	1	1.0
fxh1gw	1	0	0	1	1.0
fx	0	0	1	1	1.0
fuck	0	1	0	1	1.0
ftxeme	0	1	0	1	1.0
frdtyl	1	0	0	1	1.0
for	1	0	0	1	1.0
fm88	1	0	0	1	1.0
fm	0	1	0	1	1.0
fjkgmg	1	0	0	1	1.0
fizlwc	0	1	0	1	1.0
firecrackers	1	0	0	1	1.0
fiesta	1	0	0	1	1.0
fhco1h	0	1	0	1	1.0
festival	1	0	0	1	1.0
festivai	1	0	0	1	1.0
feminism	0	0	1	1	1.0
fcuwxa	1	0	0	1	1.0
fallas	1	0	0	1	1.0
f4e	1	0	0	1	1.0
everyone	0	1	0	1	1.0
esports	1	0	0	1	1.0
em	1	0	0	1	1.0
elisha	0	0	1	1	1.0
edition	1	0	0	1	1.0
edge	1	0	0	1	1.0
ear	0	0	1	1	1.0
e100021	1	0	0	1	1.0
e06	0	1	0	1	1.0
dv	0	1	0	1	1.0
during	1	0	0	1	1.0
dtouch	0	1	0	1	1.0
dlc	0	1	0	1	1.0
disappointed	0	1	0	1	1.0
die	0	1	0	1	1.0
debka	1	0	0	1	1.0
de	1	0	0	1	1.0
d107	1	0	0	1	1.0
cx	1	0	0	1	1.0
cry	0	0	1	1	1.0
cr	1	0	0	1	1.0
cp	0	1	0	1	1.0
cosplay	1	0	0	1	1.0
core	1	0	0	1	1.0
cnr	0	0	1	1	1.0
cnn	0	0	1	1	1.0
cnbc	0	0	1	1	1.0
ceo	0	0	1	1	1.0
cctv6	0	1	0	1	1.0
cctv	0	1	0	1	1.0
ccswsxhle	1	0	0	1	1.0
catchup	0	0	1	1	1.0
cass	1	0	0	1	1.0
call	0	0	1	1	1.0
calendar	1	0	0	1	1.0
caijing	0	1	0	1	1.0
c4	0	0	1	1	1.0
bye	1	0	0	1	1.0
byd	0	1	0	1	1.0
by	1	0	0	1	1.0
bull	1	0	0	1	1.0
brian	0	0	1	1	1.0
bot	1	0	0	1	1.0
boss	1	0	0	1	1.0
bing	1	0	0	1	1.0
bilibili	0	0	1	1	1.0
bgr	0	0	1	1	1.0
bayer	1	0	0	1	1.0
bambam	0	0	1	1	1.0
baby	1	0	0	1	1.0
ayawawa	0	1	0	1	1.0
arthur	1	0	0	1	1.0
aph	1	0	0	1	1.0
android	0	1	0	1	1.0
and	1	0	0	1	1.0
amy	1	0	0	1	1.0
amazing	0	0	1	1	1.0
air2	0	0	1	1	1.0
aijun	0	1	0	1	1.0
advanced	0	1	0	1	1.0
activity	1	0	0	1	1.0
abs	1	0	0	1	1.0
abc	1	0	0	1	1.0
a8	0	0	1	1	1.0
NUMBER	0	1	0	1	1.0
蓝天	1	20	0	21	0.952380952381
做起	1	19	0	20	0.95
碳	1	13	0	14	0.928571428571
年货	13	1	0	14	0.928571428571
断崖	0	12	1	13	0.923076923077
亲戚	12	1	0	13	0.923076923077
穷人	0	11	1	12	0.916666666667
少女	1	0	11	12	0.916666666667
劳动力	0	11	1	12	0.916666666667
普通	1	10	0	11	0.909090909091
自觉	1	9	0	10	0.9
粗暴	0	9	1	10	0.9
疯狂	1	9	0	10	0.9
同一	0	1	9	10	0.9
再也	0	9	1	10	0.9
餐饮业	3	24	0	27	0.888888888889
对准	3	24	0	27	0.888888888889
劳动	1	16	1	18	0.888888888889
远离	0	8	1	9	0.888888888889
没收	0	8	1	9	0.888888888889
扎堆	1	0	8	9	0.888888888889
嫌	1	8	0	9	0.888888888889
三年	8	0	1	9	0.888888888889
通工	0	15	2	17	0.882352941176
交通工具	0	15	2	17	0.882352941176
首映	7	0	1	8	0.875
隐患	0	7	1	8	0.875
退	1	7	0	8	0.875
违反	1	7	0	8	0.875
民意	0	7	1	8	0.875
新款	1	0	7	8	0.875
擦	7	1	0	8	0.875
摔	7	1	0	8	0.875
承担	1	7	0	8	0.875
恐	0	7	1	8	0.875
尴尬	0	7	1	8	0.875
宝贝	7	1	0	8	0.875
奇葩	0	7	1	8	0.875
唱	7	1	0	8	0.875
典型	1	7	0	8	0.875
退休	1	13	1	15	0.866666666667
横冲	13	1	1	15	0.866666666667
新衣	13	1	1	15	0.866666666667
弟弟	13	2	0	15	0.866666666667
哈哈哈	13	2	0	15	0.866666666667
倡议	2	30	3	35	0.857142857143
孕	18	1	2	21	0.857142857143
承诺	2	12	0	14	0.857142857143
坑	2	12	0	14	0.857142857143
青年	0	6	1	7	0.857142857143
锵锵	1	0	6	7	0.857142857143
迎接	6	1	0	7	0.857142857143
跟不上	0	6	1	7	0.857142857143
证	0	6	1	7	0.857142857143
稳定	6	1	0	7	0.857142857143
爸爸妈妈	6	0	1	7	0.857142857143
爱护	1	6	0	7	0.857142857143
添个	6	0	1	7	0.857142857143
涨	1	6	0	7	0.857142857143
智商	6	1	0	7	0.857142857143
操	1	6	0	7	0.857142857143
打着	1	6	0	7	0.857142857143
孤单	6	0	1	7	0.857142857143
合适	6	0	1	7	0.857142857143
可爱	6	1	0	7	0.857142857143
出席	6	0	1	7	0.857142857143
关	0	6	1	7	0.857142857143
低于	0	1	6	7	0.857142857143
传说	6	0	1	7	0.857142857143
三人行	1	0	6	7	0.857142857143
ps	6	1	0	7	0.857142857143
春晚	17	2	1	20	0.85
亲人	22	3	1	26	0.846153846154
晚婚	2	16	1	19	0.842105263158
餐饮	4	25	1	30	0.833333333333
小时候	20	3	1	24	0.833333333333
逆行	15	3	0	18	0.833333333333
妹妹	15	3	0	18	0.833333333333
龙岗	10	2	0	12	0.833333333333
绿灯	10	0	2	12	0.833333333333
直撞	10	1	1	12	0.833333333333
烧纸	1	10	1	12	0.833333333333
横冲直撞	10	1	1	12	0.833333333333
齐	5	1	0	6	0.833333333333
颜	5	0	1	6	0.833333333333
隆重	5	0	1	6	0.833333333333
陪伴	5	1	0	6	0.833333333333
防部	5	0	1	6	0.833333333333
门神	5	0	1	6	0.833333333333
长假	0	1	5	6	0.833333333333
走亲戚	5	1	0	6	0.833333333333
貌似	5	0	1	6	0.833333333333
谋生	0	5	1	6	0.833333333333
该机	1	0	5	6	0.833333333333
警力	5	0	1	6	0.833333333333
规矩	5	0	1	6	0.833333333333
苏联	0	5	1	6	0.833333333333
舞狮	5	0	1	6	0.833333333333
聚集	5	0	1	6	0.833333333333
物价	1	5	0	6	0.833333333333
炸弹	1	5	0	6	0.833333333333
温和	5	1	0	6	0.833333333333
比比皆是	5	1	0	6	0.833333333333
比比	5	1	0	6	0.833333333333
无数	0	5	1	6	0.833333333333
救	0	5	1	6	0.833333333333
握	5	0	1	6	0.833333333333
成长	5	0	1	6	0.833333333333
感人	5	1	0	6	0.833333333333
恶心	1	5	0	6	0.833333333333
录制	5	0	1	6	0.833333333333
局势	5	1	0	6	0.833333333333
小小	5	0	1	6	0.833333333333
小妹	1	0	5	6	0.833333333333
对此	0	1	5	6	0.833333333333
官员	1	5	0	6	0.833333333333
大姚	5	0	1	6	0.833333333333
大人	0	5	1	6	0.833333333333
坪	5	1	0	6	0.833333333333
国防部	5	0	1	6	0.833333333333
国防	5	0	1	6	0.833333333333
品	5	0	1	6	0.833333333333
听见	5	1	0	6	0.833333333333
发财	0	5	1	6	0.833333333333
厂家	0	5	1	6	0.833333333333
印象	5	0	1	6	0.833333333333
千元	1	5	0	6	0.833333333333
加大	0	5	1	6	0.833333333333
创新	0	5	1	6	0.833333333333
养老	1	5	0	6	0.833333333333
公益	1	5	0	6	0.833333333333
借	1	5	0	6	0.833333333333
介绍	5	0	1	6	0.833333333333
争议	0	1	5	6	0.833333333333
义务	0	5	1	6	0.833333333333
严峻	1	5	0	6	0.833333333333
两周	5	0	1	6	0.833333333333
一顿	0	5	1	6	0.833333333333
一阵	5	1	0	6	0.833333333333
pro	1	0	5	6	0.833333333333
取消	1	19	3	23	0.826086956522
西方	14	2	1	17	0.823529411765
发出	2	14	1	17	0.823529411765
中华民族	14	2	1	17	0.823529411765
宝	18	0	4	22	0.818181818182
申请	0	2	9	11	0.818181818182
毫无	2	9	0	11	0.818181818182
户户	9	0	2	11	0.818181818182
成都	0	9	2	11	0.818181818182
恐怖主义	9	2	0	11	0.818181818182
广大	1	9	1	11	0.818181818182
帅	2	0	9	11	0.818181818182
家户	9	0	2	11	0.818181818182
家家户户	9	0	2	11	0.818181818182
实话	2	9	0	11	0.818181818182
哥哥	9	2	0	11	0.818181818182
收	3	13	0	16	0.8125
失望	0	13	3	16	0.8125
千年	13	1	2	16	0.8125
团圆	17	4	0	21	0.809523809524
今年春节	3	55	10	68	0.808823529412
穿	16	1	3	20	0.8
懒	2	16	2	20	0.8
铁站	12	1	2	15	0.8
地铁站	12	1	2	15	0.8
土鸡	12	3	0	15	0.8
响	3	12	0	15	0.8
财产	0	8	2	10	0.8
记忆	8	0	2	10	0.8
消防	0	8	2	10	0.8
济南	1	8	1	10	0.8
拍照	8	2	0	10	0.8
怎么办	1	8	1	10	0.8
客	8	0	2	10	0.8
姐姐	8	2	0	10	0.8
大气	2	8	0	10	0.8
呼吸	1	8	1	10	0.8
可笑	2	8	0	10	0.8
几千年	8	1	1	10	0.8
几千	8	1	1	10	0.8
冲	8	1	1	10	0.8
全家	8	1	1	10	0.8
倡导	1	8	1	10	0.8
鱼	4	0	1	5	0.8
首映礼	4	0	1	5	0.8
面积	0	4	1	5	0.8
难题	1	0	4	5	0.8
陶	1	4	0	5	0.8
道德	1	4	0	5	0.8
迟早	1	4	0	5	0.8
车牌	1	4	0	5	0.8
趟	4	1	0	5	0.8
详见	0	4	1	5	0.8
许	0	4	1	5	0.8
记录	1	4	0	5	0.8
解放	4	1	0	5	0.8
规章	0	4	1	5	0.8
观看	1	0	4	5	0.8
行政拘留	4	1	0	5	0.8
蜜月	1	4	0	5	0.8
营销	0	4	1	5	0.8
航母	4	1	0	5	0.8
耳朵	1	0	4	5	0.8
翻新	1	4	0	5	0.8
纵容	4	1	0	5	0.8
纳税	1	4	0	5	0.8
累死	1	4	0	5	0.8
糖	4	0	1	5	0.8
精力	4	0	1	5	0.8
移风易俗	0	4	1	5	0.8
礼花	1	4	0	5	0.8
短时	1	4	0	5	0.8
知识	4	0	1	5	0.8
真不	4	1	0	5	0.8
特种部队	1	4	0	5	0.8
特定	4	0	1	5	0.8
熟悉	4	0	1	5	0.8
烦恼	1	4	0	5	0.8
炮竹	1	4	0	5	0.8
有趣	4	1	0	5	0.8
有理	4	1	0	5	0.8
显得	4	1	0	5	0.8
春节快乐	1	4	0	5	0.8
易俗	0	4	1	5	0.8
新春佳节	0	4	1	5	0.8
新意	0	4	1	5	0.8
效率	0	4	1	5	0.8
放火	1	4	0	5	0.8
改成	1	4	0	5	0.8
搞笑	4	1	0	5	0.8
搞不懂	0	4	1	5	0.8
揽客	4	1	0	5	0.8
揍	4	1	0	5	0.8
挑	4	0	1	5	0.8
拟	0	4	1	5	0.8
拜神	4	0	1	5	0.8
抚养	1	4	0	5	0.8
批	4	1	0	5	0.8
打麻将	4	0	1	5	0.8
打压	0	4	1	5	0.8
愤怒	1	4	0	5	0.8
意愿	1	4	0	5	0.8
恐怖袭击	4	0	1	5	0.8
总理	1	0	4	5	0.8
彰显	1	4	0	5	0.8
建国	4	1	0	5	0.8
广东	1	4	0	5	0.8
干部	1	4	0	5	0.8
小国	0	4	1	5	0.8
对不起	4	1	0	5	0.8
实实	0	1	4	5	0.8
定价	0	1	4	5	0.8
宇	4	0	1	5	0.8
好不容易	0	4	1	5	0.8
夫妇	4	0	1	5	0.8
天空	0	4	1	5	0.8
大道	4	1	0	5	0.8
大叔	4	1	0	5	0.8
基督	4	1	0	5	0.8
基本上	0	4	1	5	0.8
埋	0	4	1	5	0.8
坚强	4	1	0	5	0.8
圣诞节	4	1	0	5	0.8
困难	4	0	1	5	0.8
回收	1	4	0	5	0.8
四分	0	4	1	5	0.8
噢	4	0	1	5	0.8
喇叭	4	0	1	5	0.8
咋办	0	1	4	5	0.8
周边	1	4	0	5	0.8
吨	0	4	1	5	0.8
号称	1	4	0	5	0.8
可悲	1	4	0	5	0.8
只许	1	4	0	5	0.8
发明	1	4	0	5	0.8
去年同期	0	1	4	5	0.8
却是	4	1	0	5	0.8
协议	0	4	1	5	0.8
半句话	1	4	0	5	0.8
半句	1	4	0	5	0.8
勒	0	4	1	5	0.8
办事	1	4	0	5	0.8
制作	0	1	4	5	0.8
出色	4	0	1	5	0.8
六	4	1	0	5	0.8
偏	1	4	0	5	0.8
你好	4	1	0	5	0.8
何必	0	4	1	5	0.8
何以	0	4	1	5	0.8
位	1	4	0	5	0.8
似的	4	0	1	5	0.8
伴	4	1	0	5	0.8
伊	4	1	0	5	0.8
九	4	0	1	5	0.8
之下	0	4	1	5	0.8
主持人	4	0	1	5	0.8
主持	4	0	1	5	0.8
不能不	1	4	0	5	0.8
不怎么	1	4	0	5	0.8
下场	1	4	0	5	0.8
月份	11	2	1	14	0.785714285714
家家	11	1	2	14	0.785714285714
合伙人	11	0	3	14	0.785714285714
合伙	11	0	3	14	0.785714285714
土豆	14	0	4	18	0.777777777778
产生	3	14	1	18	0.777777777778
赚钱	1	7	1	9	0.777777777778
说实话	2	7	0	9	0.777777777778
福	7	1	1	9	0.777777777778
没法	1	7	1	9	0.777777777778
歧视	1	7	1	9	0.777777777778
明确	0	7	2	9	0.777777777778
打死	2	7	0	9	0.777777777778
库曼	7	2	0	9	0.777777777778
平等	1	7	1	9	0.777777777778
威胁	1	7	1	9	0.777777777778
土库曼	7	2	0	9	0.777777777778
土库	7	2	0	9	0.777777777778
别的	7	2	0	9	0.777777777778
兜	7	2	0	9	0.777777777778
偷	1	1	7	9	0.777777777778
倒退	1	7	1	9	0.777777777778
仅仅	1	7	1	9	0.777777777778
一片	0	7	2	9	0.777777777778
一旦	0	7	2	9	0.777777777778
ipad	1	1	7	9	0.777777777778
号召	4	17	1	22	0.772727272727
腿	2	1	10	13	0.769230769231
晚育	2	10	1	13	0.769230769231
年夜饭	10	1	2	13	0.769230769231
尾气	10	3	0	13	0.769230769231
就业	1	10	2	13	0.769230769231
对联	10	2	1	13	0.769230769231
夜饭	10	1	2	13	0.769230769231
地球	3	10	0	13	0.769230769231
受到	3	10	0	13	0.769230769231
绿色	2	23	5	30	0.766666666667
铁	13	2	2	17	0.764705882353
目的	3	13	1	17	0.764705882353
小土豆	13	0	4	17	0.764705882353
小土	13	0	4	17	0.764705882353
吃饺子	13	1	3	17	0.764705882353
鼓励	3	19	3	25	0.76
环保	16	109	20	145	0.751724137931
法律	3	18	3	24	0.75
总统	18	4	2	24	0.75
工具	3	18	3	24	0.75
买不起	2	15	3	20	0.75
照顾	12	3	1	16	0.75
权力	3	12	1	16	0.75
拜年	12	2	2	16	0.75
同意	1	12	3	16	0.75
重点	9	1	2	12	0.75
蜀黍	9	3	0	12	0.75
火灾	0	9	3	12	0.75
怀上	9	0	3	12	0.75
噪音	2	9	1	12	0.75
公民	2	9	1	12	0.75
路段	6	1	1	8	0.75
电车	1	6	1	8	0.75
法律依据	1	6	1	8	0.75
来源	1	1	6	8	0.75
朋友圈	2	0	6	8	0.75
明星	6	0	2	8	0.75
敏感	0	2	6	8	0.75
政权	0	6	2	8	0.75
携带	6	2	0	8	0.75
拥堵	0	6	2	8	0.75
恶劣	6	1	1	8	0.75
恭喜	6	0	2	8	0.75
总之	6	1	1	8	0.75
志愿	2	6	0	8	0.75
幼儿园	6	2	0	8	0.75
小车	1	6	1	8	0.75
宝安	6	0	2	8	0.75
多多	2	6	0	8	0.75
后来	6	1	1	8	0.75
各界	0	6	2	8	0.75
千万	1	6	1	8	0.75
值	6	1	1	8	0.75
价值	0	6	2	8	0.75
人性	2	6	0	8	0.75
也好	1	6	1	8	0.75
下面	6	0	2	8	0.75
一律	6	2	0	8	0.75
馊主意	3	1	0	4	0.75
风行	0	3	1	4	0.75
颗粒	0	3	1	4	0.75
预警	1	3	0	4	0.75
顶	1	3	0	4	0.75
雷厉风行	0	3	1	4	0.75
雪	1	3	0	4	0.75
难受	3	1	0	4	0.75
降价	0	1	3	4	0.75
阳光	3	1	0	4	0.75
队伍	3	1	0	4	0.75
阅读	1	3	0	4	0.75
通知	0	3	1	4	0.75
进去	0	3	1	4	0.75
这块	3	0	1	4	0.75
这件	1	3	0	4	0.75
辉	0	1	3	4	0.75
身	3	0	1	4	0.75
跌	0	3	1	4	0.75
贫民	1	3	0	4	0.75
调解	3	1	0	4	0.75
请求	1	3	0	4	0.75
语	1	3	0	4	0.75
访友	3	0	1	4	0.75
观察	3	1	0	4	0.75
衰	3	1	0	4	0.75
表情	3	0	1	4	0.75
街	3	0	1	4	0.75
行大运	3	1	0	4	0.75
落入	1	3	0	4	0.75
药丸	1	3	0	4	0.75
节能	1	3	0	4	0.75
节点	1	3	0	4	0.75
节俭	1	3	0	4	0.75
脚	3	0	1	4	0.75
脖子	1	0	3	4	0.75
胎生	3	1	0	4	0.75
胎儿	3	0	1	4	0.75
聪明	3	1	0	4	0.75
美的	1	3	0	4	0.75
缺点	3	1	0	4	0.75
给予	3	1	0	4	0.75
红红火火	3	1	0	4	0.75
红红	3	1	0	4	0.75
繁殖	1	3	0	4	0.75
等于	1	3	0	4	0.75
立法	1	3	0	4	0.75
立场	3	1	0	4	0.75
窜	3	0	1	4	0.75
空军	3	1	0	4	0.75
究竟	0	3	1	4	0.75
离婚	0	3	1	4	0.75
碰上	1	3	0	4	0.75
着想	0	3	1	4	0.75
着急	3	0	1	4	0.75
省钱	0	3	1	4	0.75
相亲	3	0	1	4	0.75
监测	0	1	3	4	0.75
百多	1	3	0	4	0.75
痛苦	0	3	1	4	0.75
留在	3	0	1	4	0.75
界面	3	1	0	4	0.75
画面	3	1	0	4	0.75
班	3	1	0	4	0.75
环保部门	0	3	1	4	0.75
猜测	3	1	0	4	0.75
牵制	3	1	0	4	0.75
牌子	3	0	1	4	0.75
照样	3	1	0	4	0.75
焚烧	1	3	0	4	0.75
点点	1	3	0	4	0.75
点灯	1	3	0	4	0.75
点儿	3	1	0	4	0.75
火药	1	3	0	4	0.75
激起	0	1	3	4	0.75
滴	3	0	1	4	0.75
湖北	0	3	1	4	0.75
涉嫌	3	0	1	4	0.75
洋	3	0	1	4	0.75
法者	1	3	0	4	0.75
水泥	0	3	1	4	0.75
每当	3	1	0	4	0.75
步	1	3	0	4	0.75
横岗	3	1	0	4	0.75
果	3	0	1	4	0.75
极其	3	1	0	4	0.75
有奖	0	3	1	4	0.75
最佳	3	0	1	4	0.75
曰	0	3	1	4	0.75
暴	1	3	0	4	0.75
普及	1	0	3	4	0.75
春天	3	0	1	4	0.75
时刻	3	1	0	4	0.75
早餐	3	0	1	4	0.75
早晚	3	1	0	4	0.75
早前	3	0	1	4	0.75
日益	1	3	0	4	0.75
无限	3	1	0	4	0.75
无聊	3	1	0	4	0.75
无所谓	0	3	1	4	0.75
无所	0	3	1	4	0.75
旅游	1	0	3	4	0.75
方案	1	3	0	4	0.75
新浪网	0	3	1	4	0.75
政绩	1	3	0	4	0.75
放屁	3	1	0	4	0.75
放宽	3	1	0	4	0.75
放出	1	0	3	4	0.75
放假	3	1	0	4	0.75
搭载	0	1	3	4	0.75
接下来	1	3	0	4	0.75
接下	1	3	0	4	0.75
指挥	3	1	0	4	0.75
拜	3	0	1	4	0.75
拘	1	3	0	4	0.75
抵制	3	0	1	4	0.75
抛弃	3	1	0	4	0.75
抚养费	1	3	0	4	0.75
抗法	1	3	0	4	0.75
找到	1	3	0	4	0.75
扰乱	3	0	1	4	0.75
扯淡	3	1	0	4	0.75
执法者	1	3	0	4	0.75
手上	1	0	3	4	0.75
战士	3	0	1	4	0.75
战场	0	3	1	4	0.75
感动	3	0	1	4	0.75
惊讶	0	3	1	4	0.75
惊喜	3	0	1	4	0.75
怎么样	1	0	3	4	0.75
怎	3	1	0	4	0.75
忽略	3	0	1	4	0.75
忠实	3	1	0	4	0.75
当局	0	3	1	4	0.75
强势	3	1	0	4	0.75
引燃	0	1	3	4	0.75
建筑	0	3	1	4	0.75
延长	1	3	0	4	0.75
度过	3	0	1	4	0.75
应当	3	0	1	4	0.75
幌子	1	3	0	4	0.75
幅度	1	0	3	4	0.75
帽子	1	3	0	4	0.75
州市	0	3	1	4	0.75
属	3	0	1	4	0.75
小小的	3	0	1	4	0.75
封	1	3	0	4	0.75
寒假	3	1	0	4	0.75
寄托	3	0	1	4	0.75
宪法	1	3	0	4	0.75
宜昌	1	3	0	4	0.75
宋	3	0	1	4	0.75
季度	1	0	3	4	0.75
好用	3	1	0	4	0.75
奶粉	3	0	1	4	0.75
奇怪	3	0	1	4	0.75
头胎	3	0	1	4	0.75
大队	3	0	1	4	0.75
大运	3	1	0	4	0.75
大肆	0	3	1	4	0.75
大本营	3	1	0	4	0.75
大本	3	1	0	4	0.75
大有人在	3	0	1	4	0.75
大学生	1	3	0	4	0.75
备案	3	1	0	4	0.75
处罚	1	3	0	4	0.75
处	3	1	0	4	0.75
声明	1	3	0	4	0.75
增多	1	3	0	4	0.75
堪称	0	1	3	4	0.75
基督教	3	1	0	4	0.75
块钱	0	1	3	4	0.75
场	1	3	0	4	0.75
在线	3	0	1	4	0.75
国政	1	3	0	4	0.75
国情	0	3	1	4	0.75
四成	0	3	1	4	0.75
嘻嘻	1	3	0	4	0.75
喜	3	0	1	4	0.75
啪啦	1	3	0	4	0.75
哈尔滨市	0	3	1	4	0.75
后台老板	3	1	0	4	0.75
合家	3	1	0	4	0.75
各个	3	1	0	4	0.75
台湾	1	0	3	4	0.75
受访	0	3	1	4	0.75
受欢迎	3	0	1	4	0.75
发点	1	3	0	4	0.75
即可	0	3	1	4	0.75
卫视	1	0	3	4	0.75
卖不出去	1	3	0	4	0.75
化解	3	0	1	4	0.75
劲	3	1	0	4	0.75
动物	3	0	1	4	0.75
功率	3	0	1	4	0.75
劝	1	3	0	4	0.75
到达	1	3	0	4	0.75
创造	0	3	1	4	0.75
创业	1	3	0	4	0.75
出货	0	1	3	4	0.75
出发点	1	3	0	4	0.75
冷漠	3	1	0	4	0.75
内战	1	3	0	4	0.75
兼顾	1	0	3	4	0.75
养不起	1	3	0	4	0.75
共青团	3	1	0	4	0.75
共青	3	1	0	4	0.75
公权	1	3	0	4	0.75
公安局	1	3	0	4	0.75
全新	1	0	3	4	0.75
光盘	0	3	1	4	0.75
充满	3	1	0	4	0.75
偶尔	3	1	0	4	0.75
停火	1	3	0	4	0.75
何况	3	1	0	4	0.75
传闻	1	0	3	4	0.75
仿佛	3	1	0	4	0.75
代步	0	3	1	4	0.75
代价	0	3	1	4	0.75
仔细	1	3	0	4	0.75
今后	1	3	0	4	0.75
亲朋好友	3	1	0	4	0.75
亲朋	3	1	0	4	0.75
交警部门	1	0	3	4	0.75
交易	1	3	0	4	0.75
互联	0	3	1	4	0.75
互动	0	1	3	4	0.75
二十三	3	1	0	4	0.75
争取	3	1	0	4	0.75
主权	3	1	0	4	0.75
中学	1	3	0	4	0.75
个别	1	3	0	4	0.75
严禁	1	3	0	4	0.75
两千	1	3	0	4	0.75
业内	1	0	3	4	0.75
不通	3	1	0	4	0.75
不远	1	3	0	4	0.75
不幸	0	3	1	4	0.75
不利	1	3	0	4	0.75
下令	1	0	3	4	0.75
上个月	0	1	3	4	0.75
万一	1	3	0	4	0.75
七点	3	1	0	4	0.75
一眼	1	0	3	4	0.75
一点点	1	3	0	4	0.75
一味	1	3	0	4	0.75
一个劲	3	1	0	4	0.75
zf	1	3	0	4	0.75
good	3	0	1	4	0.75
老百姓	10	32	1	43	0.744186046512
外卖	7	26	2	35	0.742857142857
一代	5	20	2	27	0.740740740741
春联	34	6	6	46	0.739130434783
操作	14	4	1	19	0.736842105263
尽量	2	14	3	19	0.736842105263
到处	14	2	3	19	0.736842105263
鞭	3	11	1	15	0.733333333333
道理	3	11	1	15	0.733333333333
纠结	11	2	2	15	0.733333333333
疫苗	2	11	2	15	0.733333333333
添	11	1	3	15	0.733333333333
流氓	3	11	1	15	0.733333333333
油价	3	11	1	15	0.733333333333
有钱	4	11	0	15	0.733333333333
最新	1	3	11	15	0.733333333333
撞	11	2	2	15	0.733333333333
拒绝	2	11	2	15	0.733333333333
动力	2	11	2	15	0.733333333333
生产	5	19	2	26	0.730769230769
感受	19	5	2	26	0.730769230769
贴	48	9	9	66	0.727272727273
这里	16	6	0	22	0.727272727273
上路	4	16	2	22	0.727272727273
符合	3	8	0	11	0.727272727273
祥和	2	8	1	11	0.727272727273
清理	0	8	3	11	0.727272727273
清新	1	8	2	11	0.727272727273
晚婚晚育	2	8	1	11	0.727272727273
无证	8	1	2	11	0.727272727273
教	8	0	3	11	0.727272727273
排放	8	2	1	11	0.727272727273
库克	1	8	2	11	0.727272727273
城区	3	8	0	11	0.727272727273
医生	1	8	2	11	0.727272727273
加油	8	2	1	11	0.727272727273
到来	8	1	2	11	0.727272727273
别说	3	8	0	11	0.727272727273
产假	3	8	0	11	0.727272727273
不够	5	13	0	18	0.722222222222
夜	18	3	4	25	0.72
中华	18	5	2	25	0.72
减少	12	46	6	64	0.71875
低	9	30	3	42	0.714285714286
抓	8	25	2	35	0.714285714286
终于	20	4	4	28	0.714285714286
权利	3	15	3	21	0.714285714286
式	4	15	2	21	0.714285714286
变成	5	15	1	21	0.714285714286
青春	3	1	10	14	0.714285714286
浪费	3	10	1	14	0.714285714286
流畅	10	3	1	14	0.714285714286
民众	2	10	2	14	0.714285714286
新机	3	1	10	14	0.714285714286
姐妹	10	4	0	14	0.714285714286
大概	10	4	0	14	0.714285714286
团聚	10	3	1	14	0.714285714286
员工	2	2	10	14	0.714285714286
农村	10	3	1	14	0.714285714286
上市	2	2	10	14	0.714285714286
默默	5	2	0	7	0.714285714286
鬼	1	5	1	7	0.714285714286
难过	0	5	2	7	0.714285714286
都市	5	2	0	7	0.714285714286
逛庙会	5	1	1	7	0.714285714286
逗	2	0	5	7	0.714285714286
车祸	2	5	0	7	0.714285714286
舒服	5	2	0	7	0.714285714286
第	5	1	1	7	0.714285714286
祝愿	5	2	0	7	0.714285714286
确定	5	0	2	7	0.714285714286
眼中	5	1	1	7	0.714285714286
独特	5	1	1	7	0.714285714286
热热闹闹	5	2	0	7	0.714285714286
热热	5	2	0	7	0.714285714286
渣	2	5	0	7	0.714285714286
没错	5	2	0	7	0.714285714286
武	1	5	1	7	0.714285714286
最终	5	2	0	7	0.714285714286
晚安	1	5	1	7	0.714285714286
春季	2	0	5	7	0.714285714286
日前	0	5	2	7	0.714285714286
无能	1	5	1	7	0.714285714286
控	5	0	2	7	0.714285714286
我市	0	2	5	7	0.714285714286
愿者	2	5	0	7	0.714285714286
心中	5	1	1	7	0.714285714286
布斯	1	5	1	7	0.714285714286
巴马	5	2	0	7	0.714285714286
安安	2	5	0	7	0.714285714286
守	1	5	1	7	0.714285714286
奥巴马	5	2	0	7	0.714285714286
奥巴	5	2	0	7	0.714285714286
天上	5	2	0	7	0.714285714286
大幅	1	5	1	7	0.714285714286
大城市	5	1	1	7	0.714285714286
大城	5	1	1	7	0.714285714286
国产机	5	2	0	7	0.714285714286
喝	5	0	2	7	0.714285714286
味道	5	2	0	7	0.714285714286
发动	2	5	0	7	0.714285714286
半个	5	2	0	7	0.714285714286
到手	5	2	0	7	0.714285714286
几百	5	1	1	7	0.714285714286
农民	1	5	1	7	0.714285714286
伤	1	5	1	7	0.714285714286
休息	2	5	0	7	0.714285714286
令人	1	5	1	7	0.714285714286
代替	5	2	0	7	0.714285714286
亮	5	2	0	7	0.714285714286
乔布斯	1	5	1	7	0.714285714286
乔布	1	5	1	7	0.714285714286
主题	5	2	0	7	0.714285714286
中间	5	2	0	7	0.714285714286
严	1	1	5	7	0.714285714286
不顾	2	5	0	7	0.714285714286
百姓	17	59	7	83	0.710843373494
计划生育	6	27	5	38	0.710526315789
政	3	17	4	24	0.708333333333
重	2	12	3	17	0.705882352941
载客	12	2	3	17	0.705882352941
国人	3	12	2	17	0.705882352941
刀切	2	12	3	17	0.705882352941
代	2	12	3	17	0.705882352941
一刀切	2	12	3	17	0.705882352941
想想	5	19	3	27	0.703703703704
传统节日	26	4	7	37	0.702702702703
一家	14	4	2	20	0.7
规划	1	7	2	10	0.7
行人	7	3	0	10	0.7
苹果公司	1	2	7	10	0.7
祝福	7	2	1	10	0.7
生日	7	0	3	10	0.7
熊	3	7	0	10	0.7
满意	7	3	0	10	0.7
无疑	1	7	2	10	0.7
方法	0	7	3	10	0.7
房价	2	7	1	10	0.7
幼儿	7	3	0	10	0.7
对比	7	2	1	10	0.7
官方	0	7	3	10	0.7
其它	7	3	0	10	0.7
依据	1	7	2	10	0.7
上去	7	3	0	10	0.7
ios	7	0	3	10	0.7
文化	32	7	7	46	0.695652173913
伙伴	18	2	6	26	0.692307692308
驾驶	9	1	3	13	0.692307692308
遭遇	0	4	9	13	0.692307692308
群众	3	9	1	13	0.692307692308
欢乐	2	9	2	13	0.692307692308
机会	9	2	2	13	0.692307692308
暴力	3	9	1	13	0.692307692308
故事	9	3	1	13	0.692307692308
收入	4	9	0	13	0.692307692308
库存	1	9	3	13	0.692307692308
子	9	2	2	13	0.692307692308
咱	4	9	0	13	0.692307692308
共同	2	9	2	13	0.692307692308
难道	9	24	2	35	0.685714285714
适合	13	3	3	19	0.684210526316
年夜	13	3	3	19	0.684210526316
大量	4	13	2	19	0.684210526316
钱	15	43	5	63	0.68253968254
女儿	15	5	2	22	0.681818181818
每	7	17	1	25	0.68
烟花爆竹	8	44	13	65	0.676923076923
饺子	25	7	5	37	0.675675675676
社会	15	56	12	83	0.674698795181
政府	29	89	15	133	0.669172932331
喜欢	64	18	14	96	0.666666666667
燃放烟花	7	32	9	48	0.666666666667
来说	28	8	6	42	0.666666666667
小伙伴	16	2	6	24	0.666666666667
企业	4	14	3	21	0.666666666667
负责	2	12	4	18	0.666666666667
请问	3	12	3	18	0.666666666667
分析	4	2	12	18	0.666666666667
不知	12	3	3	18	0.666666666667
不仅	5	12	1	18	0.666666666667
留下	10	5	0	15	0.666666666667
猴	10	3	2	15	0.666666666667
旗舰	2	10	3	15	0.666666666667
好看	10	4	1	15	0.666666666667
多么	3	10	2	15	0.666666666667
元宵节	10	4	1	15	0.666666666667
亲	10	2	3	15	0.666666666667
迎来	8	1	3	12	0.666666666667
资源	2	8	2	12	0.666666666667
贡献	3	8	1	12	0.666666666667
战略	8	3	1	12	0.666666666667
当初	3	8	1	12	0.666666666667
庙会	8	2	2	12	0.666666666667
境内	8	1	3	12	0.666666666667
力量	8	4	0	12	0.666666666667
分析师	3	1	8	12	0.666666666667
侵略	4	8	0	12	0.666666666667
任务	8	4	0	12	0.666666666667
为啥	2	8	2	12	0.666666666667
顺产	6	2	1	9	0.666666666667
非机动	6	3	0	9	0.666666666667
铁口	6	1	2	9	0.666666666667
适应	6	0	3	9	0.666666666667
花钱	1	6	2	9	0.666666666667
老妈	6	0	3	9	0.666666666667
罚	1	6	2	9	0.666666666667
类	2	6	1	9	0.666666666667
管管	6	2	1	9	0.666666666667
牌照	2	6	1	9	0.666666666667
求	6	1	2	9	0.666666666667
权益	2	6	1	9	0.666666666667
曝	6	1	2	9	0.666666666667
撤军	2	6	1	9	0.666666666667
技术	1	2	6	9	0.666666666667
扶持	2	6	1	9	0.666666666667
很快	6	1	2	9	0.666666666667
弱势群体	3	6	0	9	0.666666666667
弱势	3	6	0	9	0.666666666667
干净	6	2	1	9	0.666666666667
屁	2	6	1	9	0.666666666667
地铁口	6	1	2	9	0.666666666667
土地	3	6	0	9	0.666666666667
哎	2	6	1	9	0.666666666667
和谐	2	6	1	9	0.666666666667
后台	6	3	0	9	0.666666666667
台	6	0	3	9	0.666666666667
卵	1	6	2	9	0.666666666667
催	6	0	3	9	0.666666666667
传承	6	2	1	9	0.666666666667
今年过年	1	6	2	9	0.666666666667
人人	2	6	1	9	0.666666666667
人为	2	6	1	9	0.666666666667
东突	6	1	2	9	0.666666666667
一批	1	6	2	9	0.666666666667
龙	4	1	1	6	0.666666666667
麻将	4	1	1	6	0.666666666667
预产期	4	0	2	6	0.666666666667
预产	4	0	2	6	0.666666666667
面前	4	0	2	6	0.666666666667
阿富汗	4	1	1	6	0.666666666667
遗憾	4	2	0	6	0.666666666667
逆	4	1	1	6	0.666666666667
辣	4	1	1	6	0.666666666667
软件	4	0	2	6	0.666666666667
跳	4	1	1	6	0.666666666667
路权	0	4	2	6	0.666666666667
起码	4	1	1	6	0.666666666667
赞同	1	4	1	6	0.666666666667
负担	4	2	0	6	0.666666666667
试试	0	4	2	6	0.666666666667
觉悟	4	2	0	6	0.666666666667
观点	0	2	4	6	0.666666666667
观	1	4	1	6	0.666666666667
融融	4	1	1	6	0.666666666667
落后	1	4	1	6	0.666666666667
良好	4	0	2	6	0.666666666667
自身	4	2	0	6	0.666666666667
腊月	4	1	1	6	0.666666666667
脑袋	4	2	0	6	0.666666666667
聚会	4	0	2	6	0.666666666667
联系	2	0	4	6	0.666666666667
职业	1	4	1	6	0.666666666667
红火	4	2	0	6	0.666666666667
第四	2	0	4	6	0.666666666667
第一天	4	2	0	6	0.666666666667
突厥	4	1	1	6	0.666666666667
秀	4	0	2	6	0.666666666667
祖宗	4	2	0	6	0.666666666667
短信	0	4	2	6	0.666666666667
相反	1	4	1	6	0.666666666667
电脑	4	0	2	6	0.666666666667
生育权	1	4	1	6	0.666666666667
特区	1	4	1	6	0.666666666667
燃	1	4	1	6	0.666666666667
演	4	1	1	6	0.666666666667
消耗	1	4	1	6	0.666666666667
比起	4	1	1	6	0.666666666667
残	1	4	1	6	0.666666666667
梅	4	1	1	6	0.666666666667
格	4	2	0	6	0.666666666667
杨	1	4	1	6	0.666666666667
普遍	2	4	0	6	0.666666666667
晚报	0	4	2	6	0.666666666667
日常生活	1	4	1	6	0.666666666667
族	0	4	2	6	0.666666666667
新鲜	0	4	2	6	0.666666666667
新生	4	0	2	6	0.666666666667
攻击	4	2	0	6	0.666666666667
改装	4	1	1	6	0.666666666667
提出	1	4	1	6	0.666666666667
排号	1	4	1	6	0.666666666667
挣钱	4	2	0	6	0.666666666667
指出	2	4	0	6	0.666666666667
批评	4	2	0	6	0.666666666667
想象	4	2	0	6	0.666666666667
情绪	4	1	1	6	0.666666666667
性	2	4	0	6	0.666666666667
志愿者	2	4	0	6	0.666666666667
引力	2	4	0	6	0.666666666667
弄死	0	4	2	6	0.666666666667
延续	2	4	0	6	0.666666666667
年画	4	1	1	6	0.666666666667
平平安安	2	4	0	6	0.666666666667
平平	2	4	0	6	0.666666666667
常生	1	4	1	6	0.666666666667
巴尔米	4	1	1	6	0.666666666667
巴尔	4	1	1	6	0.666666666667
工厂	4	1	1	6	0.666666666667
实力	4	2	0	6	0.666666666667
媒	2	0	4	6	0.666666666667
娶	0	4	2	6	0.666666666667
好玩	4	2	0	6	0.666666666667
好久	4	2	0	6	0.666666666667
央视	0	4	2	6	0.666666666667
大都	4	1	1	6	0.666666666667
大屏幕	4	1	1	6	0.666666666667
外地	1	4	1	6	0.666666666667
圣诞	4	1	1	6	0.666666666667
团结	2	4	0	6	0.666666666667
嗯	4	1	1	6	0.666666666667
啥时候	2	4	0	6	0.666666666667
响声	1	4	1	6	0.666666666667
吸引力	2	4	0	6	0.666666666667
同事	4	1	1	6	0.666666666667
司机	4	1	1	6	0.666666666667
发起	4	2	0	6	0.666666666667
发言人	4	2	0	6	0.666666666667
反映	1	4	1	6	0.666666666667
千	4	1	1	6	0.666666666667
十万	0	4	2	6	0.666666666667
办理	4	0	2	6	0.666666666667
刘	1	4	1	6	0.666666666667
凭	4	0	2	6	0.666666666667
几次	4	1	1	6	0.666666666667
其乐融融	4	1	1	6	0.666666666667
公平	1	1	4	6	0.666666666667
保险	4	0	2	6	0.666666666667
俗称	4	0	2	6	0.666666666667
作用	2	4	0	6	0.666666666667
伤害	2	4	0	6	0.666666666667
优秀	4	1	1	6	0.666666666667
价位	2	4	0	6	0.666666666667
仗	4	2	0	6	0.666666666667
产期	4	0	2	6	0.666666666667
乐融融	4	1	1	6	0.666666666667
中队	4	0	2	6	0.666666666667
两轮	1	4	1	6	0.666666666667
不许	2	4	0	6	0.666666666667
不准	2	4	0	6	0.666666666667
一线	2	4	0	6	0.666666666667
一代人	1	4	1	6	0.666666666667
黑龙江省	2	0	1	3	0.666666666667
黎明	2	0	1	3	0.666666666667
黎巴嫩	0	2	1	3	0.666666666667
黄金	0	2	1	3	0.666666666667
黄冈	2	0	1	3	0.666666666667
麻痹	1	2	0	3	0.666666666667
鹏	2	1	0	3	0.666666666667
鸣	2	0	1	3	0.666666666667
鸡蛋	2	0	1	3	0.666666666667
鸡	1	2	0	3	0.666666666667
魅力	2	1	0	3	0.666666666667
高清	0	2	1	3	0.666666666667
高度	2	1	0	3	0.666666666667
高大	1	2	0	3	0.666666666667
驾	0	2	1	3	0.666666666667
马路上	2	1	0	3	0.666666666667
首选	2	1	0	3	0.666666666667
首次	0	2	1	3	0.666666666667
饿	2	1	0	3	0.666666666667
飙升	0	2	1	3	0.666666666667
频频	0	1	2	3	0.666666666667
预约	2	0	1	3	0.666666666667
预示	0	2	1	3	0.666666666667
预定	2	1	0	3	0.666666666667
面子	1	2	0	3	0.666666666667
面包	0	2	1	3	0.666666666667
面上	1	2	0	3	0.666666666667
静静	1	2	0	3	0.666666666667
震惊	0	2	1	3	0.666666666667
难民潮	2	1	0	3	0.666666666667
难得	2	1	0	3	0.666666666667
难免	1	2	0	3	0.666666666667
隔壁	1	0	2	3	0.666666666667
隔	1	2	0	3	0.666666666667
隆隆	1	2	0	3	0.666666666667
除非	0	2	1	3	0.666666666667
限购	2	1	0	3	0.666666666667
陌生	0	2	1	3	0.666666666667
阿訇	1	2	0	3	0.666666666667
阻止	1	2	0	3	0.666666666667
阴霾	1	2	0	3	0.666666666667
阴	1	2	0	3	0.666666666667
防空	0	2	1	3	0.666666666667
阖家团圆	2	1	0	3	0.666666666667
问世	0	1	2	3	0.666666666667
长远	1	2	0	3	0.666666666667
镜头	2	0	1	3	0.666666666667
镇	2	0	1	3	0.666666666667
键盘	2	1	0	3	0.666666666667
钻	2	1	0	3	0.666666666667
钥匙	1	2	0	3	0.666666666667
重复	1	2	0	3	0.666666666667
配套	0	2	1	3	0.666666666667
部署	1	2	0	3	0.666666666667
郝	2	1	0	3	0.666666666667
邻居	0	1	2	3	0.666666666667
邪恶	2	1	0	3	0.666666666667
邀请	1	0	2	3	0.666666666667
避开	2	1	0	3	0.666666666667
遭到	1	2	0	3	0.666666666667
遇冷	0	1	2	3	0.666666666667
遇	1	2	0	3	0.666666666667
逮	1	2	0	3	0.666666666667
造就	2	1	0	3	0.666666666667
速战速决	2	1	0	3	0.666666666667
速战	2	1	0	3	0.666666666667
速决	2	1	0	3	0.666666666667
选择性	2	1	0	3	0.666666666667
适当	2	1	0	3	0.666666666667
追	1	2	0	3	0.666666666667
迷信	1	0	2	3	0.666666666667
远方	0	2	1	3	0.666666666667
远征	1	2	0	3	0.666666666667
远东	0	2	1	3	0.666666666667
进攻	2	1	0	3	0.666666666667
进展	2	0	1	3	0.666666666667
这回	0	2	1	3	0.666666666667
运送	1	0	2	3	0.666666666667
运营	1	2	0	3	0.666666666667
过后	1	2	0	3	0.666666666667
辽宁	2	1	0	3	0.666666666667
边	1	0	2	3	0.666666666667
辈子	2	1	0	3	0.666666666667
轿车	1	2	0	3	0.666666666667
轻轻	1	0	2	3	0.666666666667
轮子	0	2	1	3	0.666666666667
转变	1	2	0	3	0.666666666667
转为	2	1	0	3	0.666666666667
车场	1	2	0	3	0.666666666667
车位	1	2	0	3	0.666666666667
跳跳	2	0	1	3	0.666666666667
路面	2	1	0	3	0.666666666667
跪	2	1	0	3	0.666666666667
跨	1	0	2	3	0.666666666667
跟风	2	0	1	3	0.666666666667
跟上	2	1	0	3	0.666666666667
超速	1	2	0	3	0.666666666667
超级	2	0	1	3	0.666666666667
趁着	2	0	1	3	0.666666666667
起床	2	0	1	3	0.666666666667
赶上	1	2	0	3	0.666666666667
赵	2	0	1	3	0.666666666667
走走	2	1	0	3	0.666666666667
走狗	2	1	0	3	0.666666666667
走来	2	1	0	3	0.666666666667
走亲访友	2	0	1	3	0.666666666667
赫	2	1	0	3	0.666666666667
赢家	2	0	1	3	0.666666666667
赚	1	2	0	3	0.666666666667
贺	1	2	0	3	0.666666666667
费	1	2	0	3	0.666666666667
贴着	1	0	2	3	0.666666666667
购物	2	1	0	3	0.666666666667
质疑	0	1	2	3	0.666666666667
责	1	2	0	3	0.666666666667
财经	0	1	2	3	0.666666666667
财神爷	2	0	1	3	0.666666666667
财富	0	2	1	3	0.666666666667
豆腐	2	0	1	3	0.666666666667
谜	1	2	0	3	0.666666666667
调节	2	1	0	3	0.666666666667
诺基亚	1	2	0	3	0.666666666667
说来	2	0	1	3	0.666666666667
说了算	1	2	0	3	0.666666666667
诱惑	0	2	1	3	0.666666666667
误解	2	0	1	3	0.666666666667
语言	0	1	2	3	0.666666666667
许州	1	2	0	3	0.666666666667
许可	0	1	2	3	0.666666666667
讲道理	2	1	0	3	0.666666666667
讲道	2	1	0	3	0.666666666667
讲座	1	2	0	3	0.666666666667
让路	1	2	0	3	0.666666666667
认真	1	0	2	3	0.666666666667
认可	1	2	0	3	0.666666666667
订单	1	0	2	3	0.666666666667
警车	0	2	1	3	0.666666666667
警告	1	2	0	3	0.666666666667
角落	0	2	1	3	0.666666666667
角色	2	1	0	3	0.666666666667
视野	2	1	0	3	0.666666666667
视为	1	2	0	3	0.666666666667
见识	0	1	2	3	0.666666666667
见得	1	2	0	3	0.666666666667
覆盖	0	1	2	3	0.666666666667
要说	1	2	0	3	0.666666666667
要不然	1	2	0	3	0.666666666667
西乡	1	0	2	3	0.666666666667
袭	1	2	0	3	0.666666666667
被窝	2	0	1	3	0.666666666667
衷心	1	2	0	3	0.666666666667
表态	2	1	0	3	0.666666666667
补助	0	2	1	3	0.666666666667
补	2	0	1	3	0.666666666667
行列	0	2	1	3	0.666666666667
落	1	2	0	3	0.666666666667
营	0	2	1	3	0.666666666667
苑	2	1	0	3	0.666666666667
苏州	2	0	1	3	0.666666666667
花炮	0	1	2	3	0.666666666667
艾	1	2	0	3	0.666666666667
艺	1	0	2	3	0.666666666667
航空	2	1	0	3	0.666666666667
舞	0	2	1	3	0.666666666667
舜	1	2	0	3	0.666666666667
舍	2	0	1	3	0.666666666667
自由民主	2	1	0	3	0.666666666667
自由民	2	1	0	3	0.666666666667
自卫	1	0	2	3	0.666666666667
自个	1	2	0	3	0.666666666667
脱离	1	2	0	3	0.666666666667
脚步	2	1	0	3	0.666666666667
能源	1	2	0	3	0.666666666667
背景	2	0	1	3	0.666666666667
育	1	2	0	3	0.666666666667
股市	2	1	0	3	0.666666666667
肉	2	1	0	3	0.666666666667
肆意	1	2	0	3	0.666666666667
肃	2	0	1	3	0.666666666667
聊到	2	0	1	3	0.666666666667
耽误	1	2	0	3	0.666666666667
耐用	2	0	1	3	0.666666666667
耐心	2	1	0	3	0.666666666667
而来	0	1	2	3	0.666666666667
考验	1	0	2	3	0.666666666667
老路	0	2	1	3	0.666666666667
老虎	2	0	1	3	0.666666666667
老爸	2	0	1	3	0.666666666667
老年	1	2	0	3	0.666666666667
翻倍	1	2	0	3	0.666666666667
翻	2	0	1	3	0.666666666667
羡慕	2	0	1	3	0.666666666667
美满	2	1	0	3	0.666666666667
罪	1	2	0	3	0.666666666667
罗	2	0	1	3	0.666666666667
网点	1	2	0	3	0.666666666667
缺失	1	2	0	3	0.666666666667
缓缓	2	1	0	3	0.666666666667
维	2	0	1	3	0.666666666667
绕	0	1	2	3	0.666666666667
细	1	2	0	3	0.666666666667
组合	2	0	1	3	0.666666666667
纸	2	0	1	3	0.666666666667
纯	2	0	1	3	0.666666666667
纪录	0	1	2	3	0.666666666667
红色	0	1	2	3	0.666666666667
累赘	1	2	0	3	0.666666666667
素	0	2	1	3	0.666666666667
管理者	1	2	0	3	0.666666666667
管理混乱	2	1	0	3	0.666666666667
签	0	2	1	3	0.666666666667
竹子	1	2	0	3	0.666666666667
端	2	0	1	3	0.666666666667
童年	2	1	0	3	0.666666666667
空军基地	2	1	0	3	0.666666666667
稿件	0	2	1	3	0.666666666667
税	1	2	0	3	0.666666666667
秧歌	2	0	1	3	0.666666666667
私立	1	2	0	3	0.666666666667
离开	2	1	0	3	0.666666666667
离家	2	1	0	3	0.666666666667
福田	1	0	2	3	0.666666666667
福建	1	2	0	3	0.666666666667
福州	0	1	2	3	0.666666666667
福字	2	1	0	3	0.666666666667
神经	0	2	1	3	0.666666666667
神学家	1	2	0	3	0.666666666667
社保	1	2	0	3	0.666666666667
社会舆论	0	1	2	3	0.666666666667
社会秩序	0	2	1	3	0.666666666667
社会各界	0	2	1	3	0.666666666667
礼貌	1	2	0	3	0.666666666667
碰	0	2	1	3	0.666666666667
碗	1	0	2	3	0.666666666667
确认	1	0	2	3	0.666666666667
确保	1	0	2	3	0.666666666667
确	1	2	0	3	0.666666666667
破除	2	0	1	3	0.666666666667
研究生	1	0	2	3	0.666666666667
石化	2	1	0	3	0.666666666667
短时间	1	2	0	3	0.666666666667
知名	0	2	1	3	0.666666666667
瞧瞧	0	1	2	3	0.666666666667
瞧	2	1	0	3	0.666666666667
真主	1	2	0	3	0.666666666667
看电视	1	0	2	3	0.666666666667
看待	0	1	2	3	0.666666666667
省市	0	2	1	3	0.666666666667
盼	1	0	2	3	0.666666666667
相继	0	2	1	3	0.666666666667
相应	0	2	1	3	0.666666666667
直逼	2	1	0	3	0.666666666667
目测	0	1	2	3	0.666666666667
盟友	0	1	2	3	0.666666666667
盛大	2	0	1	3	0.666666666667
监督	2	1	0	3	0.666666666667
皇家	1	0	2	3	0.666666666667
皆	1	0	2	3	0.666666666667
白眼	2	1	0	3	0.666666666667
白天	0	2	1	3	0.666666666667
登陆	1	0	2	3	0.666666666667
瘫痪	0	1	2	3	0.666666666667
疑惑	1	2	0	3	0.666666666667
略	2	1	0	3	0.666666666667
男性	0	1	2	3	0.666666666667
用电	1	2	0	3	0.666666666667
用心	2	1	0	3	0.666666666667
生计	0	1	2	3	0.666666666667
生生	1	2	0	3	0.666666666667
生理	1	2	0	3	0.666666666667
生气	2	1	0	3	0.666666666667
瑟	2	0	1	3	0.666666666667
琢磨	2	1	0	3	0.666666666667
理智	2	0	1	3	0.666666666667
理事	1	2	0	3	0.666666666667
球	2	1	0	3	0.666666666667
玺	2	1	0	3	0.666666666667
现行	1	2	0	3	0.666666666667
现状	1	2	0	3	0.666666666667
现如今	0	2	1	3	0.666666666667
玩耍	2	1	0	3	0.666666666667
玩笑	2	1	0	3	0.666666666667
王八蛋	2	1	0	3	0.666666666667
率	2	1	0	3	0.666666666667
独裁者	1	2	0	3	0.666666666667
狂欢	2	1	0	3	0.666666666667
狂	2	1	0	3	0.666666666667
犹豫	2	0	1	3	0.666666666667
牺牲品	2	1	0	3	0.666666666667
爱好者	1	0	2	3	0.666666666667
熟	0	2	1	3	0.666666666667
烧毁	1	2	0	3	0.666666666667
烟雾	0	2	1	3	0.666666666667
灵活	1	2	0	3	0.666666666667
灯谜	1	0	2	3	0.666666666667
灯节	2	0	1	3	0.666666666667
灭绝	2	1	0	3	0.666666666667
灭	2	1	0	3	0.666666666667
火锅	1	0	2	3	0.666666666667
火光	1	0	2	3	0.666666666667
潇	2	0	1	3	0.666666666667
满满的	2	1	0	3	0.666666666667
满月	2	0	1	3	0.666666666667
滞后	2	1	0	3	0.666666666667
滚滚	2	0	1	3	0.666666666667
滚	2	0	1	3	0.666666666667
温馨	2	1	0	3	0.666666666667
清明节	2	0	1	3	0.666666666667
清华	0	2	1	3	0.666666666667
深空	2	1	0	3	0.666666666667
深圳市政府	1	2	0	3	0.666666666667
涉及	0	1	2	3	0.666666666667
浓厚	2	0	1	3	0.666666666667
测	2	0	1	3	0.666666666667
流行	2	0	1	3	0.666666666667
流	0	1	2	3	0.666666666667
泡	2	1	0	3	0.666666666667
法制	0	1	2	3	0.666666666667
治标	1	2	0	3	0.666666666667
治家	1	2	0	3	0.666666666667
沦为	2	1	0	3	0.666666666667
没用过	1	2	0	3	0.666666666667
沙	2	1	0	3	0.666666666667
污浊	0	2	1	3	0.666666666667
江苏	0	2	1	3	0.666666666667
江	1	0	2	3	0.666666666667
民兵	2	0	1	3	0.666666666667
比亚迪	0	2	1	3	0.666666666667
每逢	1	0	2	3	0.666666666667
每家	1	2	0	3	0.666666666667
段子	2	0	1	3	0.666666666667
死活	1	2	0	3	0.666666666667
死亡率	1	2	0	3	0.666666666667
歪	1	2	0	3	0.666666666667
此起彼伏	1	2	0	3	0.666666666667
此时	2	1	0	3	0.666666666667
此后	2	0	1	3	0.666666666667
此事	0	1	2	3	0.666666666667
此举	1	0	2	3	0.666666666667
正当	0	2	1	3	0.666666666667
歌	2	0	1	3	0.666666666667
欲	1	0	2	3	0.666666666667
棒子	1	2	0	3	0.666666666667
检测	1	2	0	3	0.666666666667
梦见	1	0	2	3	0.666666666667
桥	2	1	0	3	0.666666666667
档次	2	0	1	3	0.666666666667
根本原因	1	2	0	3	0.666666666667
核	1	2	0	3	0.666666666667
校长	0	1	2	3	0.666666666667
极端分子	2	1	0	3	0.666666666667
极点	2	1	0	3	0.666666666667
来回	1	2	0	3	0.666666666667
杜绝	1	0	2	3	0.666666666667
村民	2	1	0	3	0.666666666667
村	1	2	0	3	0.666666666667
杀伤	1	2	0	3	0.666666666667
机器人	1	2	0	3	0.666666666667
朱	1	0	2	3	0.666666666667
本地	1	0	2	3	0.666666666667
本原	1	2	0	3	0.666666666667
未然	2	1	0	3	0.666666666667
未有	2	1	0	3	0.666666666667
未必	1	0	2	3	0.666666666667
期	1	0	2	3	0.666666666667
朝鲜	0	1	2	3	0.666666666667
有种	0	2	1	3	0.666666666667
有意思	1	2	0	3	0.666666666667
月底	2	0	1	3	0.666666666667
最早	1	2	0	3	0.666666666667
替代	1	2	0	3	0.666666666667
暴露	2	1	0	3	0.666666666667
暗中	1	2	0	3	0.666666666667
暂	1	2	0	3	0.666666666667
智障	0	2	1	3	0.666666666667
景气	0	1	2	3	0.666666666667
晚餐	1	0	2	3	0.666666666667
晃	0	2	1	3	0.666666666667
是非	1	0	2	3	0.666666666667
明摆着	2	0	1	3	0.666666666667
明摆	2	0	1	3	0.666666666667
时报	1	2	0	3	0.666666666667
旱船	2	0	1	3	0.666666666667
早早	1	2	0	3	0.666666666667
日渐	1	2	0	3	0.666666666667
日期	2	1	0	3	0.666666666667
日后	1	2	0	3	0.666666666667
无论是	2	0	1	3	0.666666666667
无论如何	1	0	2	3	0.666666666667
无异	1	2	0	3	0.666666666667
无可	2	1	0	3	0.666666666667
无力	1	2	0	3	0.666666666667
新风	0	2	1	3	0.666666666667
新品	0	1	2	3	0.666666666667
斯	2	0	1	3	0.666666666667
断	1	2	0	3	0.666666666667
料	1	0	2	3	0.666666666667
文艺	1	2	0	3	0.666666666667
整天	2	0	1	3	0.666666666667
教训	0	2	1	3	0.666666666667
教师	1	2	0	3	0.666666666667
教书	0	2	1	3	0.666666666667
敌	2	1	0	3	0.666666666667
效仿	1	2	0	3	0.666666666667
故	1	2	0	3	0.666666666667
政治家	1	2	0	3	0.666666666667
政客	0	2	1	3	0.666666666667
放松	2	1	0	3	0.666666666667
放大	1	2	0	3	0.666666666667
改进	0	2	1	3	0.666666666667
收场	0	2	1	3	0.666666666667
攒钱	0	1	2	3	0.666666666667
撤出	1	2	0	3	0.666666666667
摸	0	1	2	3	0.666666666667
摒弃	0	2	1	3	0.666666666667
摊主	1	0	2	3	0.666666666667
摇	1	2	0	3	0.666666666667
摆脱	2	1	0	3	0.666666666667
摄影	1	0	2	3	0.666666666667
搜狐	2	0	1	3	0.666666666667
搜	1	2	0	3	0.666666666667
揭	2	1	0	3	0.666666666667
掰	1	2	0	3	0.666666666667
推广	1	2	0	3	0.666666666667
接送	0	2	1	3	0.666666666667
掌握	2	1	0	3	0.666666666667
授权	1	0	2	3	0.666666666667
换掉	2	1	0	3	0.666666666667
捏	2	0	1	3	0.666666666667
捅	2	1	0	3	0.666666666667
挨	0	1	2	3	0.666666666667
挑衅	2	0	1	3	0.666666666667
指望	1	2	0	3	0.666666666667
指南	2	1	0	3	0.666666666667
指使	1	0	2	3	0.666666666667
拼到底	0	2	1	3	0.666666666667
拼到	0	2	1	3	0.666666666667
拥护	2	1	0	3	0.666666666667
拒	1	0	2	3	0.666666666667
拍手	0	1	2	3	0.666666666667
拉开	1	2	0	3	0.666666666667
担忧	0	1	2	3	0.666666666667
抽	2	0	1	3	0.666666666667
抵触	1	2	0	3	0.666666666667
报告	1	0	2	3	0.666666666667
报名	2	0	1	3	0.666666666667
抢占	0	2	1	3	0.666666666667
投诉	1	2	0	3	0.666666666667
投入	1	0	2	3	0.666666666667
投	1	2	0	3	0.666666666667
抓住	2	1	0	3	0.666666666667
扭秧歌	2	0	1	3	0.666666666667
扫地	0	2	1	3	0.666666666667
扩张	2	1	0	3	0.666666666667
扣押	1	2	0	3	0.666666666667
打破	0	1	2	3	0.666666666667
打仗	2	1	0	3	0.666666666667
打人	1	2	0	3	0.666666666667
才刚	2	1	0	3	0.666666666667
手续	2	1	0	3	0.666666666667
所欲	0	2	1	3	0.666666666667
房贷	1	2	0	3	0.666666666667
战果	2	1	0	3	0.666666666667
战局	2	1	0	3	0.666666666667
成语	0	2	1	3	0.666666666667
戏	2	0	1	3	0.666666666667
懂得	2	1	0	3	0.666666666667
感器	0	2	1	3	0.666666666667
愚蠢	0	2	1	3	0.666666666667
惠州	0	2	1	3	0.666666666667
情报	1	0	2	3	0.666666666667
情人节	1	2	0	3	0.666666666667
情人	1	2	0	3	0.666666666667
悲	2	0	1	3	0.666666666667
恩爱	1	0	2	3	0.666666666667
恨不得	1	2	0	3	0.666666666667
恨	2	0	1	3	0.666666666667
总能	2	0	1	3	0.666666666667
总结	0	1	2	3	0.666666666667
总的来说	2	1	0	3	0.666666666667
怪兽	2	0	1	3	0.666666666667
性命	1	2	0	3	0.666666666667
怀疑	1	2	0	3	0.666666666667
怀念	1	2	0	3	0.666666666667
忽然	0	2	1	3	0.666666666667
快要	1	0	2	3	0.666666666667
快件	0	2	1	3	0.666666666667
必定	2	1	0	3	0.666666666667
必不可少	2	0	1	3	0.666666666667
心心	2	1	0	3	0.666666666667
律法	1	2	0	3	0.666666666667
很久	2	1	0	3	0.666666666667
影响力	2	0	1	3	0.666666666667
当场	1	0	2	3	0.666666666667
当做	0	2	1	3	0.666666666667
当事	0	2	1	3	0.666666666667
强迫	1	2	0	3	0.666666666667
强悍	2	1	0	3	0.666666666667
强度	1	2	0	3	0.666666666667
弱智	1	2	0	3	0.666666666667
弃	2	0	1	3	0.666666666667
开开心心	2	1	0	3	0.666666666667
开开心	2	1	0	3	0.666666666667
康	0	1	2	3	0.666666666667
废	1	2	0	3	0.666666666667
底	1	0	2	3	0.666666666667
应用	1	2	0	3	0.666666666667
庆幸	0	2	1	3	0.666666666667
庆	1	0	2	3	0.666666666667
平均	1	2	0	3	0.666666666667
市长	2	1	0	3	0.666666666667
市场需求	2	0	1	3	0.666666666667
市场份额	0	1	2	3	0.666666666667
已然	0	1	2	3	0.666666666667
已成	0	1	2	3	0.666666666667
差距	0	2	1	3	0.666666666667
工程	1	2	0	3	0.666666666667
工	1	0	2	3	0.666666666667
州官放火	1	2	0	3	0.666666666667
州官	1	2	0	3	0.666666666667
岗	2	0	1	3	0.666666666667
山西	0	1	2	3	0.666666666667
屏门	0	2	1	3	0.666666666667
居	2	0	1	3	0.666666666667
尽量少	0	2	1	3	0.666666666667
就让	1	0	2	3	0.666666666667
少部分	0	2	1	3	0.666666666667
小说	2	1	0	3	0.666666666667
小弟	2	0	1	3	0.666666666667
小巷	2	1	0	3	0.666666666667
小家	2	1	0	3	0.666666666667
小儿	2	0	1	3	0.666666666667
小偷	0	1	2	3	0.666666666667
小人	1	2	0	3	0.666666666667
将近	2	1	0	3	0.666666666667
射	1	2	0	3	0.666666666667
对立	1	2	0	3	0.666666666667
富裕	1	2	0	3	0.666666666667
富人	0	1	2	3	0.666666666667
密集	0	2	1	3	0.666666666667
家教	0	1	2	3	0.666666666667
宰	1	2	0	3	0.666666666667
宣战	0	2	1	3	0.666666666667
客观	1	2	0	3	0.666666666667
宠物	0	1	2	3	0.666666666667
官僚	1	2	0	3	0.666666666667
安理会	0	1	2	3	0.666666666667
安排	1	2	0	3	0.666666666667
守法	2	1	0	3	0.666666666667
孩儿	2	1	0	3	0.666666666667
学家	1	2	0	3	0.666666666667
学会	2	0	1	3	0.666666666667
存储	1	0	2	3	0.666666666667
嫣	2	0	1	3	0.666666666667
嫌贵	0	1	2	3	0.666666666667
嫁给	2	1	0	3	0.666666666667
媒体报道	0	1	2	3	0.666666666667
妈咪	2	1	0	3	0.666666666667
妇幼	2	0	1	3	0.666666666667
如出一辙	0	2	1	3	0.666666666667
好者	1	0	2	3	0.666666666667
好开心	2	1	0	3	0.666666666667
好吃	2	1	0	3	0.666666666667
奴隶	1	2	0	3	0.666666666667
女王	2	0	1	3	0.666666666667
女权	0	1	2	3	0.666666666667
女子	1	0	2	3	0.666666666667
套房	0	2	1	3	0.666666666667
奖金	1	0	2	3	0.666666666667
夺走	2	1	0	3	0.666666666667
夹	1	2	0	3	0.666666666667
头顶	1	2	0	3	0.666666666667
头目	2	0	1	3	0.666666666667
头疼	2	0	1	3	0.666666666667
太阳	2	1	0	3	0.666666666667
太慢	0	1	2	3	0.666666666667
太平	0	2	1	3	0.666666666667
太好了	1	2	0	3	0.666666666667
太原	1	0	2	3	0.666666666667
太丑	2	0	1	3	0.666666666667
大雨	0	2	1	3	0.666666666667
大都市	2	1	0	3	0.666666666667
大规模	0	2	1	3	0.666666666667
大规	0	2	1	3	0.666666666667
大街小巷	2	1	0	3	0.666666666667
大约	0	2	1	3	0.666666666667
大堆	1	2	0	3	0.666666666667
大力支持	1	2	0	3	0.666666666667
大利	0	1	2	3	0.666666666667
大军	1	0	2	3	0.666666666667
大使	2	1	0	3	0.666666666667
够用	2	1	0	3	0.666666666667
夜间	0	2	1	3	0.666666666667
多万	2	0	1	3	0.666666666667
外长	2	1	0	3	0.666666666667
外环	2	1	0	3	0.666666666667
外加	1	2	0	3	0.666666666667
夕	2	0	1	3	0.666666666667
复兴	2	1	0	3	0.666666666667
备胎	1	0	2	3	0.666666666667
墓地	2	1	0	3	0.666666666667
塌	0	2	1	3	0.666666666667
堪忧	1	2	0	3	0.666666666667
堆放	0	2	1	3	0.666666666667
基亚	1	2	0	3	0.666666666667
城镇	1	2	0	3	0.666666666667
型号	0	1	2	3	0.666666666667
坚守	2	1	0	3	0.666666666667
坐不住	2	0	1	3	0.666666666667
地缘	0	2	1	3	0.666666666667
地产	1	0	2	3	0.666666666667
在外	2	1	0	3	0.666666666667
土狗	2	1	0	3	0.666666666667
土匪	1	2	0	3	0.666666666667
圈圈	2	1	0	3	0.666666666667
国道	2	1	0	3	0.666666666667
国务	2	0	1	3	0.666666666667
团	2	1	0	3	0.666666666667
回过	2	1	0	3	0.666666666667
四胎	0	1	2	3	0.666666666667
嚣张	2	1	0	3	0.666666666667
噼里啪啦	1	2	0	3	0.666666666667
噼噼叭叭	1	2	0	3	0.666666666667
喵	2	0	1	3	0.666666666667
喂	2	1	0	3	0.666666666667
啃	0	2	1	3	0.666666666667
哒	1	2	0	3	0.666666666667
咬牙	0	1	2	3	0.666666666667
周全	1	0	2	3	0.666666666667
听听	1	2	0	3	0.666666666667
后边	1	0	2	3	0.666666666667
后置	2	1	0	3	0.666666666667
同步	1	0	2	3	0.666666666667
吉祥	2	1	0	3	0.666666666667
吃亏	2	1	0	3	0.666666666667
右	0	2	1	3	0.666666666667
叭叭	1	2	0	3	0.666666666667
只许州官放火	1	2	0	3	0.666666666667
另一方面	0	2	1	3	0.666666666667
另一方	0	2	1	3	0.666666666667
古城	2	1	0	3	0.666666666667
口岸	2	1	0	3	0.666666666667
受访者	0	2	1	3	0.666666666667
受不了	2	0	1	3	0.666666666667
发货	1	2	0	3	0.666666666667
发红包	1	0	2	3	0.666666666667
发红	1	0	2	3	0.666666666667
发放	1	0	2	3	0.666666666667
发售	1	2	0	3	0.666666666667
反击	2	1	0	3	0.666666666667
友情	1	0	2	3	0.666666666667
叉	2	1	0	3	0.666666666667
参考	1	2	0	3	0.666666666667
县城	2	1	0	3	0.666666666667
原本	1	2	0	3	0.666666666667
原创	1	2	0	3	0.666666666667
原则	1	2	0	3	0.666666666667
压榨	1	2	0	3	0.666666666667
压根	1	2	0	3	0.666666666667
占领	2	1	0	3	0.666666666667
占用	1	2	0	3	0.666666666667
单纯	1	2	0	3	0.666666666667
单方面	0	1	2	3	0.666666666667
单方	0	1	2	3	0.666666666667
单一	2	0	1	3	0.666666666667
协助	2	0	1	3	0.666666666667
华丽	2	0	1	3	0.666666666667
华	2	0	1	3	0.666666666667
十几年	1	2	0	3	0.666666666667
医保	1	2	0	3	0.666666666667
北部	0	2	1	3	0.666666666667
北上	1	2	0	3	0.666666666667
加班	2	1	0	3	0.666666666667
加拿大	1	0	2	3	0.666666666667
加拿	1	0	2	3	0.666666666667
功	1	2	0	3	0.666666666667
力推	1	2	0	3	0.666666666667
剧	1	2	0	3	0.666666666667
剑	1	0	2	3	0.666666666667
前置	0	2	1	3	0.666666666667
前来	2	1	0	3	0.666666666667
前所未有	2	1	0	3	0.666666666667
前所	2	1	0	3	0.666666666667
前奏	2	0	1	3	0.666666666667
前夫	1	0	2	3	0.666666666667
制裁	1	0	2	3	0.666666666667
到极点	2	1	0	3	0.666666666667
到头	2	0	1	3	0.666666666667
利润率	0	2	1	3	0.666666666667
利润	0	2	1	3	0.666666666667
删除	0	2	1	3	0.666666666667
初步	1	2	0	3	0.666666666667
初期	0	1	2	3	0.666666666667
切勿	2	1	0	3	0.666666666667
出击	2	1	0	3	0.666666666667
凶	2	1	0	3	0.666666666667
凯	0	1	2	3	0.666666666667
几百万	2	0	1	3	0.666666666667
几张	0	1	2	3	0.666666666667
几万	2	0	1	3	0.666666666667
减肥	2	0	1	3	0.666666666667
冷静	2	1	0	3	0.666666666667
冲天	2	0	1	3	0.666666666667
军人	2	0	1	3	0.666666666667
内涵	2	1	0	3	0.666666666667
兽	2	0	1	3	0.666666666667
养活	0	2	1	3	0.666666666667
兵	1	2	0	3	0.666666666667
共和国	0	2	1	3	0.666666666667
共和	0	2	1	3	0.666666666667
兰	2	1	0	3	0.666666666667
公布	0	1	2	3	0.666666666667
公务员	1	2	0	3	0.666666666667
公务	1	2	0	3	0.666666666667
全都	1	2	0	3	0.666666666667
全程	2	0	1	3	0.666666666667
全市	1	2	0	3	0.666666666667
克制	1	2	0	3	0.666666666667
克	0	2	1	3	0.666666666667
充	1	2	0	3	0.666666666667
停车场	1	2	0	3	0.666666666667
停战	1	2	0	3	0.666666666667
做主	0	2	1	3	0.666666666667
借机	1	0	2	3	0.666666666667
倍	2	1	0	3	0.666666666667
信号	1	2	0	3	0.666666666667
保卫	1	2	0	3	0.666666666667
保不住	0	2	1	3	0.666666666667
俄方	1	2	0	3	0.666666666667
促进	1	2	0	3	0.666666666667
侧面	2	0	1	3	0.666666666667
依靠	1	0	2	3	0.666666666667
供给	0	2	1	3	0.666666666667
供应商	0	1	2	3	0.666666666667
例如	0	1	2	3	0.666666666667
佩服	2	1	0	3	0.666666666667
作对	1	2	0	3	0.666666666667
余地	1	2	0	3	0.666666666667
何不	0	2	1	3	0.666666666667
体检	2	1	0	3	0.666666666667
低廉	2	1	0	3	0.666666666667
低价	1	0	2	3	0.666666666667
但愿	1	2	0	3	0.666666666667
似	2	1	0	3	0.666666666667
伺候	1	2	0	3	0.666666666667
传感器	0	2	1	3	0.666666666667
传感	0	2	1	3	0.666666666667
份额	0	1	2	3	0.666666666667
任意	1	0	2	3	0.666666666667
价格比	0	2	1	3	0.666666666667
价值观	0	2	1	3	0.666666666667
以此	1	0	2	3	0.666666666667
以待	0	2	1	3	0.666666666667
以内	2	1	0	3	0.666666666667
仔	1	0	2	3	0.666666666667
从此	2	1	0	3	0.666666666667
从中	2	0	1	3	0.666666666667
今儿	1	2	0	3	0.666666666667
仅限	1	0	2	3	0.666666666667
人马	0	2	1	3	0.666666666667
人道	1	2	0	3	0.666666666667
人心	2	1	0	3	0.666666666667
亲身	1	2	0	3	0.666666666667
产量	1	2	0	3	0.666666666667
产科	2	1	0	3	0.666666666667
亦	2	0	1	3	0.666666666667
五分	2	1	0	3	0.666666666667
互联网	0	2	1	3	0.666666666667
云	1	0	2	3	0.666666666667
亏	0	1	2	3	0.666666666667
于未然	2	1	0	3	0.666666666667
予以	2	1	0	3	0.666666666667
习	1	0	2	3	0.666666666667
乐观	2	0	1	3	0.666666666667
乏味	2	1	0	3	0.666666666667
之所以	1	2	0	3	0.666666666667
举动	1	0	2	3	0.666666666667
举办	2	0	1	3	0.666666666667
主导	2	1	0	3	0.666666666667
主城区	1	2	0	3	0.666666666667
主城	1	2	0	3	0.666666666667
中期	1	0	2	3	0.666666666667
中兴	2	0	1	3	0.666666666667
中低端	0	1	2	3	0.666666666667
个性	1	2	0	3	0.666666666667
严谨	2	1	0	3	0.666666666667
两点	1	0	2	3	0.666666666667
两款	1	0	2	3	0.666666666667
两成	1	0	2	3	0.666666666667
两倍	2	1	0	3	0.666666666667
世纪	1	2	0	3	0.666666666667
世界各地	2	1	0	3	0.666666666667
世	1	0	2	3	0.666666666667
丑	0	2	1	3	0.666666666667
不见得	1	2	0	3	0.666666666667
不留	2	1	0	3	0.666666666667
不爽	2	0	1	3	0.666666666667
不止一次	2	1	0	3	0.666666666667
不成	2	1	0	3	0.666666666667
不容忽视	0	2	1	3	0.666666666667
不在	0	2	1	3	0.666666666667
不合	1	2	0	3	0.666666666667
不吃	2	0	1	3	0.666666666667
下雪	2	0	1	3	0.666666666667
下载	0	1	2	3	0.666666666667
下手	2	0	1	3	0.666666666667
下半年	0	1	2	3	0.666666666667
下半	0	1	2	3	0.666666666667
上周	0	1	2	3	0.666666666667
上升	2	1	0	3	0.666666666667
上元节	2	0	1	3	0.666666666667
上元	2	0	1	3	0.666666666667
三四	2	1	0	3	0.666666666667
三周	2	0	1	3	0.666666666667
三倍	1	2	0	3	0.666666666667
万家	2	1	0	3	0.666666666667
七十	0	1	2	3	0.666666666667
一颗	0	2	1	3	0.666666666667
一辙	0	2	1	3	0.666666666667
一辈	2	1	0	3	0.666666666667
一贯	2	0	1	3	0.666666666667
一股	2	1	0	3	0.666666666667
一纸	1	2	0	3	0.666666666667
一秒	2	1	0	3	0.666666666667
一百	0	2	1	3	0.666666666667
一架	2	1	0	3	0.666666666667
一本	1	0	2	3	0.666666666667
一帮人	1	2	0	3	0.666666666667
一大堆	1	2	0	3	0.666666666667
一夜	0	2	1	3	0.666666666667
一副	2	1	0	3	0.666666666667
一切都是	1	2	0	3	0.666666666667
一个样	2	1	0	3	0.666666666667
wifi	0	1	2	3	0.666666666667
tfboys	2	1	0	3	0.666666666667
so	2	1	0	3	0.666666666667
rqlqap2	1	0	2	3	0.666666666667
note3	1	2	0	3	0.666666666667
md	0	2	1	3	0.666666666667
daryanani	1	0	2	3	0.666666666667
amit	1	0	2	3	0.666666666667
恐怖分子	44	19	4	67	0.65671641791
活	6	17	3	26	0.653846153846
幸福	17	7	2	26	0.653846153846
放烟	7	32	10	49	0.65306122449
打击	26	10	4	40	0.65
小时	26	10	4	40	0.65
避免	3	4	13	20	0.65
营运	13	1	6	20	0.65
群体	5	13	2	20	0.65
续航	13	6	1	20	0.65
得到	5	13	2	20	0.65
允许	4	13	3	20	0.65
做法	6	13	1	20	0.65
人员	1	13	6	20	0.65
一刀	3	13	4	20	0.65
女性	9	24	4	37	0.648648648649
爆竹	15	68	22	105	0.647619047619
销量	4	2	11	17	0.647058823529
老家	11	3	3	17	0.647058823529
方便	11	5	1	17	0.647058823529
当年	5	11	1	17	0.647058823529
干嘛	5	11	1	17	0.647058823529
声音	3	11	3	17	0.647058823529
和平	11	2	4	17	0.647058823529
听说	4	11	2	17	0.647058823529
办	11	5	1	17	0.647058823529
霾	12	47	14	73	0.643835616438
哦	18	6	4	28	0.642857142857
赶紧	9	3	2	14	0.642857142857
详情	9	3	2	14	0.642857142857
节奏	9	5	0	14	0.642857142857
统一	2	9	3	14	0.642857142857
知	9	2	3	14	0.642857142857
现代	9	1	4	14	0.642857142857
某些	4	9	1	14	0.642857142857
忙	9	4	1	14	0.642857142857
心里	4	9	1	14	0.642857142857
压岁钱	9	0	5	14	0.642857142857
压岁	9	0	5	14	0.642857142857
加强	5	9	0	14	0.642857142857
剥夺	3	9	2	14	0.642857142857
再生	9	3	2	14	0.642857142857
送	15	34	4	53	0.641509433962
一起	41	11	12	64	0.640625
意思	16	7	2	25	0.64
小伙	16	3	6	25	0.64
反	7	16	2	25	0.64
增加	5	23	8	36	0.638888888889
今年	30	99	26	155	0.638709677419
解决	14	30	3	47	0.63829787234
经济	7	30	10	47	0.63829787234
分子	49	22	6	77	0.636363636364
开心	21	7	5	33	0.636363636364
服务	3	14	5	22	0.636363636364
需	2	2	7	11	0.636363636364
造	7	4	0	11	0.636363636364
违规	7	3	1	11	0.636363636364
该不该	1	3	7	11	0.636363636364
表	0	7	4	11	0.636363636364
行政	7	4	0	11	0.636363636364
监管	2	7	2	11	0.636363636364
模式	2	7	2	11	0.636363636364
样子	7	3	1	11	0.636363636364
李	7	2	2	11	0.636363636364
春	7	2	2	11	0.636363636364
无奈	3	7	1	11	0.636363636364
提供	7	0	4	11	0.636363636364
指数	1	7	3	11	0.636363636364
所有人	7	3	1	11	0.636363636364
守岁	7	2	2	11	0.636363636364
婴儿	7	1	3	11	0.636363636364
大力	3	7	1	11	0.636363636364
哈尔滨	1	7	3	11	0.636363636364
哈尔	1	7	3	11	0.636363636364
发言	7	3	1	11	0.636363636364
制度	3	7	1	11	0.636363636364
从来	3	7	1	11	0.636363636364
touch	2	7	2	11	0.636363636364
她	26	5	10	41	0.634146341463
玫瑰	12	5	2	19	0.631578947368
牌	5	12	2	19	0.631578947368
梦想	12	4	3	19	0.631578947368
成本	2	12	5	19	0.631578947368
倒	12	6	1	19	0.631578947368
谁	18	44	8	70	0.628571428571
车	8	30	10	48	0.625
民族	25	10	5	40	0.625
近	5	10	1	16	0.625
老龄化	5	10	1	16	0.625
老龄	5	10	1	16	0.625
实施	10	4	2	16	0.625
中心	10	4	2	16	0.625
高中	2	5	1	8	0.625
领空	5	2	1	8	0.625
预订	2	1	5	8	0.625
韩	5	1	2	8	0.625
非机动车	5	3	0	8	0.625
说话	5	2	1	8	0.625
良心	5	2	1	8	0.625
老二	5	2	1	8	0.625
粉	1	2	5	8	0.625
称为	1	2	5	8	0.625
疼	5	2	1	8	0.625
猪	5	3	0	8	0.625
特种	3	5	0	8	0.625
灯笼	5	1	2	8	0.625
淘汰	5	2	1	8	0.625
法治	1	5	2	8	0.625
比例	5	1	2	8	0.625
月初	5	2	1	8	0.625
更为	0	5	3	8	0.625
新疆	5	2	1	8	0.625
数量	5	1	2	8	0.625
挤	5	3	0	8	0.625
报复	5	3	0	8	0.625
折腾	5	2	1	8	0.625
想法	5	1	2	8	0.625
悲哀	2	5	1	8	0.625
悲剧	2	5	1	8	0.625
怒	5	1	2	8	0.625
形势	1	5	2	8	0.625
弱	5	1	2	8	0.625
干什么	1	5	2	8	0.625
工业	5	2	1	8	0.625
小宝	5	2	1	8	0.625
尊重	3	5	0	8	0.625
害怕	5	2	1	8	0.625
客户	1	5	2	8	0.625
好意思	5	2	1	8	0.625
好意	5	2	1	8	0.625
多月	5	1	2	8	0.625
外国	3	5	0	8	0.625
增长	1	5	2	8	0.625
在于	0	5	3	8	0.625
国家标准	0	3	5	8	0.625
名义	2	5	1	8	0.625
各地	2	5	1	8	0.625
叔叔	5	3	0	8	0.625
出发	2	5	1	8	0.625
借口	2	5	1	8	0.625
人民日报	2	5	1	8	0.625
久	5	3	0	8	0.625
不禁	5	3	0	8	0.625
下一代	3	5	0	8	0.625
一部分	5	2	1	8	0.625
一段	5	2	1	8	0.625
一方面	2	5	1	8	0.625
一位	1	5	2	8	0.625
挺	28	10	7	45	0.622222222222
恐怖	74	34	11	119	0.621848739496
骑	8	23	6	37	0.621621621622
地铁	23	6	8	37	0.621621621622
简单	4	18	7	29	0.620689655172
哈哈	18	9	2	29	0.620689655172
汽车	16	39	8	63	0.619047619048
过节	5	13	3	21	0.619047619048
根据	4	4	13	21	0.619047619048
数据	4	4	13	21	0.619047619048
意识	6	13	2	21	0.619047619048
尺寸	13	3	5	21	0.619047619048
实在	13	7	1	21	0.619047619048
味儿	13	6	2	21	0.619047619048
节日	45	13	15	73	0.616438356164
雾	12	40	13	65	0.615384615385
不错	24	6	9	39	0.615384615385
毛子	8	16	2	26	0.615384615385
明显	5	16	5	26	0.615384615385
谢谢	8	2	3	13	0.615384615385
警察	5	8	0	13	0.615384615385
脑子	3	8	2	13	0.615384615385
石油	8	4	1	13	0.615384615385
白	8	3	2	13	0.615384615385
消费者	2	3	8	13	0.615384615385
水	2	8	3	13	0.615384615385
按	2	8	3	13	0.615384615385
抱	8	2	3	13	0.615384615385
博弈	3	8	2	13	0.615384615385
做到	3	8	2	13	0.615384615385
俄军	8	3	2	13	0.615384615385
你家	8	3	2	13	0.615384615385
严查	8	1	4	13	0.615384615385
不容	2	8	3	13	0.615384615385
英寸	5	7	19	31	0.612903225806
计划	11	30	8	49	0.612244897959
人口	12	30	7	49	0.612244897959
觉得	66	28	14	108	0.611111111111
回家	33	11	10	54	0.611111111111
相关	4	11	3	18	0.611111111111
学	4	11	3	18	0.611111111111
奖励	4	11	3	18	0.611111111111
力	5	11	2	18	0.611111111111
值得	11	4	3	18	0.611111111111
上班	4	11	3	18	0.611111111111
道路	3	14	6	23	0.608695652174
老人	8	14	1	23	0.608695652174
新春	4	14	5	23	0.608695652174
吃	43	17	11	71	0.605633802817
根本	13	26	4	43	0.604651162791
空气	26	63	16	105	0.6
呼吁	13	27	5	45	0.6
到底	6	21	8	35	0.6
垃圾	8	15	2	25	0.6
假	9	15	1	25	0.6
记得	12	6	2	20	0.6
爸爸	12	2	6	20	0.6
燃放鞭炮	6	12	2	20	0.6
更是	7	12	1	20	0.6
处理	4	12	4	20	0.6
责任	6	9	0	15	0.6
老公	9	3	3	15	0.6
普	6	9	0	15	0.6
拉客	9	4	2	15	0.6
俄国	4	9	2	15	0.6
须	1	3	6	10	0.6
难以	3	6	1	10	0.6
降低	2	6	2	10	0.6
逻辑	3	6	1	10	0.6
赶	6	3	1	10	0.6
调整	2	6	2	10	0.6
节	6	4	0	10	0.6
精神	3	6	1	10	0.6
独立	4	6	0	10	0.6
没想到	2	6	2	10	0.6
没想	2	6	2	10	0.6
平时	6	3	1	10	0.6
居民	4	6	0	10	0.6
娱乐	6	2	2	10	0.6
好友	6	3	1	10	0.6
哈	6	3	1	10	0.6
发达	6	3	1	10	0.6
加入	6	3	1	10	0.6
利	3	6	1	10	0.6
军队	6	2	2	10	0.6
再说	4	6	0	10	0.6
内容	6	1	3	10	0.6
公里	3	6	1	10	0.6
付出	3	6	1	10	0.6
今	2	6	2	10	0.6
不再	6	2	2	10	0.6
一周	6	1	3	10	0.6
鲜花	3	1	1	5	0.6
高调	1	3	1	5	0.6
首发	1	1	3	5	0.6
饭	1	3	1	5	0.6
食品	2	3	0	5	0.6
额	0	3	2	5	0.6
颜色	1	1	3	5	0.6
领导人	2	3	0	5	0.6
音乐	3	0	2	5	0.6
青岛	1	3	1	5	0.6
零部件	0	3	2	5	0.6
间	3	2	0	5	0.6
遭殃	2	3	0	5	0.6
遇到	3	0	2	5	0.6
逐渐	3	0	2	5	0.6
送到	2	3	0	5	0.6
这年头	1	3	1	5	0.6
达成	1	3	1	5	0.6
达姆	2	3	0	5	0.6
轻松	3	1	1	5	0.6
轻易	3	2	0	5	0.6
轰炸机	3	2	0	5	0.6
路边	3	1	1	5	0.6
超生	2	3	0	5	0.6
走路	2	3	0	5	0.6
调	3	1	1	5	0.6
诸多	2	3	0	5	0.6
该禁	3	2	0	5	0.6
诚意	2	3	0	5	0.6
论坛	3	1	1	5	0.6
论	0	3	2	5	0.6
认识	3	2	0	5	0.6
认	2	3	0	5	0.6
警方	0	3	2	5	0.6
见到	3	0	2	5	0.6
要死	3	1	1	5	0.6
补充	3	2	0	5	0.6
蛮	3	1	1	5	0.6
萨达姆	2	3	0	5	0.6
花样	1	3	1	5	0.6
芯片	2	3	0	5	0.6
舞龙	3	1	1	5	0.6
自动	0	3	2	5	0.6
联	3	1	1	5	0.6
聊天	3	1	1	5	0.6
耍流氓	1	3	1	5	0.6
老婆	1	3	1	5	0.6
经验	1	1	3	5	0.6
第二天	1	3	1	5	0.6
窗外	3	2	0	5	0.6
穆斯	3	2	0	5	0.6
私家车	3	2	0	5	0.6
私家	3	2	0	5	0.6
礼物	3	1	1	5	0.6
眼睛	3	1	1	5	0.6
眼看	1	3	1	5	0.6
眼	1	3	1	5	0.6
相当于	1	1	3	5	0.6
相	0	3	2	5	0.6
癌	1	3	1	5	0.6
疑问	2	3	0	5	0.6
电源	1	3	1	5	0.6
用来	1	3	1	5	0.6
用惯	3	2	0	5	0.6
环保部	1	3	1	5	0.6
特点	3	1	1	5	0.6
爷爷	3	1	1	5	0.6
父亲	3	1	1	5	0.6
爆竹声	1	3	1	5	0.6
烧香	3	1	1	5	0.6
点燃	2	3	0	5	0.6
灾难	1	3	1	5	0.6
激动	2	3	0	5	0.6
演戏	3	1	1	5	0.6
满	3	2	0	5	0.6
溪	3	1	1	5	0.6
混	3	0	2	5	0.6
涉	2	0	3	5	0.6
测试	1	1	3	5	0.6
派出所	3	1	1	5	0.6
油	3	1	1	5	0.6
每月	3	1	1	5	0.6
正月初一	3	1	1	5	0.6
欧	3	2	0	5	0.6
棒	2	3	0	5	0.6
标	2	3	0	5	0.6
果然	3	2	0	5	0.6
松动	3	1	1	5	0.6
暴政	3	2	0	5	0.6
暗	2	3	0	5	0.6
晒	3	1	1	5	0.6
春风	3	1	1	5	0.6
明年	3	2	0	5	0.6
早日	3	1	1	5	0.6
无辜	2	3	0	5	0.6
无意	3	1	1	5	0.6
新政	1	1	3	5	0.6
斯拉	3	2	0	5	0.6
改革开放	1	3	1	5	0.6
收缴	0	3	2	5	0.6
摊	3	1	1	5	0.6
搭	1	3	1	5	0.6
推翻	3	2	0	5	0.6
排	3	1	1	5	0.6
挑战	3	2	0	5	0.6
拼命	1	3	1	5	0.6
投资	1	1	3	5	0.6
扩散	1	3	1	5	0.6
打扫卫生	2	3	0	5	0.6
戴	3	1	1	5	0.6
戳	3	0	2	5	0.6
成绩	3	0	2	5	0.6
愿	2	0	3	5	0.6
意	1	3	1	5	0.6
情怀	2	3	0	5	0.6
恶化	2	3	0	5	0.6
性质	3	0	2	5	0.6
忽悠	2	3	0	5	0.6
志	0	2	3	5	0.6
德	2	3	0	5	0.6
微笑	3	2	0	5	0.6
很少	3	2	0	5	0.6
很多年	2	3	0	5	0.6
当前	1	3	1	5	0.6
当于	1	1	3	5	0.6
强硬	0	2	3	5	0.6
开开	3	2	0	5	0.6
开启	3	2	0	5	0.6
年饭	3	2	0	5	0.6
年来	0	2	3	5	0.6
年头	1	3	1	5	0.6
市政府	2	3	0	5	0.6
市政	2	3	0	5	0.6
屌	3	1	1	5	0.6
屁股	2	3	0	5	0.6
尽情	3	2	0	5	0.6
尽快	3	0	2	5	0.6
就行了	1	3	1	5	0.6
小年夜	3	1	1	5	0.6
小学生	1	3	1	5	0.6
对付	1	3	1	5	0.6
室友	3	0	2	5	0.6
实际上	3	2	0	5	0.6
定义	3	1	1	5	0.6
孤独	3	2	0	5	0.6
妨碍	2	3	0	5	0.6
好听	2	3	0	5	0.6
套	2	3	0	5	0.6
奇	1	1	3	5	0.6
失	1	3	1	5	0.6
大妈	1	3	1	5	0.6
大众	0	3	2	5	0.6
多彩	3	1	1	5	0.6
增	0	3	2	5	0.6
回忆	2	3	0	5	0.6
回到	3	1	1	5	0.6
噪声	0	3	2	5	0.6
喜气	3	2	0	5	0.6
哪怕	2	3	0	5	0.6
咱们	3	2	0	5	0.6
和谈	3	2	0	5	0.6
后悔	3	2	0	5	0.6
同胞	0	3	2	5	0.6
合格	0	3	2	5	0.6
合	3	2	0	5	0.6
可见	3	2	0	5	0.6
厉害	3	2	0	5	0.6
卷	2	3	0	5	0.6
南山	3	0	2	5	0.6
南	3	1	1	5	0.6
单独	3	2	0	5	0.6
协调	2	3	0	5	0.6
升高	2	3	0	5	0.6
十字军	3	2	0	5	0.6
医疗	1	3	1	5	0.6
动静	0	3	2	5	0.6
加重	0	3	2	5	0.6
初	3	0	2	5	0.6
出动	3	0	2	5	0.6
冷	3	2	0	5	0.6
兴	1	3	1	5	0.6
公交车	3	2	0	5	0.6
全年	3	1	1	5	0.6
催生	0	3	2	5	0.6
停车	1	3	1	5	0.6
做生意	3	2	0	5	0.6
信仰	3	2	0	5	0.6
便于	2	3	0	5	0.6
供应链	0	3	2	5	0.6
佳	3	0	2	5	0.6
位置	1	3	1	5	0.6
会儿	1	3	1	5	0.6
份	1	3	1	5	0.6
他妈的	2	3	0	5	0.6
介入	1	3	1	5	0.6
今天上午	3	2	0	5	0.6
亿	2	3	0	5	0.6
人民币	2	0	3	5	0.6
京东	3	1	1	5	0.6
京	2	0	3	5	0.6
产妇	3	1	1	5	0.6
二轮	3	1	1	5	0.6
二房	0	2	3	5	0.6
二天	1	3	1	5	0.6
二十年	3	2	0	5	0.6
事实上	1	3	1	5	0.6
事业	2	3	0	5	0.6
乎	1	1	3	5	0.6
之际	3	2	0	5	0.6
之中	1	1	3	5	0.6
举行	3	1	1	5	0.6
丰富多彩	3	1	1	5	0.6
中低	0	3	2	5	0.6
两家	1	3	1	5	0.6
东部	0	3	2	5	0.6
专门	1	3	1	5	0.6
上个	0	2	3	5	0.6
上下班	2	3	0	5	0.6
三百余	3	0	2	5	0.6
一路	2	3	0	5	0.6
一模一样	0	3	2	5	0.6
一对	1	1	3	5	0.6
一会儿	1	3	1	5	0.6
一个月	3	1	1	5	0.6
一两	3	1	1	5	0.6
oppo	3	1	1	5	0.6
交警	64	27	16	107	0.598130841121
然后	10	28	9	47	0.595744680851
环境	22	53	14	89	0.595505617978
自行	19	47	13	79	0.594936708861
越	44	18	12	74	0.594594594595
子女	9	19	4	32	0.59375
is	29	16	4	49	0.591836734694
包	13	6	3	22	0.590909090909
传统	138	53	43	234	0.589743589744
行车	19	46	13	78	0.589743589744
自行车	19	46	13	78	0.589743589744
限	7	23	9	39	0.589743589744
难	8	20	6	34	0.588235294118
每天	20	7	7	34	0.588235294118
除夕夜	10	4	3	17	0.588235294118
过大年	7	10	0	17	0.588235294118
罚款	6	10	1	17	0.588235294118
电影	10	1	6	17	0.588235294118
法	2	10	5	17	0.588235294118
毛	4	10	3	17	0.588235294118
感谢	10	3	4	17	0.588235294118
巴沙尔	7	10	0	17	0.588235294118
巴沙	7	10	0	17	0.588235294118
尽	4	10	3	17	0.588235294118
女人	5	10	2	17	0.588235294118
以上	5	10	2	17	0.588235294118
为何	6	10	1	17	0.588235294118
两年	10	5	2	17	0.588235294118
燃放	17	54	21	92	0.586956521739
只能	14	27	5	46	0.586956521739
市民	6	34	18	58	0.586206896552
随着	8	4	17	29	0.586206896552
教育	7	17	5	29	0.586206896552
执法	8	17	4	29	0.586206896552
工作	14	35	11	60	0.583333333333
妈妈	28	7	13	48	0.583333333333
靠	7	14	3	24	0.583333333333
独生子女	8	14	2	24	0.583333333333
独生子	8	14	2	24	0.583333333333
嘛	8	14	2	24	0.583333333333
些	14	7	3	24	0.583333333333
那样	3	7	2	12	0.583333333333
说明	3	7	2	12	0.583333333333
说好	5	7	0	12	0.583333333333
纷纷	7	3	2	12	0.583333333333
看法	3	2	7	12	0.583333333333
的确	3	7	2	12	0.583333333333
深圳市	3	7	2	12	0.583333333333
派	7	4	1	12	0.583333333333
梦	7	3	2	12	0.583333333333
建设	3	7	2	12	0.583333333333
度	7	4	1	12	0.583333333333
字	7	5	0	12	0.583333333333
奥	7	3	2	12	0.583333333333
大街	7	4	1	12	0.583333333333
哭	7	3	2	12	0.583333333333
名字	7	4	1	12	0.583333333333
出门	4	7	1	12	0.583333333333
光	4	7	1	12	0.583333333333
临近	4	7	1	12	0.583333333333
严厉	3	2	7	12	0.583333333333
不足	2	7	3	12	0.583333333333
不见	5	7	0	12	0.583333333333
还要	11	25	7	43	0.581395348837
准备	25	15	3	43	0.581395348837
啦	29	15	6	50	0.58
事故	12	22	4	38	0.578947368421
转	5	11	3	19	0.578947368421
身体	11	7	1	19	0.578947368421
贵	4	11	4	19	0.578947368421
爸妈	11	5	3	19	0.578947368421
火	11	4	4	19	0.578947368421
提前	2	6	11	19	0.578947368421
上海	4	11	4	19	0.578947368421
独生	9	15	2	26	0.576923076923
快乐	15	11	0	26	0.576923076923
限制	6	19	8	33	0.575757575758
空气污染	8	19	6	33	0.575757575758
支持	84	42	20	146	0.575342465753
烟花	30	70	22	122	0.573770491803
期间	14	35	12	61	0.573770491803
少	50	102	26	178	0.573033707865
管理	16	32	8	56	0.571428571429
交	7	12	2	21	0.571428571429
马路	8	5	1	14	0.571428571429
长春	3	3	8	14	0.571428571429
还好	8	4	2	14	0.571428571429
辛苦	5	8	1	14	0.571428571429
跟着	8	3	3	14	0.571428571429
红包	8	2	4	14	0.571428571429
正义	4	8	2	14	0.571428571429
极端	8	4	2	14	0.571428571429
更好	5	8	1	14	0.571428571429
昨晚	8	3	3	14	0.571428571429
我家	8	4	2	14	0.571428571429
引导	5	8	1	14	0.571428571429
广	3	8	3	14	0.571428571429
并非	5	1	8	14	0.571428571429
力度	6	8	0	14	0.571428571429
军事	8	5	1	14	0.571428571429
人生	8	3	3	14	0.571428571429
不断	2	8	4	14	0.571428571429
上午	8	4	2	14	0.571428571429
风	1	2	4	7	0.571428571429
频发	3	4	0	7	0.571428571429
集团	4	1	2	7	0.571428571429
随之	2	1	4	7	0.571428571429
阿拉伯	4	2	1	7	0.571428571429
阿拉	4	2	1	7	0.571428571429
阵线	2	4	1	7	0.571428571429
键	2	4	1	7	0.571428571429
里面	3	4	0	7	0.571428571429
释放	2	4	1	7	0.571428571429
部件	0	4	3	7	0.571428571429
违章	3	4	0	7	0.571428571429
迎新	4	3	0	7	0.571428571429
辖区	4	0	3	7	0.571428571429
身份	1	2	4	7	0.571428571429
读	1	2	4	7	0.571428571429
街头	1	4	2	7	0.571428571429
行车道	1	4	2	7	0.571428571429
自行车道	1	4	2	7	0.571428571429
自我	2	4	1	7	0.571428571429
胎	1	4	2	7	0.571428571429
肾	1	4	2	7	0.571428571429
老板	4	3	0	7	0.571428571429
老实	1	4	2	7	0.571428571429
老娘	2	4	1	7	0.571428571429
缺乏	1	4	2	7	0.571428571429
绿	4	2	1	7	0.571428571429
绝	4	3	0	7	0.571428571429
经常	4	2	1	7	0.571428571429
窗花	4	2	1	7	0.571428571429
稍微	3	4	0	7	0.571428571429
禁行	3	4	0	7	0.571428571429
祭祖	4	2	1	7	0.571428571429
神	4	2	1	7	0.571428571429
看起来	4	2	1	7	0.571428571429
看起	4	2	1	7	0.571428571429
百	2	4	1	7	0.571428571429
男女	2	4	1	7	0.571428571429
理性	4	0	3	7	0.571428571429
片	3	4	0	7	0.571428571429
烦	0	4	3	7	0.571428571429
混乱	4	3	0	7	0.571428571429
消失	1	4	2	7	0.571428571429
浓浓的	4	2	1	7	0.571428571429
波	2	1	4	7	0.571428571429
民间	4	2	1	7	0.571428571429
死亡	1	4	2	7	0.571428571429
正月初	4	2	1	7	0.571428571429
样	3	4	0	7	0.571428571429
权	2	4	1	7	0.571428571429
机构	2	1	4	7	0.571428571429
本人	1	4	2	7	0.571428571429
期盼	3	4	0	7	0.571428571429
有效	1	4	2	7	0.571428571429
最低	2	4	1	7	0.571428571429
曝光	2	1	4	7	0.571428571429
智	4	1	2	7	0.571428571429
显然	3	4	0	7	0.571428571429
昨日	2	1	4	7	0.571428571429
时期	1	4	2	7	0.571428571429
新年快乐	3	4	0	7	0.571428571429
提问	0	4	3	7	0.571428571429
据说	4	1	2	7	0.571428571429
拉伯	4	2	1	7	0.571428571429
扣	2	4	1	7	0.571428571429
扔	2	4	1	7	0.571428571429
形式	4	3	0	7	0.571428571429
强制	0	3	4	7	0.571428571429
引	2	1	4	7	0.571428571429
开发	1	2	4	7	0.571428571429
廉价	1	4	2	7	0.571428571429
广泛	1	4	2	7	0.571428571429
市区	1	2	4	7	0.571428571429
小朋友	3	4	0	7	0.571428571429
家伙	1	4	2	7	0.571428571429
客户端	1	4	2	7	0.571428571429
失去	3	4	0	7	0.571428571429
大事	4	2	1	7	0.571428571429
复杂	4	2	1	7	0.571428571429
基础	2	4	1	7	0.571428571429
基地	3	4	0	7	0.571428571429
培养	4	3	0	7	0.571428571429
均	2	1	4	7	0.571428571429
场景	4	1	2	7	0.571428571429
同期	2	1	4	7	0.571428571429
友	1	4	2	7	0.571428571429
十字	4	2	1	7	0.571428571429
十三	4	3	0	7	0.571428571429
前提	1	4	2	7	0.571428571429
初五	2	4	1	7	0.571428571429
凡是	4	2	1	7	0.571428571429
其次	3	4	0	7	0.571428571429
公开	2	4	1	7	0.571428571429
依旧	4	3	0	7	0.571428571429
何	2	4	1	7	0.571428571429
伟大	4	2	1	7	0.571428571429
人群	3	4	0	7	0.571428571429
人士	1	4	2	7	0.571428571429
亲情	4	3	0	7	0.571428571429
产	4	2	1	7	0.571428571429
交管	1	4	2	7	0.571428571429
买买	4	2	1	7	0.571428571429
中午	4	0	3	7	0.571428571429
不堪	2	4	1	7	0.571428571429
下台	4	2	1	7	0.571428571429
一组	0	4	3	7	0.571428571429
tm	2	4	1	7	0.571428571429
doge	3	4	0	7	0.571428571429
或者	8	25	11	44	0.568181818182
差	13	21	3	37	0.567567567568
设计	11	17	2	30	0.566666666667
发展	12	26	8	46	0.565217391304
陪	13	4	6	23	0.565217391304
这次	13	7	3	23	0.565217391304
拉	13	2	8	23	0.565217391304
路上	18	7	7	32	0.5625
苦	2	9	5	16	0.5625
绝对	6	9	1	16	0.5625
禁放	4	9	3	16	0.5625
牺牲	7	9	0	16	0.5625
牛	9	5	2	16	0.5625
民生	3	9	4	16	0.5625
次	9	3	4	16	0.5625
既	3	9	4	16	0.5625
手段	4	9	3	16	0.5625
图片	5	2	9	16	0.5625
公安	6	9	1	16	0.5625
任	3	4	9	16	0.5625
一份	4	9	3	16	0.5625
逼	18	32	7	57	0.561403508772
组织	32	18	7	57	0.561403508772
只	30	60	17	107	0.560747663551
人民	20	42	13	75	0.56
马	7	14	4	25	0.56
呵呵	10	14	1	25	0.56
不行	6	14	5	25	0.56
特别	19	10	5	34	0.558823529412
心	19	12	3	34	0.558823529412
大年	12	19	3	34	0.558823529412
热闹	24	14	5	43	0.558139534884
为了	36	63	14	113	0.557522123894
已	30	11	13	54	0.555555555556
领导	10	15	2	27	0.555555555556
注意	15	9	3	27	0.555555555556
正月	10	5	3	18	0.555555555556
放开	10	6	2	18	0.555555555556
就算	10	3	5	18	0.555555555556
学校	4	10	4	18	0.555555555556
大小	10	2	6	18	0.555555555556
坚持	10	7	1	18	0.555555555556
同学	10	1	7	18	0.555555555556
合理	10	3	5	18	0.555555555556
反而	10	5	3	18	0.555555555556
农历	10	3	5	18	0.555555555556
再次	3	10	5	18	0.555555555556
陈	5	2	2	9	0.555555555556
阿萨德	5	3	1	9	0.555555555556
阿萨	5	3	1	9	0.555555555556
迎	5	2	2	9	0.555555555556
边境	5	3	1	9	0.555555555556
课	5	0	4	9	0.555555555556
说出	2	5	2	9	0.555555555556
袭击	5	3	1	9	0.555555555556
街道	3	5	1	9	0.555555555556
肚子	5	0	4	9	0.555555555556
种	3	5	1	9	0.555555555556
离	1	5	3	9	0.555555555556
祖国	2	5	2	9	0.555555555556
留	5	4	0	9	0.555555555556
生意	5	3	1	9	0.555555555556
生态	3	5	1	9	0.555555555556
注意安全	5	3	1	9	0.555555555556
河南	3	5	1	9	0.555555555556
武汉	2	5	2	9	0.555555555556
正确	2	5	2	9	0.555555555556
本身	3	5	1	9	0.555555555556
有时候	5	3	1	9	0.555555555556
智能	0	5	4	9	0.555555555556
明明	4	5	0	9	0.555555555556
指责	4	5	0	9	0.555555555556
报	5	1	3	9	0.555555555556
承认	5	3	1	9	0.555555555556
小哥	3	5	1	9	0.555555555556
孕妇	5	1	3	9	0.555555555556
妇女	2	5	2	9	0.555555555556
她们	5	2	2	9	0.555555555556
大帝	4	5	0	9	0.555555555556
大多数	5	3	1	9	0.555555555556
地位	1	5	3	9	0.555555555556
回事	3	5	1	9	0.555555555556
唉	5	4	0	9	0.555555555556
吵	5	4	0	9	0.555555555556
君	3	5	1	9	0.555555555556
另外	3	5	1	9	0.555555555556
半年	5	1	3	9	0.555555555556
十分	5	3	1	9	0.555555555556
十几	3	5	1	9	0.555555555556
区	2	5	2	9	0.555555555556
刺激	3	5	1	9	0.555555555556
利比亚	5	3	1	9	0.555555555556
利比	5	3	1	9	0.555555555556
出口	5	1	3	9	0.555555555556
决策	2	5	2	9	0.555555555556
关心	5	3	1	9	0.555555555556
兄弟姐妹	5	4	0	9	0.555555555556
保留	5	1	3	9	0.555555555556
保护环境	2	5	2	9	0.555555555556
保护环	2	5	2	9	0.555555555556
任性	3	5	1	9	0.555555555556
之间	2	2	5	9	0.555555555556
业	4	0	5	9	0.555555555556
不及	5	3	1	9	0.555555555556
不出	2	5	2	9	0.555555555556
一群	4	5	0	9	0.555555555556
iphone5	4	5	0	9	0.555555555556
非法	21	7	10	38	0.552631578947
越来越	32	14	12	58	0.551724137931
越来	32	14	12	58	0.551724137931
联合	9	16	4	29	0.551724137931
每年	16	9	4	29	0.551724137931
不管	16	10	3	29	0.551724137931
土	27	16	6	49	0.551020408163
禁	123	271	98	492	0.55081300813
省	11	6	3	20	0.55
条件	5	11	4	20	0.55
抢	11	6	3	20	0.55
号	7	11	2	20	0.55
危险	8	11	1	20	0.55
出去	7	11	2	20	0.55
儿	11	4	5	20	0.55
污染	39	67	16	122	0.549180327869
生子	11	17	3	31	0.548387096774
引发	1	13	17	31	0.548387096774
生育	14	40	19	73	0.547945205479
提倡	7	12	3	22	0.545454545455
多年	7	12	3	22	0.545454545455
出行	6	12	4	22	0.545454545455
以为	6	12	4	22	0.545454545455
高峰	4	1	6	11	0.545454545455
飞行员	4	6	1	11	0.545454545455
预计	4	1	6	11	0.545454545455
长期	6	2	3	11	0.545454545455
运动	2	6	3	11	0.545454545455
财神	6	3	2	11	0.545454545455
行员	4	6	1	11	0.545454545455
自然	4	6	1	11	0.545454545455
脸	6	3	2	11	0.545454545455
粉丝	3	2	6	11	0.545454545455
笑	6	3	2	11	0.545454545455
空	5	6	0	11	0.545454545455
破	6	4	1	11	0.545454545455
电瓶车	4	6	1	11	0.545454545455
独裁	3	6	2	11	0.545454545455
法规	4	6	1	11	0.545454545455
治	2	6	3	11	0.545454545455
没什么	6	3	2	11	0.545454545455
氛围	6	3	2	11	0.545454545455
正是	6	2	3	11	0.545454545455
机器	4	6	1	11	0.545454545455
有着	6	2	3	11	0.545454545455
明天	6	4	1	11	0.545454545455
日本	2	3	6	11	0.545454545455
挖	5	6	0	11	0.545454545455
年初一	3	6	2	11	0.545454545455
喷	6	3	2	11	0.545454545455
合法	2	6	3	11	0.545454545455
吃饭	4	6	1	11	0.545454545455
印度	0	5	6	11	0.545454545455
传	6	2	3	11	0.545454545455
上面	2	3	6	11	0.545454545455
上下	3	6	2	11	0.545454545455
三星	6	3	2	11	0.545454545455
起	23	37	8	68	0.544117647059
生活	28	50	14	92	0.54347826087
活动	19	13	3	35	0.542857142857
pm2	11	19	5	35	0.542857142857
晚上	13	6	5	24	0.541666666667
孩	7	13	4	24	0.541666666667
利益	16	27	7	50	0.54
出现	13	27	10	50	0.54
或	11	35	19	65	0.538461538462
结婚	12	21	6	39	0.538461538462
标准	5	14	7	26	0.538461538462
战争	8	14	4	26	0.538461538462
工人	5	14	7	26	0.538461538462
史	6	6	14	26	0.538461538462
主义	14	10	2	26	0.538461538462
项目	4	7	2	13	0.538461538462
闹	7	5	1	13	0.538461538462
谈	2	7	4	13	0.538461538462
议	1	5	7	13	0.538461538462
背后	5	7	1	13	0.538461538462
者	4	7	2	13	0.538461538462
算是	7	5	1	13	0.538461538462
第三	7	2	4	13	0.538461538462
程度	5	7	1	13	0.538461538462
接受	5	7	1	13	0.538461538462
持续	5	7	1	13	0.538461538462
拼	3	3	7	13	0.538461538462
执行	7	5	1	13	0.538461538462
房	3	7	3	13	0.538461538462
想起	7	4	2	13	0.538461538462
尼玛	3	7	3	13	0.538461538462
坚决	7	6	0	13	0.538461538462
周末	7	1	5	13	0.538461538462
名	2	7	4	13	0.538461538462
其中	7	3	3	13	0.538461538462
全民	5	7	1	13	0.538461538462
入	7	5	1	13	0.538461538462
信息	7	2	4	13	0.538461538462
交通规则	7	6	0	13	0.538461538462
不然	5	7	1	13	0.538461538462
不能	45	72	17	134	0.537313432836
文明	13	22	6	41	0.536585365854
只是	18	30	8	56	0.535714285714
金	15	6	7	28	0.535714285714
部门	7	23	13	43	0.53488372093
限电	102	221	91	414	0.533816425121
家庭	13	24	8	45	0.533333333333
只有	11	24	10	45	0.533333333333
话题	6	8	16	30	0.533333333333
建议	4	16	10	30	0.533333333333
飞行	8	6	1	15	0.533333333333
量	0	8	7	15	0.533333333333
祝	8	4	3	15	0.533333333333
硬件	5	8	2	15	0.533333333333
真心	8	2	5	15	0.533333333333
版	5	2	8	15	0.533333333333
大部分	8	5	2	15	0.533333333333
外形	8	3	4	15	0.533333333333
听到	6	8	1	15	0.533333333333
利用	8	6	1	15	0.533333333333
假期	3	8	4	15	0.533333333333
二十	8	7	0	15	0.533333333333
一件	4	8	3	15	0.533333333333
如果	33	66	25	124	0.532258064516
本	11	17	4	32	0.53125
基本	11	17	4	32	0.53125
地区	7	17	8	32	0.53125
卓	17	7	8	32	0.53125
发表	26	12	11	49	0.530612244898
博文	26	15	8	49	0.530612244898
很	105	65	28	198	0.530303030303
那	50	71	13	134	0.529850746269
不好	17	27	7	51	0.529411764706
简直	18	13	3	34	0.529411764706
长大	7	9	1	17	0.529411764706
车辆	4	4	9	17	0.529411764706
美好	9	6	2	17	0.529411764706
目标	9	4	4	17	0.529411764706
现象	9	5	3	17	0.529411764706
政府军	9	7	1	17	0.529411764706
回归	6	9	2	17	0.529411764706
吸引	9	7	1	17	0.529411764706
十五	9	6	2	17	0.529411764706
专家	4	9	4	17	0.529411764706
所	9	19	8	36	0.527777777778
别	29	21	5	55	0.527272727273
规范	5	10	4	19	0.526315789474
花	9	10	0	19	0.526315789474
期待	10	5	4	19	0.526315789474
单位	1	8	10	19	0.526315789474
击落	10	5	4	19	0.526315789474
全球	10	5	4	19	0.526315789474
作	10	4	5	19	0.526315789474
可	34	51	12	97	0.525773195876
反对派	16	21	3	40	0.525
需要	28	43	11	82	0.524390243902
是不是	12	22	8	42	0.52380952381
原因	10	22	10	42	0.52380952381
讲	11	7	3	21	0.52380952381
每次	8	11	2	21	0.52380952381
未来	6	11	4	21	0.52380952381
将来	6	11	4	21	0.52380952381
两	3	7	11	21	0.52380952381
不让	11	8	2	21	0.52380952381
看着	12	7	4	23	0.521739130435
环卫工人	5	12	6	23	0.521739130435
日子	12	7	4	23	0.521739130435
几乎	4	12	7	23	0.521739130435
违法	13	8	4	25	0.52
至	9	13	3	25	0.52
政治	8	13	4	25	0.52
据	4	8	13	25	0.52
干	9	13	3	25	0.52
天气	6	13	6	25	0.52
其他	6	13	6	25	0.52
美国	69	34	30	133	0.518796992481
你们	49	69	15	133	0.518796992481
吗	79	139	50	268	0.518656716418
跑	14	9	4	27	0.518518518519
能力	5	14	8	27	0.518518518519
喜庆	14	6	7	27	0.518518518519
放	52	86	28	166	0.518072289157
重要	29	13	14	56	0.517857142857
狗	15	6	8	29	0.51724137931
恐怖组织	15	10	4	29	0.51724137931
性能	15	9	5	29	0.51724137931
估计	10	15	4	29	0.51724137931
任何	12	15	2	29	0.51724137931
么	23	32	7	62	0.516129032258
别人	10	16	5	31	0.516129032258
鞭炮声	12	17	4	33	0.515151515152
怕	17	13	3	33	0.515151515152
过年	69	48	17	134	0.514925373134
土耳其	52	29	20	101	0.514851485149
爱	36	18	16	70	0.514285714286
反对	26	36	8	70	0.514285714286
确实	18	12	5	35	0.514285714286
方面	19	11	7	37	0.513513513514
道	20	15	4	39	0.512820512821
晨	20	0	21	41	0.512195121951
时代	11	21	9	41	0.512195121951
isis	21	16	4	41	0.512195121951
不	318	503	162	983	0.511698880977
宝宝	22	9	12	43	0.511627906977
不想	15	22	6	43	0.511627906977
安	23	13	9	45	0.511111111111
而且	25	18	6	49	0.510204081633
两个	25	18	6	49	0.510204081633
开	15	29	13	57	0.508771929825
做	36	65	27	128	0.5078125
大家	45	69	22	136	0.507352941176
一点	27	36	8	71	0.507042253521
摩	132	255	116	503	0.506958250497
希望	37	23	13	73	0.506849315068
安全	22	37	14	73	0.506849315068
看到	39	32	6	77	0.506493506494
跟	44	18	25	87	0.505747126437
城市	27	48	20	95	0.505263157895
小	123	70	53	246	0.5
那么	31	52	21	104	0.5
当	21	40	19	80	0.5
摩托车	39	27	12	78	0.5
托车	39	27	12	78	0.5
普京	37	31	6	74	0.5
行	12	28	16	56	0.5
那些	26	18	8	52	0.5
禁止	15	25	10	50	0.5
可是	16	22	6	44	0.5
方式	10	21	11	42	0.5
姚	21	0	21	42	0.5
不了	13	21	8	42	0.5
好好	19	14	5	38	0.5
压力	14	19	5	38	0.5
机动	18	8	10	36	0.5
健康	14	18	4	36	0.5
以前	13	18	5	36	0.5
昨天	17	11	6	34	0.5
如此	12	17	5	34	0.5
站	16	10	6	32	0.5
民俗	16	9	7	32	0.5
就要	16	11	5	32	0.5
见	15	10	5	30	0.5
决定	10	15	5	30	0.5
中东	15	10	5	30	0.5
推出	6	8	14	28	0.5
容易	9	14	5	28	0.5
家人	14	13	1	28	0.5
医院	5	14	9	28	0.5
要是	9	13	4	26	0.5
机	5	8	13	26	0.5
几个	13	9	4	26	0.5
公交	11	13	2	26	0.5
伊斯兰	13	7	6	26	0.5
伊斯	13	7	6	26	0.5
结果	12	9	3	24	0.5
显示	7	5	12	24	0.5
想到	9	12	3	24	0.5
通	8	11	3	22	0.5
反正	11	7	4	22	0.5
过去	8	10	2	20	0.5
竟然	4	10	6	20	0.5
帮	10	5	5	20	0.5
市	2	10	8	20	0.5
差不多	9	10	1	20	0.5
采取	5	9	4	18	0.5
装	9	8	1	18	0.5
男	9	6	3	18	0.5
正式	7	2	9	18	0.5
新浪	7	9	2	18	0.5
提高	9	7	2	18	0.5
性价比	9	7	2	18	0.5
平民	8	9	1	18	0.5
堵	6	9	3	18	0.5
单车	9	7	2	18	0.5
动	9	8	1	18	0.5
加上	6	9	3	18	0.5
傻	8	9	1	18	0.5
下来	7	9	2	18	0.5
下去	6	9	3	18	0.5
下午	9	5	4	18	0.5
闯红灯	8	7	1	16	0.5
通事	5	8	3	16	0.5
至今	4	8	4	16	0.5
结束	3	5	8	16	0.5
污染环境	6	8	2	16	0.5
早上	8	6	2	16	0.5
既然	7	8	1	16	0.5
改革	5	8	3	16	0.5
工资	6	8	2	16	0.5
大部	8	6	2	16	0.5
大大	7	8	1	16	0.5
哪里	8	5	3	16	0.5
否则	6	8	2	16	0.5
则	2	8	6	16	0.5
像素	8	5	3	16	0.5
人类	7	8	1	16	0.5
交通事故	5	8	3	16	0.5
了解	8	3	5	16	0.5
习惯	3	5	8	16	0.5
之一	7	8	1	16	0.5
下降	4	8	4	16	0.5
三胎	5	8	3	16	0.5
麻烦	2	7	5	14	0.5
范围	7	3	4	14	0.5
相对	7	3	4	14	0.5
炮	7	4	3	14	0.5
消灭	6	7	1	14	0.5
正	5	2	7	14	0.5
放弃	7	4	3	14	0.5
控制	7	4	3	14	0.5
怎样	6	7	1	14	0.5
必要	7	4	3	14	0.5
强	7	6	1	14	0.5
庆祝	7	4	3	14	0.5
完成	7	7	0	14	0.5
好多	7	4	3	14	0.5
大多	7	5	2	14	0.5
坐	7	6	1	14	0.5
国外	7	3	4	14	0.5
原来	7	6	1	14	0.5
佳节	7	4	3	14	0.5
体会	7	6	1	14	0.5
今晚	2	5	7	14	0.5
事实	4	7	3	14	0.5
也许	4	7	3	14	0.5
且	6	7	1	14	0.5
高兴	6	5	1	12	0.5
部队	6	4	2	12	0.5
这点	6	6	0	12	0.5
购买	4	6	2	12	0.5
联盟	6	2	4	12	0.5
经典	6	4	2	12	0.5
算	6	5	1	12	0.5
相比	4	6	2	12	0.5
电瓶	4	6	2	12	0.5
然	6	3	3	12	0.5
有时	6	5	1	12	0.5
意味着	5	1	6	12	0.5
思想	3	6	3	12	0.5
当时	2	6	4	12	0.5
年代	6	5	1	12	0.5
它们	4	6	2	12	0.5
哪些	4	2	6	12	0.5
哥	6	3	3	12	0.5
吓	4	6	2	12	0.5
兄弟	6	4	2	12	0.5
做好	6	3	3	12	0.5
中央	2	6	4	12	0.5
不得不	6	5	1	12	0.5
一条	2	6	4	12	0.5
iphone6	6	4	2	12	0.5
a9	6	3	3	12	0.5
龙江	3	5	2	10	0.5
黑龙江	3	5	2	10	0.5
高端	3	5	2	10	0.5
面	5	2	3	10	0.5
除	1	5	4	10	0.5
错	5	4	1	10	0.5
配合	2	5	3	10	0.5
运行	4	5	1	10	0.5
身上	2	5	3	10	0.5
言	5	3	2	10	0.5
蛇	5	4	1	10	0.5
网络	3	5	2	10	0.5
网上	5	2	3	10	0.5
缺少	5	2	3	10	0.5
福利	3	5	2	10	0.5
睡觉	5	2	3	10	0.5
特色	5	4	1	10	0.5
母亲	5	4	1	10	0.5
正月十五	5	4	1	10	0.5
欢度	3	5	2	10	0.5
最高	2	3	5	10	0.5
日常	4	5	1	10	0.5
提	4	5	1	10	0.5
指纹	5	3	2	10	0.5
意外	5	3	2	10	0.5
平衡	1	4	5	10	0.5
帮忙	2	3	5	10	0.5
小米	4	1	5	10	0.5
宣传	5	4	1	10	0.5
大战	2	3	5	10	0.5
大年初一	3	5	2	10	0.5
哪个	2	3	5	10	0.5
各位	3	5	2	10	0.5
另	5	4	1	10	0.5
变得	5	2	3	10	0.5
卫生	3	5	2	10	0.5
南京	5	3	2	10	0.5
区别	2	5	3	10	0.5
势力	5	4	1	10	0.5
冲击	5	3	2	10	0.5
党	3	2	5	10	0.5
做出	5	5	0	10	0.5
保障	3	5	2	10	0.5
住	3	5	2	10	0.5
伊朗	1	5	4	10	0.5
以往	5	1	4	10	0.5
令	5	3	2	10	0.5
人口老龄化	4	5	1	10	0.5
二个	5	3	2	10	0.5
下班	3	5	2	10	0.5
三百	5	3	2	10	0.5
一名	2	5	3	10	0.5
龙华	4	1	3	8	0.5
鼻	4	4	0	8	0.5
骑车	2	4	2	8	0.5
领土	2	4	2	8	0.5
韩国	4	3	1	8	0.5
难怪	2	4	2	8	0.5
阿	2	4	2	8	0.5
阖家	4	3	1	8	0.5
锅	4	3	1	8	0.5
重视	3	4	1	8	0.5
进步	2	4	2	8	0.5
运	4	3	1	8	0.5
过程	3	1	4	8	0.5
资格	3	4	1	8	0.5
表演	4	3	1	8	0.5
获得	2	4	2	8	0.5
脑	3	4	1	8	0.5
能手	0	4	4	8	0.5
而言	3	4	1	8	0.5
维护	4	4	0	8	0.5
经过	4	3	1	8	0.5
系	1	4	3	8	0.5
第二个	4	2	2	8	0.5
第一个	3	1	4	8	0.5
秩序	4	3	1	8	0.5
社区	3	4	1	8	0.5
男孩	1	4	3	8	0.5
环境污染	3	4	1	8	0.5
犯罪	4	2	2	8	0.5
物质	2	4	2	8	0.5
爱国	2	4	2	8	0.5
烂	4	3	1	8	0.5
浓浓	4	3	1	8	0.5
欢度春节	2	4	2	8	0.5
枪	3	4	1	8	0.5
极	3	1	4	8	0.5
有所	2	2	4	8	0.5
有意	3	4	1	8	0.5
有利	4	3	1	8	0.5
智能手机	0	4	4	8	0.5
易	3	4	1	8	0.5
早就	4	3	1	8	0.5
整	4	4	0	8	0.5
推荐	4	3	1	8	0.5
损害	2	2	4	8	0.5
按照	2	2	4	8	0.5
招	3	4	1	8	0.5
拍摄	4	3	1	8	0.5
战斗	4	4	0	8	0.5
战	2	4	2	8	0.5
急	2	2	4	8	0.5
忽视	3	4	1	8	0.5
必	4	4	0	8	0.5
心疼	4	2	2	8	0.5
德国	2	4	2	8	0.5
形象	4	3	1	8	0.5
平	4	3	1	8	0.5
干脆	4	4	0	8	0.5
局	1	3	4	8	0.5
小孩子	4	3	1	8	0.5
实际行动	4	4	0	8	0.5
完美	4	3	1	8	0.5
完整	4	3	1	8	0.5
安静	1	4	3	8	0.5
多久	1	4	3	8	0.5
多个	3	4	1	8	0.5
外交	3	4	1	8	0.5
增添	1	4	3	8	0.5
塞	4	4	0	8	0.5
四个	1	4	3	8	0.5
周围	3	4	1	8	0.5
可怕	2	4	2	8	0.5
双	3	4	1	8	0.5
华为	2	2	4	8	0.5
出兵	2	4	2	8	0.5
几十	1	4	3	8	0.5
像是	1	3	4	8	0.5
侵犯	4	4	0	8	0.5
众	3	1	4	8	0.5
代人	2	4	2	8	0.5
五年	4	4	0	8	0.5
五	4	3	1	8	0.5
主意	4	3	1	8	0.5
不下	1	4	3	8	0.5
万辆	1	4	3	8	0.5
麻麻	3	2	1	6	0.5
高龄	2	1	3	6	0.5
题	1	2	3	6	0.5
零售	0	3	3	6	0.5
随便	1	3	2	6	0.5
防止	2	3	1	6	0.5
闯	3	1	2	6	0.5
错误	2	3	1	6	0.5
采访	3	1	2	6	0.5
酒店	1	3	2	6	0.5
郑州	0	3	3	6	0.5
那边	3	1	2	6	0.5
造型	3	1	2	6	0.5
连续	2	1	3	6	0.5
违法行为	3	1	2	6	0.5
迅速	1	3	2	6	0.5
车速	3	0	3	6	0.5
路口	3	1	2	6	0.5
越来越少	2	1	3	6	0.5
越少	2	1	3	6	0.5
资本	3	1	2	6	0.5
费用	3	3	0	6	0.5
识别	2	3	1	6	0.5
计生	3	3	0	6	0.5
表达	1	3	2	6	0.5
衣服	2	3	1	6	0.5
药	1	3	2	6	0.5
腾讯	1	3	2	6	0.5
罢了	3	3	0	6	0.5
等到	3	2	1	6	0.5
立马	2	3	1	6	0.5
立	3	3	0	6	0.5
突出	2	1	3	6	0.5
积极响应	3	1	2	6	0.5
砸	3	2	1	6	0.5
石	3	1	2	6	0.5
眼里	3	3	0	6	0.5
眼前	3	3	0	6	0.5
真实	3	1	2	6	0.5
看不到	3	2	1	6	0.5
直	1	3	2	6	0.5
百余	3	1	2	6	0.5
百万	2	3	1	6	0.5
痛	3	3	0	6	0.5
电视台	3	3	0	6	0.5
生小孩	2	3	1	6	0.5
独	1	3	2	6	0.5
状态	3	3	0	6	0.5
爱好	3	1	2	6	0.5
烧	3	3	0	6	0.5
烟火	3	1	2	6	0.5
清	1	3	2	6	0.5
派出	3	1	2	6	0.5
洋洋	2	3	1	6	0.5
法国	1	3	2	6	0.5
没用	2	3	1	6	0.5
气	3	2	1	6	0.5
每日	2	1	3	6	0.5
段	2	1	3	6	0.5
欺负	2	3	1	6	0.5
欧盟	3	1	2	6	0.5
概念	2	3	1	6	0.5
本质	1	3	2	6	0.5
朝	2	3	1	6	0.5
有感	3	3	0	6	0.5
替	3	2	1	6	0.5
晚会	3	2	1	6	0.5
星期	2	1	3	6	0.5
早点	1	3	2	6	0.5
无关	3	0	3	6	0.5
旁边	2	1	3	6	0.5
方向	3	2	1	6	0.5
敌人	1	3	2	6	0.5
改善	2	3	1	6	0.5
收到	2	3	1	6	0.5
指纹识别	2	3	1	6	0.5
折	3	2	1	6	0.5
扫	2	1	3	6	0.5
打扫	3	3	0	6	0.5
慢	1	2	3	6	0.5
感情	3	1	2	6	0.5
念	3	1	2	6	0.5
心愿	1	3	2	6	0.5
往往	2	3	1	6	0.5
当天	2	1	3	6	0.5
弥漫	1	2	3	6	0.5
年前	3	2	1	6	0.5
常识	3	2	1	6	0.5
帝	3	2	1	6	0.5
山东	3	3	0	6	0.5
客机	3	2	1	6	0.5
定位	2	3	1	6	0.5
学院	3	1	2	6	0.5
学习	3	2	1	6	0.5
子宫	2	3	1	6	0.5
媳妇	1	3	2	6	0.5
姑娘	3	2	1	6	0.5
女士	1	2	3	6	0.5
头上	1	3	2	6	0.5
夫妻	3	2	1	6	0.5
多次	3	3	0	6	0.5
多些	1	2	3	6	0.5
城市交通	1	3	2	6	0.5
场所	3	2	1	6	0.5
圣战	3	2	1	6	0.5
国产手机	1	3	2	6	0.5
固定	3	2	1	6	0.5
嘴	1	3	2	6	0.5
商业	3	1	2	6	0.5
品牌	0	3	3	6	0.5
呗	3	2	1	6	0.5
启动	3	0	3	6	0.5
后果	3	2	1	6	0.5
各国	0	3	3	6	0.5
古代	2	1	3	6	0.5
及时	1	2	3	6	0.5
原	3	1	2	6	0.5
即将来临	1	3	2	6	0.5
南头	3	2	1	6	0.5
华人	3	1	2	6	0.5
加剧	1	3	2	6	0.5
剩	3	2	1	6	0.5
具有	2	3	1	6	0.5
公众	2	1	3	6	0.5
公交站	3	2	1	6	0.5
俄新社	3	1	2	6	0.5
作品	3	2	1	6	0.5
体现	3	2	1	6	0.5
低端	1	2	3	6	0.5
优势	3	3	0	6	0.5
份子	2	1	3	6	0.5
从小	3	2	1	6	0.5
享受	2	1	3	6	0.5
交通管理	1	3	2	6	0.5
互相	1	3	2	6	0.5
主任	3	1	2	6	0.5
丰富	3	2	1	6	0.5
个个	2	3	1	6	0.5
两次	2	3	1	6	0.5
世界大战	1	2	3	6	0.5
不好意思	3	2	1	6	0.5
不停	0	3	3	6	0.5
不久	1	3	2	6	0.5
下次	1	2	3	6	0.5
三天	2	3	1	6	0.5
万部	2	1	3	6	0.5
万元	0	3	3	6	0.5
一生	3	1	2	6	0.5
一把	3	1	2	6	0.5
一度	3	3	0	6	0.5
一家人	3	3	0	6	0.5
一会	1	3	2	6	0.5
pay	3	1	2	6	0.5
iphone7	2	3	1	6	0.5
齐鸣	2	1	1	4	0.5
鸡肋	1	2	1	4	0.5
骗	2	1	1	4	0.5
驾照	1	2	1	4	0.5
驱逐	1	1	2	4	0.5
首	1	1	2	4	0.5
领	2	1	1	4	0.5
顿	1	1	2	4	0.5
顺便	1	1	2	4	0.5
非得	2	2	0	4	0.5
震耳欲聋	2	2	0	4	0.5
震耳	2	2	0	4	0.5
雨	2	1	1	4	0.5
集体	1	2	1	4	0.5
随时	2	2	0	4	0.5
阶段	1	1	2	4	0.5
阵痛	2	1	1	4	0.5
防范	2	1	1	4	0.5
闺女	2	1	1	4	0.5
鉴于	1	2	1	4	0.5
金色	2	0	2	4	0.5
野蛮	1	2	1	4	0.5
重男轻女	1	1	2	4	0.5
重度	2	2	0	4	0.5
重庆	2	1	1	4	0.5
醉	2	2	0	4	0.5
配色	2	1	1	4	0.5
鄙视	2	2	0	4	0.5
迪	0	2	2	4	0.5
迟	2	0	2	4	0.5
这份	2	0	2	4	0.5
还给	1	2	1	4	0.5
近年来	0	2	2	4	0.5
近年	0	2	2	4	0.5
运气	1	2	1	4	0.5
边缘	0	2	2	4	0.5
边框	2	2	0	4	0.5
输	2	1	1	4	0.5
载	2	2	0	4	0.5
转载	1	2	1	4	0.5
转移	2	1	1	4	0.5
躺	1	1	2	4	0.5
身材	2	0	2	4	0.5
身体健康	2	2	0	4	0.5
路人	1	2	1	4	0.5
起步	0	2	2	4	0.5
赶走	2	2	0	4	0.5
赢	2	0	2	4	0.5
财	2	1	1	4	0.5
负面影响	2	2	0	4	0.5
负面	2	2	0	4	0.5
负	2	1	1	4	0.5
谱	1	2	1	4	0.5
诶	2	2	0	4	0.5
误	1	2	1	4	0.5
详情请	2	0	2	4	0.5
试问	1	2	1	4	0.5
词	2	1	1	4	0.5
证实	1	1	2	4	0.5
设备	1	1	2	4	0.5
认同	0	2	2	4	0.5
警	1	2	1	4	0.5
解锁	2	1	1	4	0.5
观众	0	2	2	4	0.5
要闻	2	0	2	4	0.5
要脸	1	2	1	4	0.5
要么	2	2	0	4	0.5
街上	2	1	1	4	0.5
蛋	2	1	1	4	0.5
虽	1	2	1	4	0.5
虐	2	1	1	4	0.5
著	2	2	0	4	0.5
营业	1	1	2	4	0.5
菜	2	1	1	4	0.5
苏	1	2	1	4	0.5
节假	1	1	2	4	0.5
色	2	2	0	4	0.5
至极	2	1	1	4	0.5
自私	2	2	0	4	0.5
自愿	1	2	1	4	0.5
腾	2	2	0	4	0.5
背	1	2	1	4	0.5
联网	1	2	1	4	0.5
职工	1	2	1	4	0.5
耶	1	1	2	4	0.5
耳边	0	2	2	4	0.5
老家伙	0	2	2	4	0.5
美军	2	0	2	4	0.5
网民	2	2	0	4	0.5
网易	1	1	2	4	0.5
缺陷	1	2	1	4	0.5
统观	1	2	1	4	0.5
统治	2	2	0	4	0.5
结起来	2	2	0	4	0.5
结起	2	2	0	4	0.5
结局	1	1	2	4	0.5
经	2	2	0	4	0.5
组成	2	1	1	4	0.5
线	2	0	2	4	0.5
约束	2	2	0	4	0.5
红旗	2	1	1	4	0.5
糟糕	2	1	1	4	0.5
答	2	1	1	4	0.5
笔记本	2	2	0	4	0.5
笔记	2	2	0	4	0.5
立即	2	2	0	4	0.5
立刻	1	2	1	4	0.5
穆斯林	2	2	0	4	0.5
移动	1	2	1	4	0.5
秒杀	2	2	0	4	0.5
科学	2	2	0	4	0.5
禁忌	2	0	2	4	0.5
祸害	1	2	1	4	0.5
神学	1	2	1	4	0.5
短	1	2	1	4	0.5
看出	2	2	0	4	0.5
相差	2	1	1	4	0.5
盖	2	0	2	4	0.5
留言	2	0	2	4	0.5
电视剧	0	2	2	4	0.5
用于	2	2	0	4	0.5
理想	2	2	0	4	0.5
理念	1	1	2	4	0.5
理会	0	2	2	4	0.5
珍惜	2	0	2	4	0.5
玩儿	2	1	1	4	0.5
王八	2	2	0	4	0.5
猴子	2	2	0	4	0.5
猫	2	1	1	4	0.5
熬夜	1	2	1	4	0.5
焚香	2	1	1	4	0.5
热门	2	1	1	4	0.5
热爱	2	2	0	4	0.5
热烈	2	2	0	4	0.5
点击	0	2	2	4	0.5
炸死	2	2	0	4	0.5
炫	1	1	2	4	0.5
火车	1	1	2	4	0.5
火爆	2	2	0	4	0.5
激活	1	1	2	4	0.5
潮	2	1	1	4	0.5
漠视	2	2	0	4	0.5
满足	2	1	1	4	0.5
源于	2	1	1	4	0.5
游戏	1	2	1	4	0.5
游客	2	2	0	4	0.5
港	0	2	2	4	0.5
温暖	2	2	0	4	0.5
渐	2	2	0	4	0.5
清扫	1	2	1	4	0.5
深深	2	0	2	4	0.5
淘宝	2	0	2	4	0.5
浙江	2	1	1	4	0.5
洗脑	1	2	1	4	0.5
治疗	1	1	2	4	0.5
沸沸扬扬	0	2	2	4	0.5
沸沸	0	2	2	4	0.5
没事	1	1	2	4	0.5
沙特阿拉伯	2	2	0	4	0.5
汉子	0	2	2	4	0.5
汉	2	1	1	4	0.5
水果	2	1	1	4	0.5
此次	1	1	2	4	0.5
此外	0	2	2	4	0.5
欺骗	2	2	0	4	0.5
榜	1	1	2	4	0.5
根源	1	2	1	4	0.5
核武	2	2	0	4	0.5
核心	2	1	1	4	0.5
标志	2	1	1	4	0.5
林	1	2	1	4	0.5
松	2	2	0	4	0.5
村里	2	1	1	4	0.5
机身	1	2	1	4	0.5
机智	2	1	1	4	0.5
有用	2	2	0	4	0.5
有感而发	2	2	0	4	0.5
有序	1	2	1	4	0.5
最为	1	2	1	4	0.5
智慧	2	1	1	4	0.5
显著	1	2	1	4	0.5
显	2	1	1	4	0.5
是从	2	2	0	4	0.5
时速	2	1	1	4	0.5
时机	1	1	2	4	0.5
时尚	1	2	1	4	0.5
早起	2	2	0	4	0.5
早晨	1	2	1	4	0.5
早已	2	1	1	4	0.5
旗号	2	2	0	4	0.5
方公里	2	2	0	4	0.5
斤	2	1	1	4	0.5
斗争	1	2	1	4	0.5
斗	1	1	2	4	0.5
文字	2	1	1	4	0.5
教授	1	1	2	4	0.5
放到	1	1	2	4	0.5
操心	2	1	1	4	0.5
播	0	2	2	4	0.5
撞死	2	1	1	4	0.5
撕	1	1	2	4	0.5
提议	2	1	1	4	0.5
推迟	1	2	1	4	0.5
接近	1	2	1	4	0.5
排队	1	2	1	4	0.5
掀起	1	2	1	4	0.5
换成	2	1	1	4	0.5
损失	0	2	2	4	0.5
挑起	2	2	0	4	0.5
指标	1	1	2	4	0.5
拥挤	2	2	0	4	0.5
拆	1	1	2	4	0.5
投票	1	2	1	4	0.5
扬扬	0	2	2	4	0.5
打开	2	2	0	4	0.5
打卡	2	2	0	4	0.5
扎	2	0	2	4	0.5
手中	2	2	0	4	0.5
战火	2	1	1	4	0.5
我会	2	1	1	4	0.5
成熟	0	2	2	4	0.5
成人	2	2	0	4	0.5
懂事	2	1	1	4	0.5
愿望	1	2	1	4	0.5
感冒	2	2	0	4	0.5
意图	1	2	1	4	0.5
愉快	1	1	2	4	0.5
总算	1	2	1	4	0.5
总体	2	1	1	4	0.5
怂	2	2	0	4	0.5
快快	2	1	1	4	0.5
心头	1	2	1	4	0.5
得利	2	1	1	4	0.5
得不到	1	2	1	4	0.5
待遇	2	2	0	4	0.5
当作	2	2	0	4	0.5
强盗	2	2	0	4	0.5
强人	2	1	1	4	0.5
异常	2	0	2	4	0.5
应有	2	1	1	4	0.5
庆贺	2	0	2	4	0.5
幼稚	2	1	1	4	0.5
年纪	2	0	2	4	0.5
平方公里	2	2	0	4	0.5
平方	2	2	0	4	0.5
工作组	2	2	0	4	0.5
岗位	2	2	0	4	0.5
屠杀	2	2	0	4	0.5
屑	1	2	1	4	0.5
就是说	2	1	1	4	0.5
少数民族	1	2	1	4	0.5
少年	2	1	1	4	0.5
小心	1	1	2	4	0.5
对待	2	0	2	4	0.5
寒	1	2	1	4	0.5
家乡	2	1	1	4	0.5
实体	0	2	2	4	0.5
定性	1	2	1	4	0.5
孝顺	1	2	1	4	0.5
子孙	2	2	0	4	0.5
婚姻	1	2	1	4	0.5
威武	1	1	2	4	0.5
如同	2	1	1	4	0.5
好转	1	2	1	4	0.5
好不好	2	2	0	4	0.5
奋斗	0	2	2	4	0.5
大雾	1	2	1	4	0.5
大连	1	2	1	4	0.5
大地	1	2	1	4	0.5
多种	0	2	2	4	0.5
外型	1	2	1	4	0.5
外交部	2	2	0	4	0.5
堵住	2	0	2	4	0.5
基	2	1	1	4	0.5
块	0	2	2	4	0.5
地面	2	2	0	4	0.5
土豪	1	2	1	4	0.5
国标	1	2	1	4	0.5
国度	2	2	0	4	0.5
围观	1	1	2	4	0.5
团结起来	2	2	0	4	0.5
回头	1	1	2	4	0.5
四十	1	1	2	4	0.5
嘴巴	1	2	1	4	0.5
喜气洋洋	2	2	0	4	0.5
商量	1	2	1	4	0.5
商场	0	2	2	4	0.5
唐	2	0	2	4	0.5
哄	1	2	1	4	0.5
品质	2	1	1	4	0.5
咨询	2	1	1	4	0.5
呈现	2	0	2	4	0.5
吹	2	1	1	4	0.5
吵醒	2	2	0	4	0.5
吴	2	0	2	4	0.5
后续	1	1	2	4	0.5
古老	2	0	2	4	0.5
变迁	1	1	2	4	0.5
受伤	0	2	2	4	0.5
取	2	2	0	4	0.5
发达国家	2	1	1	4	0.5
反抗	1	2	1	4	0.5
反感	1	2	1	4	0.5
反思	1	2	1	4	0.5
双胞胎	2	2	0	4	0.5
双胞	2	2	0	4	0.5
双手	1	2	1	4	0.5
十多年	1	2	1	4	0.5
十	2	1	1	4	0.5
北路	1	2	1	4	0.5
北极熊	1	2	1	4	0.5
北极	1	2	1	4	0.5
努	2	2	0	4	0.5
动不动	2	2	0	4	0.5
办公	2	1	1	4	0.5
副	2	1	1	4	0.5
前后	2	2	0	4	0.5
前两天	2	1	1	4	0.5
利于	2	2	0	4	0.5
初二	1	1	2	4	0.5
初中	1	2	1	4	0.5
刚好	2	2	0	4	0.5
分歧	2	2	0	4	0.5
分明	1	1	2	4	0.5
击	1	1	2	4	0.5
出乎	2	1	1	4	0.5
几十年	1	2	1	4	0.5
凌	2	0	2	4	0.5
决心	1	2	1	4	0.5
内心	2	2	0	4	0.5
内外	1	2	1	4	0.5
养育	2	2	0	4	0.5
共识	1	2	1	4	0.5
公正	2	2	0	4	0.5
公共交通	1	2	1	4	0.5
公交站点	2	2	0	4	0.5
八	2	2	0	4	0.5
光是	0	2	2	4	0.5
光明	2	1	1	4	0.5
停产	2	0	2	4	0.5
做事	2	2	0	4	0.5
假日	0	2	2	4	0.5
倾向	1	1	2	4	0.5
修改	1	2	1	4	0.5
依赖	1	2	1	4	0.5
依	2	1	1	4	0.5
使得	1	2	1	4	0.5
体健	2	2	0	4	0.5
伤人	0	2	2	4	0.5
传统观念	1	2	1	4	0.5
优点	2	2	0	4	0.5
休	1	2	1	4	0.5
企图	2	1	1	4	0.5
价钱	1	2	1	4	0.5
价	0	2	2	4	0.5
从没	1	1	2	4	0.5
人情	2	1	1	4	0.5
交管部门	0	2	2	4	0.5
亚洲	1	1	2	4	0.5
互	1	2	1	4	0.5
乱象	2	2	0	4	0.5
买单	2	2	0	4	0.5
书	2	2	0	4	0.5
也就是说	2	1	1	4	0.5
乐意	2	1	1	4	0.5
主张	1	2	1	4	0.5
为首	2	1	1	4	0.5
为此	2	1	1	4	0.5
临时	2	2	0	4	0.5
串	1	2	1	4	0.5
中原	2	2	0	4	0.5
两位	1	1	2	4	0.5
东北	2	2	0	4	0.5
世代	2	1	1	4	0.5
与其	2	1	1	4	0.5
不着	1	1	2	4	0.5
不时	2	2	0	4	0.5
不怕	2	1	1	4	0.5
不快	2	2	0	4	0.5
不得了	2	2	0	4	0.5
不开	1	2	1	4	0.5
不孕	2	1	1	4	0.5
不动	2	2	0	4	0.5
上次	2	1	1	4	0.5
上坟	2	2	0	4	0.5
三千	2	2	0	4	0.5
一系列	1	2	1	4	0.5
一系	1	2	1	4	0.5
一篇	2	2	0	4	0.5
一枚	2	1	1	4	0.5
一时	1	1	2	4	0.5
一战	1	2	1	4	0.5
一声	1	2	1	4	0.5
一团	2	0	2	4	0.5
一刻	1	1	2	4	0.5
一个多月	2	0	2	4	0.5
tmd	2	1	1	4	0.5
s7	2	1	1	4	0.5
m9	1	1	2	4	0.5
live	2	1	1	4	0.5
km	2	0	2	4	0.5
cpu	2	2	0	4	0.5
com	2	2	0	4	0.5
鼻子	1	1	0	2	0.5
鼠	1	1	0	2	0.5
默认	0	1	1	2	0.5
默克尔	0	1	1	2	0.5
默克	0	1	1	2	0.5
鹰	1	0	1	2	0.5
鸿	0	1	1	2	0.5
鸡飞狗跳	0	1	1	2	0.5
鸡汤	1	0	1	2	0.5
鸟	0	1	1	2	0.5
魔鬼	0	1	1	2	0.5
魄力	0	1	1	2	0.5
高温	0	1	1	2	0.5
高架	1	0	1	2	0.5
高喊	1	1	0	2	0.5
高出	0	1	1	2	0.5
骡子	1	1	0	2	0.5
骗子	1	0	1	2	0.5
验证	0	1	1	2	0.5
驾驶员	1	0	1	2	0.5
驻军	1	1	0	2	0.5
马达	1	1	0	2	0.5
马桶	1	1	0	2	0.5
馨	1	0	1	2	0.5
香烟	1	1	0	2	0.5
首页	1	1	0	2	0.5
饥饿	0	1	1	2	0.5
餐	1	1	0	2	0.5
食物	0	1	1	2	0.5
风范	1	1	0	2	0.5
风尚	0	1	1	2	0.5
风光	1	0	1	2	0.5
颠覆	1	1	0	2	0.5
颗	1	1	0	2	0.5
频率	0	1	1	2	0.5
颐	0	1	1	2	0.5
领悟	1	1	0	2	0.5
领域	0	1	1	2	0.5
预想	1	0	1	2	0.5
预估	1	0	1	2	0.5
顾虑	1	1	0	2	0.5
顺顺利利	1	0	1	2	0.5
顺顺	1	0	1	2	0.5
顺应	0	1	1	2	0.5
韵	1	1	0	2	0.5
音	1	1	0	2	0.5
靴	1	0	1	2	0.5
面试	1	1	0	2	0.5
面包车	0	1	1	2	0.5
非洲	1	1	0	2	0.5
静	1	0	1	2	0.5
霸气	1	0	1	2	0.5
霸权	1	1	0	2	0.5
露出	1	1	0	2	0.5
霍姆斯	0	1	1	2	0.5
震天	1	1	0	2	0.5
雷声大雨	0	1	1	2	0.5
雷声大	0	1	1	2	0.5
雷声	0	1	1	2	0.5
零距离	0	1	1	2	0.5
零售店	0	1	1	2	0.5
零售商	0	1	1	2	0.5
零	0	1	1	2	0.5
雏形	1	1	0	2	0.5
难事	1	1	0	2	0.5
障碍	0	1	1	2	0.5
隔三差五	0	1	1	2	0.5
随手	1	1	0	2	0.5
随后	0	1	1	2	0.5
随之而来	0	1	1	2	0.5
陷	0	1	1	2	0.5
险	1	0	1	2	0.5
除夕之夜	1	1	0	2	0.5
院子	0	1	1	2	0.5
限量	1	1	0	2	0.5
陆续	1	1	0	2	0.5
附属	1	1	0	2	0.5
阴谋	1	1	0	2	0.5
防火	1	1	0	2	0.5
防水	0	1	1	2	0.5
防护	1	0	1	2	0.5
防患于未然	1	1	0	2	0.5
防患于未	1	1	0	2	0.5
防患	1	1	0	2	0.5
防	0	1	1	2	0.5
队员	0	1	1	2	0.5
阖家欢乐	0	1	1	2	0.5
阖家欢	0	1	1	2	0.5
阖家幸福	1	1	0	2	0.5
闹事	0	1	1	2	0.5
闲钱	1	1	0	2	0.5
问问	1	1	0	2	0.5
问候	1	1	0	2	0.5
闪闪	1	0	1	2	0.5
长线	0	1	1	2	0.5
长时间	1	1	0	2	0.5
长安	0	1	1	2	0.5
长大成人	1	1	0	2	0.5
锣鼓喧天	1	0	1	2	0.5
错过	1	0	1	2	0.5
锁	1	1	0	2	0.5
销售量	0	1	1	2	0.5
销售点	1	0	1	2	0.5
铲	1	1	0	2	0.5
铁甲	0	1	1	2	0.5
钟声	1	1	0	2	0.5
针	0	1	1	2	0.5
量力	1	0	1	2	0.5
量减少	0	1	1	2	0.5
重置	0	1	1	2	0.5
重拾	1	0	1	2	0.5
重回	0	1	1	2	0.5
里姆林	1	0	1	2	0.5
里姆	1	0	1	2	0.5
醒	0	1	1	2	0.5
酝酿	1	0	1	2	0.5
配送	0	1	1	2	0.5
配图	1	0	1	2	0.5
部长	1	1	0	2	0.5
郁闷	0	1	1	2	0.5
邮政	1	0	1	2	0.5
那位	1	1	0	2	0.5
邀	1	1	0	2	0.5
避孕	0	1	1	2	0.5
避	1	1	0	2	0.5
遭受	1	1	0	2	0.5
道具	1	1	0	2	0.5
道义	1	1	0	2	0.5
遍地	1	1	0	2	0.5
遇难	1	1	0	2	0.5
造谣	1	1	0	2	0.5
造孽	0	1	1	2	0.5
通道	1	1	0	2	0.5
通讯	1	1	0	2	0.5
通报	0	1	1	2	0.5
逐	1	0	1	2	0.5
透	1	0	1	2	0.5
送走	1	1	0	2	0.5
退步	1	1	0	2	0.5
退出	1	1	0	2	0.5
退休金	1	1	0	2	0.5
迷藏	0	1	1	2	0.5
迫使	1	0	1	2	0.5
迟钝	1	1	0	2	0.5
连线	0	1	1	2	0.5
连环	1	0	1	2	0.5
连接	1	1	0	2	0.5
违规行为	1	1	0	2	0.5
违法犯罪	1	1	0	2	0.5
远去	0	1	1	2	0.5
这点儿	1	1	0	2	0.5
这样的话	1	1	0	2	0.5
这时	1	0	1	2	0.5
这么回事	1	1	0	2	0.5
返回	1	0	1	2	0.5
运势	1	0	1	2	0.5
过期	0	1	1	2	0.5
过度	1	1	0	2	0.5
过小年	1	1	0	2	0.5
边界	1	0	1	2	0.5
辩证	1	1	0	2	0.5
辨别	1	1	0	2	0.5
输卵管	1	0	1	2	0.5
输卵	1	0	1	2	0.5
输入	1	1	0	2	0.5
较为	1	0	1	2	0.5
轻度	0	1	1	2	0.5
转行	0	1	1	2	0.5
转眼	1	0	1	2	0.5
转头	0	1	1	2	0.5
转世	1	1	0	2	0.5
轩	1	0	1	2	0.5
车厢	1	1	0	2	0.5
躲	1	1	0	2	0.5
身体素质	1	1	0	2	0.5
躁	0	1	1	2	0.5
踩	1	1	0	2	0.5
踏实	0	1	1	2	0.5
践踏	1	1	0	2	0.5
跳舞	0	1	1	2	0.5
跳楼	0	1	1	2	0.5
跳出	1	0	1	2	0.5
路过	1	1	0	2	0.5
路人皆知	1	1	0	2	0.5
跑旱船	1	0	1	2	0.5
足	1	0	1	2	0.5
越是	1	1	0	2	0.5
越境	1	0	1	2	0.5
越发	1	1	0	2	0.5
越南	0	1	1	2	0.5
超高	1	0	1	2	0.5
超市	1	0	1	2	0.5
起航	1	0	1	2	0.5
赶着	0	1	1	2	0.5
赶快	1	1	0	2	0.5
走访	1	0	1	2	0.5
走火	1	1	0	2	0.5
走入	0	1	1	2	0.5
赞助	1	0	1	2	0.5
赏	1	0	1	2	0.5
资助	0	1	1	2	0.5
贱	0	1	1	2	0.5
购买欲	0	1	1	2	0.5
贪污	1	1	0	2	0.5
贪官	1	1	0	2	0.5
贩子	0	1	1	2	0.5
财力	1	1	0	2	0.5
财产权	0	1	1	2	0.5
豆浆	1	1	0	2	0.5
谢	0	1	1	2	0.5
谈起	0	1	1	2	0.5
谈谈	1	0	1	2	0.5
谈恋爱	0	1	1	2	0.5
调低	0	1	1	2	0.5
谁知	0	1	1	2	0.5
谁家	1	0	1	2	0.5
课堂	1	1	0	2	0.5
读书	1	1	0	2	0.5
请来	0	1	1	2	0.5
说道	1	1	0	2	0.5
说起	0	1	1	2	0.5
说白了	1	1	0	2	0.5
说白	1	1	0	2	0.5
说服	1	1	0	2	0.5
说不清	1	1	0	2	0.5
说不定	1	1	0	2	0.5
详细	1	1	0	2	0.5
诚信	1	1	0	2	0.5
诚	1	0	1	2	0.5
诗	1	0	1	2	0.5
试验场	0	1	1	2	0.5
试验	0	1	1	2	0.5
试管婴儿	1	0	1	2	0.5
试图	0	1	1	2	0.5
识	1	1	0	2	0.5
评论员	1	1	0	2	0.5
证件	0	1	1	2	0.5
访谈	0	1	1	2	0.5
访	1	0	1	2	0.5
论文	0	1	1	2	0.5
许可证	0	1	1	2	0.5
讲话	1	0	1	2	0.5
记忆里	1	0	1	2	0.5
记	0	1	1	2	0.5
讨	1	1	0	2	0.5
认亲	1	0	1	2	0.5
计算	0	1	1	2	0.5
计生委	1	1	0	2	0.5
解散	1	1	0	2	0.5
解	0	1	1	2	0.5
角落里	0	1	1	2	0.5
见面	1	0	1	2	0.5
西部	0	1	1	2	0.5
西游	0	1	1	2	0.5
西北部	0	1	1	2	0.5
裹	1	1	0	2	0.5
装车	1	1	0	2	0.5
裂	1	1	0	2	0.5
被迫	1	1	0	2	0.5
被车撞	1	0	1	2	0.5
被子	1	0	1	2	0.5
衰老	1	0	1	2	0.5
表面	0	1	1	2	0.5
补贴	1	0	1	2	0.5
衍生	0	1	1	2	0.5
行路	1	1	0	2	0.5
行使	0	1	1	2	0.5
薄	1	1	0	2	0.5
蒸	1	1	0	2	0.5
蒙古	1	1	0	2	0.5
获利	1	1	0	2	0.5
莫非	1	1	0	2	0.5
荒唐	1	1	0	2	0.5
英镑	1	0	1	2	0.5
英国	1	0	1	2	0.5
苦肉计	1	1	0	2	0.5
若干年	1	1	0	2	0.5
若干	1	1	0	2	0.5
苟且	1	1	0	2	0.5
芳	1	1	0	2	0.5
芒果	1	1	0	2	0.5
节庆	1	1	0	2	0.5
节后	1	1	0	2	0.5
节前	1	1	0	2	0.5
节制	1	1	0	2	0.5
节假日	0	1	1	2	0.5
良	0	1	1	2	0.5
般的	1	1	0	2	0.5
舒适	1	1	0	2	0.5
舒坦	1	1	0	2	0.5
舍不得	1	1	0	2	0.5
自费	0	1	1	2	0.5
自知	0	1	1	2	0.5
自治	1	1	0	2	0.5
自制	1	0	1	2	0.5
自为	1	1	0	2	0.5
自不量力	1	0	1	2	0.5
腻	1	0	1	2	0.5
脸面	1	1	0	2	0.5
脱	0	1	1	2	0.5
脑子里	1	0	1	2	0.5
胸	0	1	1	2	0.5
胡子	1	0	1	2	0.5
胜利	0	1	1	2	0.5
胖子	1	1	0	2	0.5
胖	1	0	1	2	0.5
背着	0	1	1	2	0.5
肺	1	1	0	2	0.5
股	1	0	1	2	0.5
肚	1	0	1	2	0.5
聚	1	1	0	2	0.5
联邦制	0	1	1	2	0.5
联通	1	0	1	2	0.5
联合国安理会	0	1	1	2	0.5
联军	1	1	0	2	0.5
职场	1	1	0	2	0.5
耳机	0	1	1	2	0.5
耍	1	1	0	2	0.5
而过	1	1	0	2	0.5
老年人	1	1	0	2	0.5
老头	0	1	1	2	0.5
羞辱	1	1	0	2	0.5
羞耻	0	1	1	2	0.5
美美	1	0	1	2	0.5
美利坚	1	1	0	2	0.5
美利	1	1	0	2	0.5
置疑	1	1	0	2	0.5
罪人	1	1	0	2	0.5
罢	1	0	1	2	0.5
网通	0	1	1	2	0.5
缺	1	1	0	2	0.5
缓和	0	1	1	2	0.5
缓冲	1	0	1	2	0.5
绿绿	1	1	0	2	0.5
统计局	1	0	1	2	0.5
绝路	1	1	0	2	0.5
绝经	0	1	1	2	0.5
结论	1	1	0	2	0.5
经纪	1	1	0	2	0.5
细分	0	1	1	2	0.5
组建	1	1	0	2	0.5
纷纷表示	1	1	0	2	0.5
级别	1	1	0	2	0.5
约合	1	0	1	2	0.5
纠纷	0	1	1	2	0.5
繁荣	0	1	1	2	0.5
累累	1	1	0	2	0.5
紧跟	1	0	1	2	0.5
糟	0	1	1	2	0.5
糕	1	1	0	2	0.5
精选	1	0	1	2	0.5
精	1	1	0	2	0.5
粮	1	0	1	2	0.5
粗放	1	1	0	2	0.5
粑	1	1	0	2	0.5
米饭	1	1	0	2	0.5
米姆	1	1	0	2	0.5
箱	0	1	1	2	0.5
算盘	1	1	0	2	0.5
算了	1	1	0	2	0.5
算不算	1	1	0	2	0.5
简约	1	1	0	2	0.5
简化	0	1	1	2	0.5
策略	0	1	1	2	0.5
答案	1	1	0	2	0.5
等着瞧	1	1	0	2	0.5
等同	1	1	0	2	0.5
第三周	1	0	1	2	0.5
第一眼	1	0	1	2	0.5
第一件	1	1	0	2	0.5
笑语	1	1	0	2	0.5
竟	1	1	0	2	0.5
窗户	1	0	1	2	0.5
窗口	0	1	1	2	0.5
窗	1	0	1	2	0.5
突显	0	1	1	2	0.5
穿梭	0	1	1	2	0.5
空中	1	0	1	2	0.5
穷鬼	1	1	0	2	0.5
稳	1	1	0	2	0.5
程序	1	1	0	2	0.5
稀里哗啦	1	1	0	2	0.5
积压	0	1	1	2	0.5
积	1	1	0	2	0.5
租金	1	1	0	2	0.5
离不开	0	1	1	2	0.5
禹州	1	1	0	2	0.5
祸水	0	1	1	2	0.5
祖	0	1	1	2	0.5
祈祷	1	0	1	2	0.5
社	1	1	0	2	0.5
磕	0	1	1	2	0.5
碰到	1	0	1	2	0.5
碎语	1	1	0	2	0.5
碎	1	1	0	2	0.5
硬	1	0	1	2	0.5
石家庄	0	1	1	2	0.5
石家	0	1	1	2	0.5
短途	1	0	1	2	0.5
短短	1	0	1	2	0.5
短期	0	1	1	2	0.5
知不知道	0	1	1	2	0.5
矣	1	0	1	2	0.5
瞬间	1	0	1	2	0.5
瞎折腾	0	1	1	2	0.5
睿	1	1	0	2	0.5
睡不着	1	0	1	2	0.5
眼见为实	1	1	0	2	0.5
眼见	1	1	0	2	0.5
真不容易	1	1	0	2	0.5
看齐	0	1	1	2	0.5
看过	1	1	0	2	0.5
看着办	1	0	1	2	0.5
看望	1	0	1	2	0.5
看吧	1	1	0	2	0.5
看书	1	1	0	2	0.5
看不懂	0	1	1	2	0.5
省城	0	1	1	2	0.5
相处	0	1	1	2	0.5
相传	1	0	1	2	0.5
盐	1	1	0	2	0.5
皆知	1	1	0	2	0.5
百姓生活	0	1	1	2	0.5
百倍	1	1	0	2	0.5
百人	1	1	0	2	0.5
百二	1	1	0	2	0.5
登记	1	1	0	2	0.5
瘦	1	0	1	2	0.5
病根	1	1	0	2	0.5
病房	1	0	1	2	0.5
畜	1	1	0	2	0.5
留学	0	1	1	2	0.5
男生	0	1	1	2	0.5
男娃	0	1	1	2	0.5
电灯	0	1	1	2	0.5
电三轮	1	0	1	2	0.5
由衷	1	1	0	2	0.5
用车	1	0	1	2	0.5
用度	0	1	1	2	0.5
用到	0	1	1	2	0.5
生物	0	1	1	2	0.5
生活富裕	1	1	0	2	0.5
生养	0	1	1	2	0.5
生产线	1	1	0	2	0.5
瓜	1	1	0	2	0.5
理直气壮	1	1	0	2	0.5
理	1	0	1	2	0.5
玻璃	0	1	1	2	0.5
环节	1	1	0	2	0.5
环球时报	1	1	0	2	0.5
环球	1	1	0	2	0.5
玩游戏	1	1	0	2	0.5
玩游	1	1	0	2	0.5
玩具	1	0	1	2	0.5
玛	0	1	1	2	0.5
猪头	1	1	0	2	0.5
猛烈	1	0	1	2	0.5
猛增	1	1	0	2	0.5
猖狂	1	1	0	2	0.5
狮子	1	1	0	2	0.5
独裁政权	0	1	1	2	0.5
独家	1	0	1	2	0.5
狠揍	1	1	0	2	0.5
狗狗	1	1	0	2	0.5
犹如	0	1	1	2	0.5
犯罪分子	1	0	1	2	0.5
特种兵	1	1	0	2	0.5
特派记者	1	0	1	2	0.5
特派	1	0	1	2	0.5
特殊政策	1	0	1	2	0.5
特征	1	1	0	2	0.5
物美	0	1	1	2	0.5
牛郎	1	0	1	2	0.5
牌坊	1	1	0	2	0.5
爹妈	1	1	0	2	0.5
爷爷奶奶	1	1	0	2	0.5
爷们	1	1	0	2	0.5
爱车	0	1	1	2	0.5
爆棚	1	0	1	2	0.5
煮	1	0	1	2	0.5
焕发	0	1	1	2	0.5
热门话题	0	1	1	2	0.5
热衷于	0	1	1	2	0.5
热衷	0	1	1	2	0.5
热点话题	1	0	1	2	0.5
烦躁	0	1	1	2	0.5
烦死	1	1	0	2	0.5
烟尘	0	1	1	2	0.5
烛	0	1	1	2	0.5
点火	1	1	0	2	0.5
炮轰	0	1	1	2	0.5
炒	1	1	0	2	0.5
灶神	1	0	1	2	0.5
火药桶	1	1	0	2	0.5
火光冲天	1	0	1	2	0.5
灌输	0	1	1	2	0.5
激化	1	1	0	2	0.5
潘	1	1	0	2	0.5
潍坊	1	1	0	2	0.5
漫长	1	1	0	2	0.5
满面	1	0	1	2	0.5
满街	1	1	0	2	0.5
满月酒	1	0	1	2	0.5
满天	1	0	1	2	0.5
湖南	0	1	1	2	0.5
湖	1	0	1	2	0.5
游	1	1	0	2	0.5
港版	1	0	1	2	0.5
港城	1	0	1	2	0.5
温州	1	0	1	2	0.5
温	0	1	1	2	0.5
渠道	1	0	1	2	0.5
清风	1	1	0	2	0.5
清除	1	1	0	2	0.5
清真寺	0	1	1	2	0.5
清真	0	1	1	2	0.5
清晨	0	1	1	2	0.5
深化	1	0	1	2	0.5
深刻	1	1	0	2	0.5
淡薄	1	0	1	2	0.5
淘	1	0	1	2	0.5
涕零	1	0	1	2	0.5
消防官兵	0	1	1	2	0.5
消防员	0	1	1	2	0.5
消	0	1	1	2	0.5
浑水	1	0	1	2	0.5
浏览	0	1	1	2	0.5
流畅性	1	1	0	2	0.5
流满	1	0	1	2	0.5
活该	0	1	1	2	0.5
活着	1	1	0	2	0.5
洞	1	1	0	2	0.5
洛阳	1	1	0	2	0.5
洁癖	1	1	0	2	0.5
泽	0	1	1	2	0.5
泪流满面	1	0	1	2	0.5
泪流	1	0	1	2	0.5
泥	1	1	0	2	0.5
法律法规	1	1	0	2	0.5
泉	1	1	0	2	0.5
治病	0	1	1	2	0.5
治国	1	1	0	2	0.5
没钱买	1	1	0	2	0.5
没钱	1	1	0	2	0.5
没空	1	1	0	2	0.5
没人管	1	1	0	2	0.5
没人	1	1	0	2	0.5
沟通	1	1	0	2	0.5
沙漠	1	0	1	2	0.5
江西	0	1	1	2	0.5
江湖	0	1	1	2	0.5
求助	0	1	1	2	0.5
水火	0	1	1	2	0.5
气球	1	1	0	2	0.5
气味	1	1	0	2	0.5
民工	0	1	1	2	0.5
母爱	1	0	1	2	0.5
毋庸置疑	1	1	0	2	0.5
毋庸	1	1	0	2	0.5
死死	1	1	0	2	0.5
死去	1	0	1	2	0.5
步步	1	1	0	2	0.5
步入	1	1	0	2	0.5
正面	1	1	0	2	0.5
歌谣	1	1	0	2	0.5
歌手	1	0	1	2	0.5
歇歇	1	1	0	2	0.5
欣赏	0	1	1	2	0.5
欣喜	0	1	1	2	0.5
欢声笑语	1	1	0	2	0.5
欢声	1	1	0	2	0.5
次日	0	1	1	2	0.5
欠	1	1	0	2	0.5
横行	0	1	1	2	0.5
横	1	0	1	2	0.5
模	0	1	1	2	0.5
概率	1	1	0	2	0.5
棍	1	1	0	2	0.5
棋子	0	1	1	2	0.5
检	1	0	1	2	0.5
案例	1	0	1	2	0.5
根	1	1	0	2	0.5
核算	1	0	1	2	0.5
树	1	1	0	2	0.5
栏目	1	0	1	2	0.5
标配	0	1	1	2	0.5
查看	1	1	0	2	0.5
柒	1	1	0	2	0.5
某位	1	0	1	2	0.5
某人	1	0	1	2	0.5
某个	1	0	1	2	0.5
架次	1	1	0	2	0.5
架	1	1	0	2	0.5
构成	0	1	1	2	0.5
极端主义	1	1	0	2	0.5
极左	1	1	0	2	0.5
板砖	1	1	0	2	0.5
板子	0	1	1	2	0.5
杰	1	1	0	2	0.5
来源于	1	0	1	2	0.5
李女士	1	1	0	2	0.5
杂志	1	0	1	2	0.5
杀戮	1	1	0	2	0.5
杀害	1	1	0	2	0.5
机子	1	1	0	2	0.5
本国	1	1	0	2	0.5
本事	1	0	1	2	0.5
服	0	1	1	2	0.5
有责	1	1	0	2	0.5
有罪	0	1	1	2	0.5
有点像	1	0	1	2	0.5
有意无意	0	1	1	2	0.5
有利于	1	1	0	2	0.5
有事	1	1	0	2	0.5
月子	1	0	1	2	0.5
最起码	1	0	1	2	0.5
最强	1	1	0	2	0.5
最差	0	1	1	2	0.5
最初	1	0	1	2	0.5
暗访	0	1	1	2	0.5
暖冬	1	1	0	2	0.5
晨报	0	1	1	2	0.5
显而易见	0	1	1	2	0.5
显而	0	1	1	2	0.5
显示屏	1	0	1	2	0.5
春运	1	0	1	2	0.5
春节假期	1	0	1	2	0.5
映	0	1	1	2	0.5
星星	1	1	0	2	0.5
易见	0	1	1	2	0.5
昏	0	1	1	2	0.5
昆明	1	1	0	2	0.5
时段	1	1	0	2	0.5
时时	1	1	0	2	0.5
时政	1	1	0	2	0.5
时任	1	1	0	2	0.5
时不时	1	1	0	2	0.5
早饭	1	1	0	2	0.5
早知	0	1	1	2	0.5
日电	1	1	0	2	0.5
无缝	1	1	0	2	0.5
无线	1	1	0	2	0.5
无知	1	1	0	2	0.5
无比	1	1	0	2	0.5
无异于	1	1	0	2	0.5
无尽	1	1	0	2	0.5
无可厚非	1	1	0	2	0.5
无休	1	0	1	2	0.5
旗帜	1	0	1	2	0.5
旅行	0	1	1	2	0.5
施行	1	1	0	2	0.5
新鲜事	0	1	1	2	0.5
新风尚	0	1	1	2	0.5
新民	0	1	1	2	0.5
新年好	1	1	0	2	0.5
新安	1	0	1	2	0.5
新增	1	0	1	2	0.5
新华网	1	1	0	2	0.5
新华	1	1	0	2	0.5
斗牛	1	1	0	2	0.5
文物	1	1	0	2	0.5
文学	1	0	1	2	0.5
文件	1	1	0	2	0.5
整顿	1	1	0	2	0.5
整版	1	0	1	2	0.5
敲	1	0	1	2	0.5
数额	1	0	1	2	0.5
数码	0	1	1	2	0.5
数百年	1	1	0	2	0.5
数百	1	1	0	2	0.5
数字	0	1	1	2	0.5
数千	1	0	1	2	0.5
散步	1	0	1	2	0.5
效忠	1	1	0	2	0.5
放学	1	1	0	2	0.5
放在眼里	1	1	0	2	0.5
放任	1	1	0	2	0.5
改良	1	1	0	2	0.5
收货	1	0	1	2	0.5
收回	0	1	1	2	0.5
支那	1	1	0	2	0.5
支持者	1	0	1	2	0.5
支	1	1	0	2	0.5
擦枪	1	1	0	2	0.5
操控	1	0	1	2	0.5
撒娇	1	0	1	2	0.5
撑腰	1	1	0	2	0.5
撑	0	1	1	2	0.5
摩尔	1	0	1	2	0.5
摧毁	1	1	0	2	0.5
摆设	1	1	0	2	0.5
搅乱	1	0	1	2	0.5
搅	1	1	0	2	0.5
搁	1	1	0	2	0.5
援引	0	1	1	2	0.5
措手不及	1	0	1	2	0.5
措手	1	0	1	2	0.5
推进	1	1	0	2	0.5
推定	0	1	1	2	0.5
接收	0	1	1	2	0.5
掠夺	0	1	1	2	0.5
排斥	1	1	0	2	0.5
掏	1	0	1	2	0.5
掌控	1	1	0	2	0.5
换机	1	0	1	2	0.5
捡	1	1	0	2	0.5
捐给	1	1	0	2	0.5
捉迷藏	0	1	1	2	0.5
捉	1	0	1	2	0.5
捂着	0	1	1	2	0.5
振动	1	1	0	2	0.5
挤压	1	1	0	2	0.5
挣扎	0	1	1	2	0.5
按键	0	1	1	2	0.5
按理说	0	1	1	2	0.5
按理	0	1	1	2	0.5
挂牌	0	1	1	2	0.5
拳头	1	1	0	2	0.5
拭目以待	0	1	1	2	0.5
拭目	0	1	1	2	0.5
拦	1	1	0	2	0.5
拜托	1	0	1	2	0.5
招呼	1	1	0	2	0.5
拆解	1	1	0	2	0.5
担当	1	1	0	2	0.5
担子	1	1	0	2	0.5
报警	1	0	1	2	0.5
护眼	1	1	0	2	0.5
护理	1	0	1	2	0.5
抢走	0	1	1	2	0.5
抢掠	1	1	0	2	0.5
抢夺	1	1	0	2	0.5
抗衡	0	1	1	2	0.5
抗拒	0	1	1	2	0.5
抗	0	1	1	2	0.5
投保	1	0	1	2	0.5
抓捕	0	1	1	2	0.5
抉择	1	0	1	2	0.5
承受	0	1	1	2	0.5
找准	1	1	0	2	0.5
批发	1	0	1	2	0.5
批判	1	0	1	2	0.5
扶	1	1	0	2	0.5
扫把	0	1	1	2	0.5
打扰	1	1	0	2	0.5
打成	0	1	1	2	0.5
打字	1	0	1	2	0.5
打动	1	0	1	2	0.5
打上去	1	1	0	2	0.5
打上	1	1	0	2	0.5
所幸	1	0	1	2	0.5
房间	1	0	1	2	0.5
房地产	1	0	1	2	0.5
房地	1	0	1	2	0.5
户	1	1	0	2	0.5
截至	1	0	1	2	0.5
战斗力	1	1	0	2	0.5
战役	1	1	0	2	0.5
成果	1	1	0	2	0.5
懒得	1	0	1	2	0.5
慎重	0	1	1	2	0.5
感激涕零	1	0	1	2	0.5
感激	1	0	1	2	0.5
感兴趣	1	1	0	2	0.5
感兴	1	1	0	2	0.5
意大利	0	1	1	2	0.5
惧怕	1	1	0	2	0.5
惊吓	1	0	1	2	0.5
情愿	1	1	0	2	0.5
情感	1	1	0	2	0.5
患者	1	0	1	2	0.5
悠久	0	1	1	2	0.5
悍然	1	0	1	2	0.5
悄悄	1	0	1	2	0.5
恶性	1	1	0	2	0.5
恰好	1	1	0	2	0.5
恐怖份子	1	1	0	2	0.5
总部	1	1	0	2	0.5
总而言之	1	1	0	2	0.5
总归	1	1	0	2	0.5
怪物	1	1	0	2	0.5
性格	1	1	0	2	0.5
急需	1	0	1	2	0.5
怂恿	1	0	1	2	0.5
态势	1	1	0	2	0.5
怀里	1	0	1	2	0.5
念佛	0	1	1	2	0.5
快速	1	1	0	2	0.5
快点	1	1	0	2	0.5
忧	1	0	1	2	0.5
忍耐	1	1	0	2	0.5
忍不住	1	0	1	2	0.5
必备	1	1	0	2	0.5
心焦	1	0	1	2	0.5
心灵	0	1	1	2	0.5
心慌	1	1	0	2	0.5
心思	1	0	1	2	0.5
德行	1	0	1	2	0.5
得罪	0	1	1	2	0.5
得知	0	1	1	2	0.5
得不偿失	1	1	0	2	0.5
律	1	0	1	2	0.5
很惨	1	1	0	2	0.5
很久很久	1	1	0	2	0.5
征	1	1	0	2	0.5
往前	1	1	0	2	0.5
彼得	0	1	1	2	0.5
彩	1	0	1	2	0.5
当兵	1	1	0	2	0.5
当今社会	1	1	0	2	0.5
当事人	0	1	1	2	0.5
当中	1	0	1	2	0.5
当下	0	1	1	2	0.5
归咎	1	0	1	2	0.5
强权	0	1	1	2	0.5
强劲	0	1	1	2	0.5
弹	0	1	1	2	0.5
弟	1	1	0	2	0.5
引线	1	1	0	2	0.5
引爆	0	1	1	2	0.5
引人	1	0	1	2	0.5
引产	1	1	0	2	0.5
异于	1	1	0	2	0.5
异	1	1	0	2	0.5
开玩笑	1	1	0	2	0.5
开机	0	1	1	2	0.5
开工	0	1	1	2	0.5
店员	1	1	0	2	0.5
应为	0	1	1	2	0.5
床上	1	0	1	2	0.5
广东台	1	1	0	2	0.5
幺	0	1	1	2	0.5
并未	0	1	1	2	0.5
年节	1	0	1	2	0.5
年度	1	1	0	2	0.5
平安夜	1	1	0	2	0.5
平和	1	1	0	2	0.5
干扰	1	0	1	2	0.5
常态	0	1	1	2	0.5
帮衬	1	1	0	2	0.5
帖子	1	0	1	2	0.5
希腊	1	0	1	2	0.5
师范	1	1	0	2	0.5
师傅	1	1	0	2	0.5
市面上	1	1	0	2	0.5
市面	1	1	0	2	0.5
市道	0	1	1	2	0.5
市委	1	1	0	2	0.5
市县	1	1	0	2	0.5
巴黎	1	1	0	2	0.5
巴基斯坦	0	1	1	2	0.5
巴基斯	0	1	1	2	0.5
巴基	0	1	1	2	0.5
巴不得	1	1	0	2	0.5
巴	1	0	1	2	0.5
巨响	1	1	0	2	0.5
左手	1	0	1	2	0.5
左	1	1	0	2	0.5
工人员	0	1	1	2	0.5
崽	1	1	0	2	0.5
崇洋媚外	1	0	1	2	0.5
峰	1	1	0	2	0.5
岂	1	1	0	2	0.5
岁月	1	1	0	2	0.5
山路	1	0	1	2	0.5
山姆大叔	1	1	0	2	0.5
山东省	1	1	0	2	0.5
屠苏	0	1	1	2	0.5
屏蔽	0	1	1	2	0.5
屏幕显示	0	1	1	2	0.5
屋	1	0	1	2	0.5
届	1	0	1	2	0.5
居高不下	0	1	1	2	0.5
尾巴	0	1	1	2	0.5
尽责	0	1	1	2	0.5
尽早	1	0	1	2	0.5
少年儿童	1	0	1	2	0.5
小队	1	0	1	2	0.5
小苹果	1	0	1	2	0.5
小康	1	0	1	2	0.5
小孩儿	1	1	0	2	0.5
小子	1	1	0	2	0.5
小姐	1	1	0	2	0.5
小型	0	1	1	2	0.5
尊	1	0	1	2	0.5
封建	1	1	0	2	0.5
寻求	1	0	1	2	0.5
富有	1	0	1	2	0.5
密度	1	0	1	2	0.5
寂寞	1	1	0	2	0.5
宾馆	1	0	1	2	0.5
宽敞	1	0	1	2	0.5
宽	0	1	1	2	0.5
家庄	0	1	1	2	0.5
家具	1	1	0	2	0.5
家住	1	1	0	2	0.5
宴	0	1	1	2	0.5
宫	1	1	0	2	0.5
实践	1	0	1	2	0.5
实	0	1	1	2	0.5
完整版	1	0	1	2	0.5
安心	0	1	1	2	0.5
安宁	0	1	1	2	0.5
安卡拉	0	1	1	2	0.5
安利	1	1	0	2	0.5
安全性	1	1	0	2	0.5
安保	1	0	1	2	0.5
守护	0	1	1	2	0.5
守夜	1	1	0	2	0.5
宁波	1	1	0	2	0.5
孽	1	1	0	2	0.5
学法	0	1	1	2	0.5
学术	0	1	1	2	0.5
孕育	1	0	1	2	0.5
嫌疑人	1	0	1	2	0.5
嫂	1	1	0	2	0.5
嫁娶	1	1	0	2	0.5
媚外	1	0	1	2	0.5
婶婶	1	0	1	2	0.5
婴	1	0	1	2	0.5
威力	0	1	1	2	0.5
姥姥	1	0	1	2	0.5
姆林宫	1	0	1	2	0.5
妙	1	0	1	2	0.5
妇产科	1	1	0	2	0.5
妇产	1	1	0	2	0.5
妄为	1	0	1	2	0.5
如下	0	1	1	2	0.5
好歹	1	0	1	2	0.5
好多年	1	1	0	2	0.5
她家	0	1	1	2	0.5
女权主义者	0	1	1	2	0.5
女权主义	0	1	1	2	0.5
女孩子	0	1	1	2	0.5
女婴	1	1	0	2	0.5
失踪	1	1	0	2	0.5
失火	0	1	1	2	0.5
央	0	1	1	2	0.5
太紧	1	1	0	2	0.5
天河	0	1	1	2	0.5
天地	1	0	1	2	0.5
大龄	1	1	0	2	0.5
大餐	1	1	0	2	0.5
大面积	0	1	1	2	0.5
大面	0	1	1	2	0.5
大过年	1	0	1	2	0.5
大路	1	1	0	2	0.5
大赛	1	1	0	2	0.5
大脑	1	1	0	2	0.5
大群	1	1	0	2	0.5
大片	0	1	1	2	0.5
大浪	1	0	1	2	0.5
大法	1	0	1	2	0.5
大楼	0	1	1	2	0.5
大早	1	1	0	2	0.5
大成	1	1	0	2	0.5
大幅度	1	0	1	2	0.5
大宗	1	1	0	2	0.5
大学毕业	1	0	1	2	0.5
大大降低	1	1	0	2	0.5
大型	0	1	1	2	0.5
大团	1	1	0	2	0.5
大叫	1	1	0	2	0.5
大厦	0	1	1	2	0.5
大功	1	1	0	2	0.5
大佬	1	1	0	2	0.5
大伙	1	0	1	2	0.5
夜班	0	1	1	2	0.5
多长	1	0	1	2	0.5
多款	1	0	1	2	0.5
多样	1	0	1	2	0.5
多日	0	1	1	2	0.5
多家	0	1	1	2	0.5
多吨	0	1	1	2	0.5
外部	1	1	0	2	0.5
外壳	1	1	0	2	0.5
外力	1	0	1	2	0.5
复仇	1	0	1	2	0.5
备用机	1	0	1	2	0.5
备用	1	0	1	2	0.5
备份	1	0	1	2	0.5
处女	0	1	1	2	0.5
处处	1	1	0	2	0.5
处于	1	1	0	2	0.5
壳子	1	1	0	2	0.5
增援	1	1	0	2	0.5
塔尔	1	0	1	2	0.5
堕胎	1	1	0	2	0.5
堆积	0	1	1	2	0.5
堆	0	1	1	2	0.5
基本一致	1	0	1	2	0.5
基斯坦	0	1	1	2	0.5
基斯	0	1	1	2	0.5
基因	1	1	0	2	0.5
基于	1	1	0	2	0.5
域	0	1	1	2	0.5
城市道路	0	1	1	2	0.5
城市规划	0	1	1	2	0.5
埃及	1	0	1	2	0.5
坨	0	1	1	2	0.5
坦白	1	1	0	2	0.5
坦克	1	1	0	2	0.5
坐月子	1	0	1	2	0.5
坐地	0	1	1	2	0.5
坐在	1	1	0	2	0.5
坏事	1	0	1	2	0.5
场合	1	1	0	2	0.5
地上	1	1	0	2	0.5
圈	0	1	1	2	0.5
圆角	1	1	0	2	0.5
圆润	1	0	1	2	0.5
国际化	0	1	1	2	0.5
国家统计局	1	0	1	2	0.5
国安	0	1	1	2	0.5
国务卿	1	0	1	2	0.5
国力	1	1	0	2	0.5
围墙	1	1	0	2	0.5
困	1	0	1	2	0.5
园	1	0	1	2	0.5
因涉嫌	1	0	1	2	0.5
因噎废食	0	1	1	2	0.5
回顾	1	1	0	2	0.5
回不去	1	1	0	2	0.5
四种	0	1	1	2	0.5
四家	1	0	1	2	0.5
四天	1	1	0	2	0.5
四分五裂	0	1	1	2	0.5
四分五	0	1	1	2	0.5
嚷嚷	1	1	0	2	0.5
嘴里	1	0	1	2	0.5
嘲讽	1	1	0	2	0.5
嘉	0	1	1	2	0.5
喧天	1	0	1	2	0.5
喧哗	1	1	0	2	0.5
喜悦	1	0	1	2	0.5
善	0	1	1	2	0.5
啸	0	1	1	2	0.5
啥意思	1	0	1	2	0.5
啤酒	1	0	1	2	0.5
商家	1	0	1	2	0.5
唯	1	0	1	2	0.5
唤醒	1	1	0	2	0.5
唤起	1	1	0	2	0.5
唐人街	1	0	1	2	0.5
哥们	1	1	0	2	0.5
哗啦	1	1	0	2	0.5
哗众取宠	1	0	1	2	0.5
哗众	1	0	1	2	0.5
响应号召	1	0	1	2	0.5
哈市	0	1	1	2	0.5
哇	1	0	1	2	0.5
咬	0	1	1	2	0.5
咨询电话	1	1	0	2	0.5
和尚	1	1	0	2	0.5
咄咄	0	1	1	2	0.5
命名	1	0	1	2	0.5
呼啸而过	1	1	0	2	0.5
呼啸	1	1	0	2	0.5
呸	1	0	1	2	0.5
周年	1	0	1	2	0.5
告	1	1	0	2	0.5
呆	1	1	0	2	0.5
听闻	0	1	1	2	0.5
听话	1	1	0	2	0.5
听懂	1	0	1	2	0.5
向来	1	1	0	2	0.5
同谋	1	1	0	2	0.5
同盟	1	1	0	2	0.5
同一个	0	1	1	2	0.5
合家欢乐	1	1	0	2	0.5
合家欢	1	1	0	2	0.5
各派	1	1	0	2	0.5
各家	1	1	0	2	0.5
吃香	1	1	0	2	0.5
吃火锅	1	0	1	2	0.5
右手	1	0	1	2	0.5
可取	0	1	1	2	0.5
叫苦	1	0	1	2	0.5
另类	0	1	1	2	0.5
口口声声	1	1	0	2	0.5
口口	1	1	0	2	0.5
变淡	0	1	1	2	0.5
取缔	1	1	0	2	0.5
取宠	1	0	1	2	0.5
叔	0	1	1	2	0.5
发言权	1	0	1	2	0.5
发烧	1	1	0	2	0.5
发挥	1	1	0	2	0.5
发工资	1	1	0	2	0.5
发动战争	1	1	0	2	0.5
反应速度	1	0	1	2	0.5
反对者	1	0	1	2	0.5
反响	0	1	1	2	0.5
反倒	1	1	0	2	0.5
双重	1	1	0	2	0.5
友谊	1	1	0	2	0.5
友人	1	1	0	2	0.5
参数	1	1	0	2	0.5
厦门	0	1	1	2	0.5
厚非	1	1	0	2	0.5
厕所	1	0	1	2	0.5
历来	1	1	0	2	0.5
历史悠久	0	1	1	2	0.5
卷入	1	0	1	2	0.5
卵管	1	0	1	2	0.5
危险性	1	1	0	2	0.5
印证	1	1	0	2	0.5
印	1	1	0	2	0.5
卫队	0	1	1	2	0.5
卫士	1	1	0	2	0.5
卫国	1	0	1	2	0.5
卡拉	0	1	1	2	0.5
卡扎菲	1	1	0	2	0.5
博士	1	1	0	2	0.5
博取	1	0	1	2	0.5
南昌	1	1	0	2	0.5
南方	1	0	1	2	0.5
南宁	1	1	0	2	0.5
卖掉	0	1	1	2	0.5
协商	1	0	1	2	0.5
协	0	1	1	2	0.5
华大	1	1	0	2	0.5
半岛	1	1	0	2	0.5
千金	1	1	0	2	0.5
千百	0	1	1	2	0.5
十多万	1	0	1	2	0.5
十五天	1	1	0	2	0.5
十二点	1	1	0	2	0.5
十二	1	1	0	2	0.5
十个	1	1	0	2	0.5
十一	1	0	1	2	0.5
包车	0	1	1	2	0.5
包子	1	0	1	2	0.5
包围	1	0	1	2	0.5
包含	0	1	1	2	0.5
勿	1	0	1	2	0.5
勾搭	1	1	0	2	0.5
勤劳	1	0	1	2	0.5
勇敢	1	0	1	2	0.5
动用	0	1	1	2	0.5
动手	1	1	0	2	0.5
务必	1	1	0	2	0.5
务工人员	0	1	1	2	0.5
务工	0	1	1	2	0.5
加装	0	1	1	2	0.5
加倍	1	0	1	2	0.5
办事处	1	1	0	2	0.5
力气	0	1	1	2	0.5
剪	1	0	1	2	0.5
剥离	1	1	0	2	0.5
前沿	1	0	1	2	0.5
前夕	1	1	0	2	0.5
前任	1	0	1	2	0.5
刻起	1	1	0	2	0.5
刺眼	1	1	0	2	0.5
制订	1	1	0	2	0.5
利民	1	0	1	2	0.5
利人	1	1	0	2	0.5
初恋	1	1	0	2	0.5
初三	1	1	0	2	0.5
列车	0	1	1	2	0.5
列入	1	0	1	2	0.5
划算	1	1	0	2	0.5
切换	1	0	1	2	0.5
分局	1	0	1	2	0.5
刀	1	1	0	2	0.5
出面	1	1	0	2	0.5
出过	1	1	0	2	0.5
出路	0	1	1	2	0.5
出示	0	1	1	2	0.5
出息	1	1	0	2	0.5
出头	1	0	1	2	0.5
出卖	0	1	1	2	0.5
出入	1	0	1	2	0.5
凯末尔	1	1	0	2	0.5
凯旋	1	1	0	2	0.5
凤凰网	1	1	0	2	0.5
凡	1	1	0	2	0.5
几百人	1	1	0	2	0.5
几家	1	1	0	2	0.5
几句	1	1	0	2	0.5
准生证	1	0	1	2	0.5
冷藏	0	1	1	2	0.5
冲着	1	0	1	2	0.5
冲动	1	1	0	2	0.5
冰冻三尺非一日之寒	0	1	1	2	0.5
冬季	1	1	0	2	0.5
冬天	1	1	0	2	0.5
农民工	0	1	1	2	0.5
军事冲突	0	1	1	2	0.5
冒险	1	0	1	2	0.5
再有	1	0	1	2	0.5
兼具	1	1	0	2	0.5
养生	1	0	1	2	0.5
养儿	1	1	0	2	0.5
具备	0	1	1	2	0.5
具	1	1	0	2	0.5
其他人	1	1	0	2	0.5
关外	0	1	1	2	0.5
共用	0	1	1	2	0.5
共有	1	0	1	2	0.5
六月	1	1	0	2	0.5
六个	0	1	1	2	0.5
公明	1	0	1	2	0.5
公害	1	1	0	2	0.5
公园	1	0	1	2	0.5
公举	1	0	1	2	0.5
八卦	1	0	1	2	0.5
全区	1	0	1	2	0.5
入土	1	0	1	2	0.5
入侵	1	1	0	2	0.5
兜售	0	1	1	2	0.5
克里姆林宫	1	0	1	2	0.5
克里姆林	1	0	1	2	0.5
克里姆	1	0	1	2	0.5
克服	1	1	0	2	0.5
克星	1	0	1	2	0.5
克尔	0	1	1	2	0.5
光辉	1	1	0	2	0.5
光荣	1	1	0	2	0.5
先后	0	1	1	2	0.5
傻傻	0	1	1	2	0.5
做人	1	1	0	2	0.5
假话	1	1	0	2	0.5
值班	1	1	0	2	0.5
借着	1	0	1	2	0.5
倒把	1	0	1	2	0.5
俱全	1	1	0	2	0.5
修订	1	0	1	2	0.5
修	1	1	0	2	0.5
信服	1	1	0	2	0.5
保险公司	1	0	1	2	0.5
保护费	1	1	0	2	0.5
保卫者	1	1	0	2	0.5
保佑	0	1	1	2	0.5
俘虏	1	1	0	2	0.5
促销	0	1	1	2	0.5
便携	1	1	0	2	0.5
侵	1	0	1	2	0.5
侮辱	1	1	0	2	0.5
例子	1	0	1	2	0.5
侄子	1	0	1	2	0.5
你老	0	1	1	2	0.5
作家	1	1	0	2	0.5
作出	0	1	1	2	0.5
余名	1	0	1	2	0.5
何去何从	1	1	0	2	0.5
何以堪	0	1	1	2	0.5
体重	1	0	1	2	0.5
体力	1	1	0	2	0.5
住院	1	0	1	2	0.5
低迷	1	0	1	2	0.5
低下	0	1	1	2	0.5
伪	1	1	0	2	0.5
伦理	0	1	1	2	0.5
伟	1	1	0	2	0.5
伞	1	0	1	2	0.5
会面	0	1	1	2	0.5
会议	1	0	1	2	0.5
会上	1	0	1	2	0.5
伙子	1	1	0	2	0.5
优质	0	1	1	2	0.5
优美	0	1	1	2	0.5
众所周知	1	0	1	2	0.5
伏	0	1	1	2	0.5
价廉物美	0	1	1	2	0.5
价廉	0	1	1	2	0.5
仪式	1	1	0	2	0.5
以外	1	1	0	2	0.5
以免	0	1	1	2	0.5
以便	1	0	1	2	0.5
代言	1	1	0	2	0.5
代步车	0	1	1	2	0.5
代尔	0	1	1	2	0.5
代代	1	1	0	2	0.5
仓	1	1	0	2	0.5
从未	1	0	1	2	0.5
介意	1	0	1	2	0.5
今天下午	1	0	1	2	0.5
仇恨	1	0	1	2	0.5
仁义	1	1	0	2	0.5
人间	1	1	0	2	0.5
人身	1	1	0	2	0.5
人数	0	1	1	2	0.5
人情世故	0	1	1	2	0.5
人品	1	1	0	2	0.5
人命	1	1	0	2	0.5
人人有责	1	1	0	2	0.5
亲爱	1	1	0	2	0.5
亮灯	1	0	1	2	0.5
亮度	1	1	0	2	0.5
享	1	0	1	2	0.5
产物	1	1	0	2	0.5
产权	0	1	1	2	0.5
交通部门	0	1	1	2	0.5
交通部	0	1	1	2	0.5
交通状况	1	1	0	2	0.5
交替	1	1	0	2	0.5
交换	1	1	0	2	0.5
五天	1	1	0	2	0.5
五大	1	1	0	2	0.5
五十多	1	0	1	2	0.5
五六	1	0	1	2	0.5
五一节	1	1	0	2	0.5
互换	1	1	0	2	0.5
二点	1	1	0	2	0.5
二来	1	1	0	2	0.5
二代	1	0	1	2	0.5
二三	0	1	1	2	0.5
事项	1	0	1	2	0.5
争执	0	1	1	2	0.5
争	0	1	1	2	0.5
乱世	1	0	1	2	0.5
买点	1	0	1	2	0.5
买来	0	1	1	2	0.5
买手机	1	0	1	2	0.5
买手	1	0	1	2	0.5
买下	1	1	0	2	0.5
乡村	1	1	0	2	0.5
乐见	0	1	1	2	0.5
乏力	0	1	1	2	0.5
之内	0	1	1	2	0.5
义务教育	0	1	1	2	0.5
久违	1	1	0	2	0.5
举措	1	0	1	2	0.5
主权国家	1	1	0	2	0.5
主权国	1	1	0	2	0.5
主义者	0	1	1	2	0.5
为的是	0	1	1	2	0.5
为名	0	1	1	2	0.5
中途	1	1	0	2	0.5
中药	1	1	0	2	0.5
中石化	1	1	0	2	0.5
中石	1	1	0	2	0.5
中度	1	0	1	2	0.5
中山	1	0	1	2	0.5
中将	1	0	1	2	0.5
中央电视台	1	1	0	2	0.5
中国网民	1	1	0	2	0.5
中医	0	1	1	2	0.5
个人感觉	1	0	1	2	0.5
严格管理	1	0	1	2	0.5
两面	1	1	0	2	0.5
两节课	1	0	1	2	0.5
两节	1	0	1	2	0.5
两者	1	1	0	2	0.5
两种	0	1	1	2	0.5
两条	1	1	0	2	0.5
丢人	1	1	0	2	0.5
丝毫	0	1	1	2	0.5
东欧	1	0	1	2	0.5
东台	1	1	0	2	0.5
业界	0	1	1	2	0.5
业生	0	1	1	2	0.5
业务	1	0	1	2	0.5
世故	0	1	1	2	0.5
世上	0	1	1	2	0.5
专车	1	1	0	2	0.5
专卖店	0	1	1	2	0.5
专卖	0	1	1	2	0.5
不量力	1	0	1	2	0.5
不许百姓点灯	1	1	0	2	0.5
不管怎样	1	1	0	2	0.5
不管怎么	1	0	1	2	0.5
不理	1	0	1	2	0.5
不慎	0	1	1	2	0.5
不定	1	1	0	2	0.5
不大	1	1	0	2	0.5
不合理	1	1	0	2	0.5
不可避免	1	0	1	2	0.5
不利于	1	1	0	2	0.5
不划算	1	1	0	2	0.5
不出意外	1	0	1	2	0.5
不久前	1	0	1	2	0.5
下车	1	0	1	2	0.5
下沙	1	1	0	2	0.5
下水	1	1	0	2	0.5
下文	1	0	1	2	0.5
下放	1	0	1	2	0.5
下周	1	0	1	2	0.5
上网	0	1	1	2	0.5
上游	0	1	1	2	0.5
上天	1	1	0	2	0.5
上台	1	1	0	2	0.5
上千	0	1	1	2	0.5
三点	1	0	1	2	0.5
三期	1	0	1	2	0.5
三十年	0	1	1	2	0.5
三分之一	1	1	0	2	0.5
三位	0	1	1	2	0.5
三五年	1	1	0	2	0.5
三五	1	1	0	2	0.5
万能	0	1	1	2	0.5
万块	1	0	1	2	0.5
万分	1	1	0	2	0.5
七十万	0	1	1	2	0.5
七八	1	1	0	2	0.5
一遍	0	1	1	2	0.5
一辈子	1	1	0	2	0.5
一节	1	1	0	2	0.5
一气	1	1	0	2	0.5
一月	1	0	1	2	0.5
一座	0	1	1	2	0.5
一并	1	1	0	2	0.5
一带	1	1	0	2	0.5
一大早	1	1	0	2	0.5
一圈	1	0	1	2	0.5
一回	1	0	1	2	0.5
一向	0	1	1	2	0.5
一同	1	0	1	2	0.5
一口	0	1	1	2	0.5
一分	1	0	1	2	0.5
一代代	1	1	0	2	0.5
一个个	1	1	0	2	0.5
一两年	1	1	0	2	0.5
一不小心	1	1	0	2	0.5
www	1	1	0	2	0.5
store	0	1	1	2	0.5
sp	0	1	1	2	0.5
sns	1	0	1	2	0.5
siri	1	1	0	2	0.5
sim	1	0	1	2	0.5
say	1	1	0	2	0.5
s7edge	0	1	1	2	0.5
s400	1	1	0	2	0.5
rq0bcjt	1	0	1	2	0.5
retina	1	0	1	2	0.5
ram	1	0	1	2	0.5
photos	1	1	0	2	0.5
or	1	0	1	2	0.5
lol	1	0	1	2	0.5
iss	1	1	0	2	0.5
iphones	0	1	1	2	0.5
iphone5c	0	1	1	2	0.5
ip	1	1	0	2	0.5
ios6	1	0	1	2	0.5
ing	0	1	1	2	0.5
id	0	1	1	2	0.5
i5	1	1	0	2	0.5
home	1	1	0	2	0.5
flash	1	0	1	2	0.5
duang	1	0	1	2	0.5
diy	1	0	1	2	0.5
cia	1	0	1	2	0.5
boy	1	0	1	2	0.5
aqi	0	1	1	2	0.5
88	1	0	1	2	0.5
深圳	123	221	102	446	0.495515695067
没有	100	146	49	295	0.494915254237
们	48	32	17	97	0.494845360825
老	23	32	10	65	0.492307692308
以	21	31	11	63	0.492063492063
表示	30	11	20	61	0.491803278689
怀	30	1	30	61	0.491803278689
一定	27	20	8	55	0.490909090909
死	23	26	4	53	0.490566037736
为	59	99	44	202	0.490099009901
必须	24	16	9	49	0.489795918367
还有	47	31	18	96	0.489583333333
整治	23	10	14	47	0.489361702128
这些	26	44	20	90	0.488888888889
严重	16	22	7	45	0.488888888889
视频	11	11	21	43	0.488372093023
考虑	13	20	8	41	0.487804878049
全国	11	19	9	39	0.487179487179
我们	82	123	48	253	0.486166007905
问题	44	68	28	140	0.485714285714
网	10	17	8	35	0.485714285714
炮声	13	17	5	35	0.485714285714
本来	17	17	1	35	0.485714285714
一天	17	10	8	35	0.485714285714
会	103	159	66	328	0.484756097561
时候	77	69	13	159	0.48427672956
秒	10	6	15	31	0.483870967742
炸	14	15	2	31	0.483870967742
平安	15	14	2	31	0.483870967742
功能	10	15	6	31	0.483870967742
所谓	7	14	8	29	0.48275862069
味	27	17	12	56	0.482142857143
非常	13	6	8	27	0.481481481481
除了	13	8	6	27	0.481481481481
沙特	13	7	7	27	0.481481481481
总	13	9	5	27	0.481481481481
导致	7	13	7	27	0.481481481481
哪	13	10	4	27	0.481481481481
去年	4	13	10	27	0.481481481481
历史	8	13	6	27	0.481481481481
出台	7	13	7	27	0.481481481481
几年	12	13	2	27	0.481481481481
事情	7	13	7	27	0.481481481481
不用	12	13	2	27	0.481481481481
管	12	9	4	25	0.48
正常	5	8	12	25	0.48
手	12	8	5	25	0.48
尤其	12	11	2	25	0.48
天天	12	10	3	25	0.48
国内	12	7	6	25	0.48
养	7	12	6	25	0.48
发布	16	22	35	73	0.479452054795
一年	23	8	17	48	0.479166666667
又	78	114	46	238	0.478991596639
一直	34	22	15	71	0.478873239437
父母	22	18	6	46	0.478260869565
规定	7	11	5	23	0.478260869565
红灯	11	9	3	23	0.478260869565
如今	8	11	4	23	0.478260869565
制定	1	11	11	23	0.478260869565
初一	9	11	3	23	0.478260869565
体验	11	6	6	23	0.478260869565
开放	103	150	61	314	0.477707006369
就是	102	128	38	268	0.477611940299
才	63	48	21	132	0.477272727273
这样	38	52	19	109	0.477064220183
国家	74	101	37	212	0.47641509434
飞机	10	10	1	21	0.47619047619
理解	10	6	5	21	0.47619047619
爆	8	10	3	21	0.47619047619
比如	9	10	2	21	0.47619047619
是因为	10	10	1	21	0.47619047619
敢	9	10	2	21	0.47619047619
国际	10	9	2	21	0.47619047619
不多	9	10	2	21	0.47619047619
不可	10	5	6	21	0.47619047619
一句	10	7	4	21	0.47619047619
为什么	33	48	20	101	0.475247524752
着	86	66	29	181	0.475138121547
黄	12	19	9	40	0.475
保护	13	19	8	40	0.475
卖	17	28	14	59	0.474576271186
还	136	176	59	371	0.474393530997
多	107	148	57	312	0.474358974359
地方	17	27	13	57	0.473684210526
遵守	9	8	2	19	0.473684210526
达到	5	9	5	19	0.473684210526
许多	9	5	5	19	0.473684210526
规则	9	9	1	19	0.473684210526
累	6	9	4	19	0.473684210526
更加	5	9	5	19	0.473684210526
提醒	9	8	2	19	0.473684210526
叙	9	9	1	19	0.473684210526
刚刚	9	7	3	19	0.473684210526
不敢	8	9	2	19	0.473684210526
一部	9	7	3	19	0.473684210526
这种	27	35	12	74	0.472972972973
这么	33	51	24	108	0.472222222222
直接	17	12	7	36	0.472222222222
环卫	10	17	9	36	0.472222222222
毕竟	17	11	8	36	0.472222222222
今天	66	52	22	140	0.471428571429
打	31	41	15	87	0.471264367816
配置	24	18	9	51	0.470588235294
连	10	16	8	34	0.470588235294
行为	11	16	7	34	0.470588235294
搞	12	16	6	34	0.470588235294
非	7	8	2	17	0.470588235294
针对	8	3	6	17	0.470588235294
转发	4	8	5	17	0.470588235294
调查	5	4	8	17	0.470588235294
规	5	4	8	17	0.470588235294
行驶	8	5	4	17	0.470588235294
欢迎	8	2	7	17	0.470588235294
掉	6	8	3	17	0.470588235294
手感	8	6	3	17	0.470588235294
当地	3	8	6	17	0.470588235294
宣布	8	3	6	17	0.470588235294
定	7	2	8	17	0.470588235294
好处	7	8	2	17	0.470588235294
各	8	5	4	17	0.470588235294
今日	6	3	8	17	0.470588235294
世界	45	32	19	96	0.46875
机动车	15	8	9	32	0.46875
完全	15	15	2	32	0.46875
媒体	9	15	8	32	0.46875
三	15	14	3	32	0.46875
他们	42	44	8	94	0.468085106383
交通	31	43	18	92	0.467391304348
之	26	42	22	90	0.466666666667
除夕	21	17	7	45	0.466666666667
带来	9	14	7	30	0.466666666667
主要	8	14	8	30	0.466666666667
不如	14	12	4	30	0.466666666667
黑	7	5	3	15	0.466666666667
需求	7	3	5	15	0.466666666667
身边	7	5	3	15	0.466666666667
舆论	2	7	6	15	0.466666666667
而已	7	6	2	15	0.466666666667
约	7	3	5	15	0.466666666667
电单车	7	7	1	15	0.466666666667
特	7	6	2	15	0.466666666667
照片	2	6	7	15	0.466666666667
武器	6	7	2	15	0.466666666667
待	7	7	1	15	0.466666666667
强烈	5	7	3	15	0.466666666667
强大	7	2	6	15	0.466666666667
实行	6	7	2	15	0.466666666667
在家	5	7	3	15	0.466666666667
唯一	7	5	3	15	0.466666666667
即使	4	7	4	15	0.466666666667
占	6	7	2	15	0.466666666667
入手	7	4	4	15	0.466666666667
仅	2	7	6	15	0.466666666667
人行	4	4	7	15	0.466666666667
丢	5	7	3	15	0.466666666667
一半	5	7	3	15	0.466666666667
集中	5	10	13	28	0.464285714286
要求	9	6	13	28	0.464285714286
自由	6	13	9	28	0.464285714286
真正	11	13	4	28	0.464285714286
全	11	13	4	28	0.464285714286
之后	9	13	6	28	0.464285714286
反恐	29	32	8	69	0.463768115942
妈	17	19	5	41	0.463414634146
俄	21	25	8	54	0.462962962963
给	109	91	36	236	0.46186440678
摩托	42	30	19	91	0.461538461538
屏幕	36	27	15	78	0.461538461538
新年	24	21	7	52	0.461538461538
玩	18	14	7	39	0.461538461538
内	18	9	12	39	0.461538461538
人家	18	14	7	39	0.461538461538
轰炸	12	12	2	26	0.461538461538
的话	7	12	7	26	0.461538461538
来看	12	6	8	26	0.461538461538
娃	12	10	4	26	0.461538461538
响应	11	12	3	26	0.461538461538
北约	12	10	4	26	0.461538461538
全世界	12	10	4	26	0.461538461538
骂	6	5	2	13	0.461538461538
达	2	6	5	13	0.461538461538
超过	4	3	6	13	0.461538461538
至少	4	6	3	13	0.461538461538
编	6	3	4	13	0.461538461538
矛盾	4	6	3	13	0.461538461538
爹	6	6	1	13	0.461538461538
污染空气	5	6	2	13	0.461538461538
永远	3	4	6	13	0.461538461538
成功	6	3	4	13	0.461538461538
意味	6	1	6	13	0.461538461538
回来	6	2	5	13	0.461538461538
区域	6	4	3	13	0.461538461538
内部	3	6	4	13	0.461538461538
关键	6	4	3	13	0.461538461538
克兰	6	6	1	13	0.461538461538
乌克兰	6	6	1	13	0.461538461538
两天	5	6	2	13	0.461538461538
一方	4	6	3	13	0.461538461538
买	63	87	39	189	0.460317460317
我	331	262	127	720	0.459722222222
评论	17	13	7	37	0.459459459459
想要	13	7	17	37	0.459459459459
好	140	113	52	305	0.459016393443
虽然	19	28	14	61	0.459016393443
可以	99	87	30	216	0.458333333333
那个	11	7	6	24	0.458333333333
而是	11	10	3	24	0.458333333333
咋	11	10	3	24	0.458333333333
只要	9	11	4	24	0.458333333333
内存	7	11	6	24	0.458333333333
真是	32	28	10	70	0.457142857143
生二胎	32	24	14	70	0.457142857143
网友	8	11	16	35	0.457142857143
放炮	13	16	6	35	0.457142857143
小孩	16	15	4	35	0.457142857143
啊	91	100	28	219	0.456621004566
要	143	178	69	390	0.45641025641
用	70	88	35	193	0.455958549223
就	236	289	109	634	0.455835962145
月	55	23	43	121	0.454545454545
所以	37	45	17	99	0.454545454545
部分	20	17	7	44	0.454545454545
话	15	12	6	33	0.454545454545
系统	15	14	4	33	0.454545454545
讨论	4	10	8	22	0.454545454545
挂	10	9	3	22	0.454545454545
参与	10	10	2	22	0.454545454545
全部	7	10	5	22	0.454545454545
元宵	10	7	5	22	0.454545454545
距离	4	5	2	11	0.454545454545
精彩	4	2	5	11	0.454545454545
空间	3	5	3	11	0.454545454545
空袭	5	5	1	11	0.454545454545
穷	4	5	2	11	0.454545454545
现场	5	1	5	11	0.454545454545
灰	2	5	4	11	0.454545454545
武装	5	4	2	11	0.454545454545
槽	5	4	2	11	0.454545454545
查处	5	3	3	11	0.454545454545
文	3	3	5	11	0.454545454545
拥有	5	3	3	11	0.454545454545
手里	5	5	1	11	0.454545454545
总是	4	5	2	11	0.454545454545
必然	3	5	3	11	0.454545454545
很大	1	5	5	11	0.454545454545
年轻人	5	3	3	11	0.454545454545
属于	3	3	5	11	0.454545454545
小学	4	5	2	11	0.454545454545
婚	1	5	5	11	0.454545454545
妹	4	5	2	11	0.454545454545
大爷	5	4	2	11	0.454545454545
城	5	3	3	11	0.454545454545
埃	5	5	1	11	0.454545454545
四	5	5	1	11	0.454545454545
同	5	4	2	11	0.454545454545
可惜	2	4	5	11	0.454545454545
句	3	5	3	11	0.454545454545
参加	3	3	5	11	0.454545454545
剩下	3	5	3	11	0.454545454545
凤凰	3	5	3	11	0.454545454545
先生	1	5	5	11	0.454545454545
俗	4	5	2	11	0.454545454545
真	45	49	14	108	0.453703703704
电动车	57	73	31	161	0.453416149068
但是	49	58	21	128	0.453125
却	23	29	12	64	0.453125
事	53	43	21	117	0.452991452991
去	72	86	32	190	0.452631578947
比	42	31	20	93	0.451612903226
早	14	10	7	31	0.451612903226
愿意	8	14	9	31	0.451612903226
岁	14	11	6	31	0.451612903226
儿子	14	8	9	31	0.451612903226
更	48	65	31	144	0.451388888889
个	98	116	43	257	0.451361867704
他	51	34	28	113	0.451327433628
罗斯	74	73	17	164	0.451219512195
俄罗斯	74	73	17	164	0.451219512195
并	35	46	21	102	0.450980392157
所有	23	18	10	51	0.450980392157
啥	16	23	12	51	0.450980392157
过	99	113	39	251	0.450199203187
美	18	12	10	40	0.45
速度	9	7	4	20	0.45
未	7	9	4	20	0.45
意义	9	7	4	20	0.45
学生	8	9	3	20	0.45
好像	5	9	6	20	0.45
因此	6	9	5	20	0.45
告诉	9	6	5	20	0.45
以来	5	6	9	20	0.45
三十	9	8	3	20	0.45
不是	91	103	35	229	0.449781659389
生	65	85	39	189	0.449735449735
一个	147	128	52	327	0.449541284404
后	45	66	36	147	0.448979591837
叙利亚	66	57	24	147	0.448979591837
利亚	66	57	24	147	0.448979591837
来	127	98	58	283	0.448763250883
近日	4	12	13	29	0.448275862069
理由	13	13	3	29	0.448275862069
最好	13	11	5	29	0.448275862069
够	13	11	5	29	0.448275862069
现在	98	103	29	230	0.447826086957
其实	24	30	13	67	0.44776119403
对	119	94	53	266	0.447368421053
也	261	214	109	584	0.446917808219
最	67	39	44	150	0.446666666667
前	29	24	12	65	0.446153846154
不会	33	45	23	101	0.445544554455
真的	39	44	16	99	0.444444444444
对于	24	17	13	54	0.444444444444
比较	16	11	9	36	0.444444444444
发生	6	16	14	36	0.444444444444
公司	9	11	16	36	0.444444444444
突然	12	10	5	27	0.444444444444
女	7	12	8	27	0.444444444444
图	12	8	7	27	0.444444444444
听	12	10	5	27	0.444444444444
事儿	12	11	4	27	0.444444444444
整个	8	6	4	18	0.444444444444
开车	6	8	4	18	0.444444444444
加	8	3	7	18	0.444444444444
不住	8	5	5	18	0.444444444444
门	3	4	2	9	0.444444444444
轻	2	4	3	9	0.444444444444
证明	2	3	4	9	0.444444444444
角度	3	4	2	9	0.444444444444
群	4	3	2	9	0.444444444444
网站	1	4	4	9	0.444444444444
综合	2	3	4	9	0.444444444444
百年	3	4	2	9	0.444444444444
男人	1	4	4	9	0.444444444444
爸	3	2	4	9	0.444444444444
浓	4	4	1	9	0.444444444444
民	4	4	1	9	0.444444444444
明	3	4	2	9	0.444444444444
收拾	4	4	1	9	0.444444444444
提示	4	3	2	9	0.444444444444
感	2	3	4	9	0.444444444444
心情	3	4	2	9	0.444444444444
彻底	4	3	2	9	0.444444444444
建立	4	4	1	9	0.444444444444
广播	4	3	2	9	0.444444444444
年龄	3	4	2	9	0.444444444444
年三十	3	4	2	9	0.444444444444
山	4	2	3	9	0.444444444444
屎	4	4	1	9	0.444444444444
尔多	4	4	1	9	0.444444444444
小区	4	1	4	9	0.444444444444
完善	2	4	3	9	0.444444444444
始终	4	4	1	9	0.444444444444
可怜	2	4	3	9	0.444444444444
口	4	3	2	9	0.444444444444
危机	3	2	4	9	0.444444444444
半	1	4	4	9	0.444444444444
冲突	2	4	3	9	0.444444444444
保证	3	4	2	9	0.444444444444
件	4	4	1	9	0.444444444444
仍然	4	1	4	9	0.444444444444
产业	3	2	4	9	0.444444444444
于是	3	4	2	9	0.444444444444
之类	3	4	2	9	0.444444444444
一边	2	4	3	9	0.444444444444
一堆	4	2	3	9	0.444444444444
iphone6s	3	2	4	9	0.444444444444
人	181	214	88	483	0.443064182195
能	87	99	38	224	0.441964285714
再	53	48	19	120	0.441666666667
点	36	49	26	111	0.441441441441
感觉	45	40	17	102	0.441176470588
不要	35	41	17	93	0.440860215054
无	20	22	8	50	0.44
像	22	18	10	50	0.44
睡	9	11	5	25	0.44
气氛	11	7	7	25	0.44
家里	10	11	4	25	0.44
国产	11	11	3	25	0.44
因	6	11	8	25	0.44
很多	50	42	22	114	0.438596491228
知道	48	53	20	121	0.438016528926
第二	11	7	14	32	0.4375
环卫工	9	14	9	32	0.4375
寸	14	9	9	32	0.4375
销售	3	7	6	16	0.4375
素质	7	7	2	16	0.4375
电话	7	6	3	16	0.4375
曾	4	7	5	16	0.4375
晚	6	3	7	16	0.4375
打算	5	7	4	16	0.4375
意见	3	7	6	16	0.4375
天下	6	7	3	16	0.4375
俩	7	5	4	16	0.4375
一场	4	7	5	16	0.4375
plus	7	3	6	16	0.4375
大	136	108	67	311	0.43729903537
二胎	254	195	132	581	0.437177280551
从	59	48	28	135	0.437037037037
二	22	24	9	55	0.436363636364
一下	21	24	10	55	0.436363636364
情况	15	7	17	39	0.435897435897
乱	17	14	8	39	0.435897435897
多少	27	23	12	62	0.435483870968
都	257	284	112	653	0.434915773354
拿	28	30	11	69	0.434782608696
发	20	16	10	46	0.434782608696
分享	20	16	10	46	0.434782608696
积极	8	10	5	23	0.434782608696
甚至	10	6	7	23	0.434782608696
气质	5	10	8	23	0.434782608696
大国	9	10	4	23	0.434782608696
及	10	10	3	23	0.434782608696
gb	9	4	10	23	0.434782608696
因为	62	60	21	143	0.433566433566
进入	13	8	9	30	0.433333333333
报道	8	9	13	30	0.433333333333
看	93	69	53	215	0.432558139535
继续	16	14	7	37	0.432432432432
怀孕	16	8	13	37	0.432432432432
不到	16	15	6	37	0.432432432432
各种	19	17	8	44	0.431818181818
http	12	13	19	44	0.431818181818
动车	63	75	36	174	0.431034482759
带	25	24	9	58	0.431034482759
以后	25	24	9	58	0.431034482759
没	110	115	42	267	0.430711610487
出	38	43	19	100	0.43
而	51	54	21	126	0.428571428571
成	20	24	12	56	0.428571428571
关注	12	18	12	42	0.428571428571
治理	10	12	6	28	0.428571428571
最大	11	12	5	28	0.428571428571
如	7	12	9	28	0.428571428571
超	5	7	9	21	0.428571428571
行业	8	9	4	21	0.428571428571
相信	7	9	5	21	0.428571428571
电视	9	8	4	21	0.428571428571
来自	9	6	6	21	0.428571428571
变	9	7	5	21	0.428571428571
依然	6	9	6	21	0.428571428571
不同	5	7	9	21	0.428571428571
马上	5	6	3	14	0.428571428571
米	5	6	3	14	0.428571428571
等等	6	4	4	14	0.428571428571
清楚	3	6	5	14	0.428571428571
欧洲	6	4	4	14	0.428571428571
某	6	4	4	14	0.428571428571
有关	4	6	4	14	0.428571428571
摄像头	6	2	6	14	0.428571428571
摄像	6	2	6	14	0.428571428571
拉克	5	3	6	14	0.428571428571
并且	5	6	3	14	0.428571428571
年初	5	6	3	14	0.428571428571
官	4	4	6	14	0.428571428571
好事	4	6	4	14	0.428571428571
坏	5	6	3	14	0.428571428571
反应	6	4	4	14	0.428571428571
包括	3	5	6	14	0.428571428571
凌晨	2	6	6	14	0.428571428571
共	5	3	6	14	0.428571428571
像头	6	2	6	14	0.428571428571
伊拉克	5	3	6	14	0.428571428571
伊拉	5	3	6	14	0.428571428571
事件	3	6	5	14	0.428571428571
主	4	6	4	14	0.428571428571
一切	6	6	2	14	0.428571428571
首日	3	2	2	7	0.428571428571
首先	2	3	2	7	0.428571428571
附近	1	3	3	7	0.428571428571
酒	3	3	1	7	0.428571428571
辞职	3	3	1	7	0.428571428571
车主	2	3	2	7	0.428571428571
评	2	2	3	7	0.428571428571
解释	3	2	2	7	0.428571428571
规模	3	2	2	7	0.428571428571
西	3	2	2	7	0.428571428571
表明	3	3	1	7	0.428571428571
血	3	2	2	7	0.428571428571
莫	2	2	3	7	0.428571428571
英雄	2	3	2	7	0.428571428571
育儿	3	3	1	7	0.428571428571
联合国	2	3	2	7	0.428571428571
聊	3	1	3	7	0.428571428571
紧张	3	2	2	7	0.428571428571
类似	1	3	3	7	0.428571428571
等待	3	1	3	7	0.428571428571
第一胎	2	3	2	7	0.428571428571
第一次	3	3	1	7	0.428571428571
竞争	3	3	1	7	0.428571428571
突破	1	3	3	7	0.428571428571
破五	3	2	2	7	0.428571428571
相同	2	2	3	7	0.428571428571
病	3	3	1	7	0.428571428571
玩意	3	3	1	7	0.428571428571
状况	3	3	1	7	0.428571428571
洗	3	3	1	7	0.428571428571
泛滥	3	3	1	7	0.428571428571
民警	2	3	2	7	0.428571428571
楼	2	3	2	7	0.428571428571
更新	2	3	2	7	0.428571428571
星	2	3	2	7	0.428571428571
方	2	3	2	7	0.428571428571
故意	2	3	2	7	0.428571428571
放心	3	3	1	7	0.428571428571
放在	3	3	1	7	0.428571428571
推动	2	2	3	7	0.428571428571
拿到	1	3	3	7	0.428571428571
抱怨	3	3	1	7	0.428571428571
打电话	3	2	2	7	0.428571428571
怪不得	3	1	3	7	0.428571428571
忍	3	1	3	7	0.428571428571
心理	2	3	2	7	0.428571428571
当今世界	2	3	2	7	0.428571428571
强行	3	3	1	7	0.428571428571
库尔德人	2	3	2	7	0.428571428571
帝国	2	3	2	7	0.428571428571
已有	3	3	1	7	0.428571428571
巨大	2	3	2	7	0.428571428571
尔	3	2	2	7	0.428571428571
少数	3	2	2	7	0.428571428571
对象	3	3	1	7	0.428571428571
坟场	2	3	2	7	0.428571428571
场面	3	3	1	7	0.428571428571
回答	3	1	3	7	0.428571428571
回去	3	3	1	7	0.428571428571
响起	3	3	1	7	0.428571428571
咯	2	3	2	7	0.428571428571
命	3	2	2	7	0.428571428571
双方	2	2	3	7	0.428571428571
博客	2	2	3	7	0.428571428571
单身	1	3	3	7	0.428571428571
北	1	3	3	7	0.428571428571
刷	2	2	3	7	0.428571428571
分别	2	3	2	7	0.428571428571
出手	3	3	1	7	0.428571428571
冒	2	2	3	7	0.428571428571
具体	2	3	2	7	0.428571428571
保	2	2	3	7	0.428571428571
作战	2	3	2	7	0.428571428571
以下	3	1	3	7	0.428571428571
今世	2	3	2	7	0.428571428571
什么样	3	3	1	7	0.428571428571
人权	3	3	1	7	0.428571428571
之外	2	2	3	7	0.428571428571
专项	2	3	2	7	0.428571428571
一致	3	2	2	7	0.428571428571
一只	3	2	2	7	0.428571428571
一个多	3	1	3	7	0.428571428571
phone	2	3	2	7	0.428571428571
孩子	63	76	39	178	0.426966292135
高	32	25	18	75	0.426666666667
出来	29	25	14	68	0.426470588235
博	19	23	12	54	0.425925925926
电动	71	85	44	200	0.425
家	9	14	10	33	0.424242424242
先	14	14	5	33	0.424242424242
产品	8	11	14	33	0.424242424242
这个	71	78	35	184	0.423913043478
该	25	20	14	59	0.423728813559
看来	11	9	6	26	0.423076923077
同时	7	11	8	26	0.423076923077
cn	11	15	19	45	0.422222222222
让	82	100	55	237	0.42194092827
第一	24	13	20	57	0.421052631579
节目	8	5	6	19	0.421052631579
消费	4	7	8	19	0.421052631579
回	8	6	5	19	0.421052631579
代表	8	7	4	19	0.421052631579
不该	4	7	8	19	0.421052631579
里	37	30	21	88	0.420454545455
快	21	16	13	50	0.42
向	18	21	11	50	0.42
款	13	9	9	31	0.41935483871
呀	13	10	8	31	0.41935483871
政策	82	93	47	222	0.418918918919
呢	72	70	30	172	0.418604651163
时	29	36	21	86	0.418604651163
鞭炮	250	251	100	601	0.417637271215
放鞭炮	250	251	100	601	0.417637271215
放鞭	250	251	100	601	0.417637271215
春节	249	250	100	599	0.417362270451
想	93	90	40	223	0.417040358744
什么	119	128	60	307	0.416938110749
说	132	140	64	336	0.416666666667
关系	20	18	10	48	0.416666666667
有些	13	15	8	36	0.416666666667
拘留	15	10	11	36	0.416666666667
记者	8	6	10	24	0.416666666667
此	9	5	10	24	0.416666666667
引起	6	8	10	24	0.416666666667
办法	9	10	5	24	0.416666666667
风险	4	5	3	12	0.416666666667
门口	4	5	3	12	0.416666666667
那种	5	3	4	12	0.416666666667
自从	4	3	5	12	0.416666666667
老师	4	5	3	12	0.416666666667
结	5	5	2	12	0.416666666667
科技	2	5	5	12	0.416666666667
研究	3	4	5	12	0.416666666667
深	3	5	4	12	0.416666666667
比亚	5	5	2	12	0.416666666667
曾经	5	3	4	12	0.416666666667
暂时	5	5	2	12	0.416666666667
无论	5	4	3	12	0.416666666667
担心	3	5	4	12	0.416666666667
房子	4	5	3	12	0.416666666667
懂	4	5	3	12	0.416666666667
怪	5	5	2	12	0.416666666667
往年	3	5	4	12	0.416666666667
常	5	4	3	12	0.416666666667
尔德	3	5	4	12	0.416666666667
家长	4	3	5	12	0.416666666667
宗教	4	5	3	12	0.416666666667
婆婆	5	3	4	12	0.416666666667
奶奶	5	5	2	12	0.416666666667
单	5	5	2	12	0.416666666667
军	4	5	3	12	0.416666666667
便	5	2	5	12	0.416666666667
举	5	3	4	12	0.416666666667
不止	5	5	2	12	0.416666666667
一般	5	5	2	12	0.416666666667
一台	5	3	4	12	0.416666666667
iphone5s	3	5	4	12	0.416666666667
新闻	19	24	15	58	0.413793103448
然而	7	10	12	29	0.413793103448
造成	19	19	8	46	0.413043478261
选择	17	19	10	46	0.413043478261
东西	13	14	7	34	0.411764705882
面对	3	7	7	17	0.411764705882
超标	4	7	6	17	0.411764705882
美元	6	4	7	17	0.411764705882
生命	7	6	4	17	0.411764705882
弄	6	7	4	17	0.411764705882
厂商	7	6	4	17	0.411764705882
出生	7	7	3	17	0.411764705882
写	4	6	7	17	0.411764705882
三个	6	4	7	17	0.411764705882
一大	7	7	3	17	0.411764705882
是	478	473	210	1161	0.411714039621
中	65	52	41	158	0.411392405063
到	102	104	47	253	0.411067193676
完	15	16	8	39	0.410256410256
全面	16	13	10	39	0.410256410256
应该	54	53	25	132	0.409090909091
不少	11	18	15	44	0.409090909091
一种	16	18	10	44	0.409090909091
空气质量	5	9	8	22	0.409090909091
每个	8	9	5	22	0.409090909091
才能	8	9	5	22	0.409090909091
战机	9	7	6	22	0.409090909091
张	9	6	7	22	0.409090909091
习俗	22	14	18	54	0.407407407407
热	6	11	10	27	0.407407407407
开展	11	7	9	27	0.407407407407
iphone	82	61	98	241	0.406639004149
被	80	89	50	219	0.406392694064
请	18	26	20	64	0.40625
国	26	19	19	64	0.40625
是否	15	14	8	37	0.405405405405
把	68	65	35	168	0.404761904762
目前	17	10	15	42	0.404761904762
叫	17	12	13	42	0.404761904762
发现	17	10	15	42	0.404761904762
作为	17	15	10	42	0.404761904762
不得	19	19	9	47	0.404255319149
自己	80	73	45	198	0.40404040404
等	63	60	33	156	0.403846153846
使用	21	12	19	52	0.403846153846
中国	95	107	63	265	0.403773584906
太	59	57	31	147	0.401360544218
怎么	48	64	48	160	0.4
得	62	62	31	155	0.4
屏	48	39	33	120	0.4
开始	42	39	24	105	0.4
认为	19	14	22	55	0.4
问	16	20	14	50	0.4
市场	12	20	18	50	0.4
外观	20	20	10	50	0.4
北京	12	20	18	50	0.4
找	16	15	9	40	0.4
其	16	10	14	40	0.4
肯定	14	13	8	35	0.4
您	13	8	14	35	0.4
几天	12	12	6	30	0.4
元	9	9	12	30	0.4
当然	10	6	9	25	0.4
发布会	8	7	10	25	0.4
车道	8	8	4	20	0.4
由	8	6	6	20	0.4
措施	7	8	5	20	0.4
卡	8	5	7	20	0.4
一步	6	8	6	20	0.4
过来	5	6	4	15	0.4
辆	6	3	6	15	0.4
系列	4	5	6	15	0.4
电池	6	5	4	15	0.4
王	6	4	5	15	0.4
段时间	6	5	4	15	0.4
明白	6	4	5	15	0.4
头	6	5	4	15	0.4
多数	6	6	3	15	0.4
声	6	6	3	15	0.4
十年	6	6	3	15	0.4
分钟	6	6	3	15	0.4
仍	5	4	6	15	0.4
赞成	4	4	2	10	0.4
讨厌	4	4	2	10	0.4
表现	4	3	3	10	0.4
经历	4	2	4	10	0.4
相当	3	4	3	10	0.4
特殊	3	4	3	10	0.4
版本	4	2	4	10	0.4
来到	4	2	4	10	0.4
条	4	4	2	10	0.4
杀	4	4	2	10	0.4
推	3	3	4	10	0.4
性别	3	3	4	10	0.4
思维	3	3	4	10	0.4
态度	3	4	3	10	0.4
当今	4	4	2	10	0.4
应对	3	4	3	10	0.4
对外	2	4	4	10	0.4
姐	4	2	4	10	0.4
地点	3	4	3	10	0.4
因素	4	4	2	10	0.4
喊	4	4	2	10	0.4
努力	4	3	3	10	0.4
兴趣	3	4	3	10	0.4
儿童	4	3	3	10	0.4
供应	2	4	4	10	0.4
主流	2	4	4	10	0.4
严格	4	3	3	10	0.4
不算	2	4	4	10	0.4
不小	4	2	4	10	0.4
iphone5se	4	4	2	10	0.4
高考	2	1	2	5	0.4
陋习	2	1	2	5	0.4
阿姨	2	1	2	5	0.4
阵营	2	1	2	5	0.4
长辈	2	2	1	5	0.4
长沙	2	2	1	5	0.4
银行	2	2	1	5	0.4
钟爱	2	2	1	5	0.4
采用	1	2	2	5	0.4
酷	1	2	2	5	0.4
配备	1	2	2	5	0.4
部	2	2	1	5	0.4
遭	1	2	2	5	0.4
道路交通	2	2	1	5	0.4
途径	2	1	2	5	0.4
迫切	2	2	1	5	0.4
近期	2	1	2	5	0.4
辨率	2	2	1	5	0.4
车站	1	2	2	5	0.4
赶到	2	2	1	5	0.4
触	2	1	2	5	0.4
视	2	1	2	5	0.4
西北	2	1	2	5	0.4
被扣	1	2	2	5	0.4
致	1	2	2	5	0.4
能量	2	2	1	5	0.4
胞胎	2	2	1	5	0.4
联邦	2	2	1	5	0.4
考试	2	1	2	5	0.4
考	2	1	2	5	0.4
老子	1	2	2	5	0.4
缓解	2	2	1	5	0.4
给出	1	2	2	5	0.4
结合	2	2	1	5	0.4
级	2	2	1	5	0.4
第二胎	2	1	2	5	0.4
第三次	1	2	2	5	0.4
竹	2	2	1	5	0.4
站点	2	2	1	5	0.4
立交桥	2	2	1	5	0.4
秘密	2	1	2	5	0.4
禁令	2	2	1	5	0.4
真相	1	2	2	5	0.4
看见	2	2	1	5	0.4
看好	2	2	1	5	0.4
相机	2	2	1	5	0.4
皮肤	2	1	2	5	0.4
皮	2	1	2	5	0.4
百度	2	2	1	5	0.4
环	1	2	2	5	0.4
猜	2	1	2	5	0.4
爽	2	1	2	5	0.4
爱心	2	2	1	5	0.4
灰色	2	2	1	5	0.4
满满	2	2	1	5	0.4
满城	2	2	1	5	0.4
海	2	2	1	5	0.4
沈阳	2	2	1	5	0.4
检查	2	1	2	5	0.4
暖	2	1	2	5	0.4
晕	1	2	2	5	0.4
显摆	2	2	1	5	0.4
新区	2	1	2	5	0.4
摆	2	2	1	5	0.4
战乱	2	1	2	5	0.4
成员	2	1	2	5	0.4
感到	2	2	1	5	0.4
意料	2	2	1	5	0.4
恐怕	2	2	1	5	0.4
忘	2	2	1	5	0.4
心动	2	1	2	5	0.4
得出	2	2	1	5	0.4
引来	2	1	2	5	0.4
建	1	2	2	5	0.4
底线	1	2	2	5	0.4
干活	2	2	1	5	0.4
展开	1	2	2	5	0.4
局面	2	2	1	5	0.4
寓意	2	2	1	5	0.4
孙子	2	2	1	5	0.4
头条	2	1	2	5	0.4
天津	1	2	2	5	0.4
大陆	1	2	2	5	0.4
大年三十	2	2	1	5	0.4
在乎	2	2	1	5	0.4
哪儿	2	2	1	5	0.4
告知	1	2	2	5	0.4
否认	2	2	1	5	0.4
同性恋	1	2	2	5	0.4
同性	1	2	2	5	0.4
合作	2	2	1	5	0.4
取得	2	2	1	5	0.4
及其	1	2	2	5	0.4
原文	2	1	2	5	0.4
即便	2	2	1	5	0.4
南海	2	2	1	5	0.4
包裹	2	2	1	5	0.4
动作	2	1	2	5	0.4
前段时间	2	1	2	5	0.4
前段	2	1	2	5	0.4
分辨率	2	2	1	5	0.4
几	2	2	1	5	0.4
减	2	2	1	5	0.4
准	2	2	1	5	0.4
全城	1	2	2	5	0.4
免费	1	2	2	5	0.4
克里	2	1	2	5	0.4
充电	2	1	2	5	0.4
元旦	2	2	1	5	0.4
作者	2	2	1	5	0.4
佛	2	2	1	5	0.4
伤亡	1	2	2	5	0.4
会员	2	1	2	5	0.4
人行道	2	2	1	5	0.4
亮点	2	2	1	5	0.4
书记	1	2	2	5	0.4
临	1	2	2	5	0.4
东莞	2	2	1	5	0.4
专业	1	2	2	5	0.4
不必	1	2	2	5	0.4
三次	1	2	2	5	0.4
三分	1	2	2	5	0.4
一项	2	2	1	5	0.4
一段时间	2	2	1	5	0.4
一日	1	2	2	5	0.4
一手	2	2	1	5	0.4
一帮	2	2	1	5	0.4
一岁	2	2	1	5	0.4
phonese	2	2	1	5	0.4
ios9	1	2	2	5	0.4
在	312	278	192	782	0.398976982097
还是	78	76	42	196	0.397959183673
可能	31	33	19	83	0.397590361446
上	120	113	69	302	0.397350993377
地	27	26	15	68	0.397058823529
看看	21	18	14	53	0.396226415094
行动	38	35	23	96	0.395833333333
刚	13	12	8	33	0.393939393939
时间	33	23	28	84	0.392857142857
正在	11	8	9	28	0.392857142857
成为	7	11	10	28	0.392857142857
大学	11	11	6	28	0.392857142857
年	108	98	69	275	0.392727272727
有	207	222	137	566	0.39222614841
最近	17	14	20	51	0.392156862745
一	75	87	60	222	0.391891891892
与	50	58	40	148	0.391891891892
换	18	16	12	46	0.391304347826
应	9	9	5	23	0.391304347826
升级	9	6	8	23	0.391304347826
传统习俗	6	9	8	23	0.391304347826
长	16	11	14	41	0.390243902439
iphonese	37	32	26	95	0.389473684211
这	183	182	105	470	0.389361702128
起来	27	28	17	72	0.388888888889
远	5	6	7	18	0.388888888889
赞	7	7	4	18	0.388888888889
老大	7	6	5	18	0.388888888889
我国	5	7	6	18	0.388888888889
售价	5	6	7	18	0.388888888889
制造	7	7	4	18	0.388888888889
信	7	5	6	18	0.388888888889
你	153	157	94	404	0.388613861386
微	23	26	18	67	0.388059701493
最后	11	12	8	31	0.387096774194
一次	16	17	11	44	0.386363636364
走	22	20	15	57	0.385964912281
质量	12	15	12	39	0.384615384615
便宜	7	9	10	26	0.384615384615
三轮车	10	8	8	26	0.384615384615
风俗	5	5	3	13	0.384615384615
货	5	5	3	13	0.384615384615
至于	4	4	5	13	0.384615384615
水平	3	5	5	13	0.384615384615
毕业	5	4	4	13	0.384615384615
旧	4	5	4	13	0.384615384615
情	5	3	5	13	0.384615384615
往	4	5	4	13	0.384615384615
变化	5	4	4	13	0.384615384615
东	4	4	5	13	0.384615384615
一张	4	4	5	13	0.384615384615
有人	26	25	17	68	0.382352941176
下	55	53	36	144	0.381944444444
有点	20	21	14	55	0.381818181818
不过	21	16	18	55	0.381818181818
三轮	16	14	12	42	0.380952380952
日报	8	8	5	21	0.380952380952
同样	8	7	6	21	0.380952380952
使	5	8	8	21	0.380952380952
手机	66	56	52	174	0.379310344828
一胎	11	11	7	29	0.379310344828
已经	47	42	35	124	0.379032258065
通过	10	14	13	37	0.378378378378
新	34	28	28	90	0.377777777778
电	29	37	32	98	0.377551020408
价格	29	27	21	77	0.376623376623
天	27	25	20	72	0.375
进行	12	13	15	40	0.375
用户	7	8	9	24	0.375
改变	6	9	9	24	0.375
居然	7	9	8	24	0.375
受	6	9	9	24	0.375
以及	8	7	9	24	0.375
顺利	6	5	5	16	0.375
进	5	6	5	16	0.375
由于	4	6	6	16	0.375
民主	6	6	4	16	0.375
查	5	6	5	16	0.375
员	4	6	6	16	0.375
公共	6	6	4	16	0.375
保持	6	6	4	16	0.375
似乎	6	6	4	16	0.375
飞	3	3	2	8	0.375
预测	2	3	3	8	0.375
随意	3	3	2	8	0.375
选	3	2	3	8	0.375
资讯	2	3	3	8	0.375
观念	3	3	2	8	0.375
萌	3	2	3	8	0.375
美丽	3	3	2	8	0.375
紧急	3	3	2	8	0.375
直到	3	2	3	8	0.375
电子	3	3	2	8	0.375
现	3	2	3	8	0.375
爆炸	3	2	3	8	0.375
炸伤	2	3	3	8	0.375
清明	3	3	2	8	0.375
杭州	3	3	2	8	0.375
机型	2	3	3	8	0.375
机动车道	2	3	3	8	0.375
新手机	2	3	3	8	0.375
新手	2	3	3	8	0.375
整体	2	3	3	8	0.375
效果	3	2	3	8	0.375
改	3	2	3	8	0.375
指	3	3	2	8	0.375
或许	3	2	3	8	0.375
思考	2	3	3	8	0.375
开门	3	3	2	8	0.375
店	3	3	2	8	0.375
帮助	3	3	2	8	0.375
存	3	3	2	8	0.375
女生	3	2	3	8	0.375
女孩	2	3	3	8	0.375
失败	2	3	3	8	0.375
卧槽	3	2	3	8	0.375
半夜	3	2	3	8	0.375
他人	2	3	3	8	0.375
主动	3	3	2	8	0.375
一辆	2	3	3	8	0.375
一块	3	2	3	8	0.375
一样	39	40	28	107	0.373831775701
日	34	24	33	91	0.373626373626
人们	17	19	15	51	0.372549019608
将	31	40	42	113	0.371681415929
路	12	13	10	35	0.371428571429
但	73	68	56	197	0.370558375635
拍	14	20	20	54	0.37037037037
它	18	20	16	54	0.37037037037
朋友	21	19	17	57	0.368421052632
于	14	11	13	38	0.368421052632
个人	14	11	13	38	0.368421052632
有没有	7	6	6	19	0.368421052632
广州	6	7	6	19	0.368421052632
外	6	6	7	19	0.368421052632
自	15	18	16	49	0.367346938776
如何	15	18	16	49	0.367346938776
一些	19	15	18	52	0.365384615385
万	12	12	9	33	0.363636363636
查扣	8	6	8	22	0.363636363636
重新	3	4	4	11	0.363636363636
配	4	4	3	11	0.363636363636
进一步	3	4	4	11	0.363636363636
较	3	4	4	11	0.363636363636
疯	4	4	3	11	0.363636363636
现实	4	4	3	11	0.363636363636
来临	4	4	3	11	0.363636363636
接	4	4	3	11	0.363636363636
库尔德	3	4	4	11	0.363636363636
库尔	3	4	4	11	0.363636363636
尽管	4	3	4	11	0.363636363636
吐	4	4	3	11	0.363636363636
停	4	4	3	11	0.363636363636
乐	4	3	4	11	0.363636363636
快递	17	16	14	47	0.36170212766
number	273	270	213	756	0.361111111111
影响	21	18	22	61	0.360655737705
苹果	44	53	50	147	0.360544217687
se	106	93	97	296	0.358108108108
羊	5	4	5	14	0.357142857143
红	5	5	4	14	0.357142857143
照	5	5	4	14	0.357142857143
提升	5	5	4	14	0.357142857143
左右	4	5	5	14	0.357142857143
实际	10	11	10	31	0.354838709677
能够	6	5	6	17	0.352941176471
无法	5	6	6	17	0.352941176471
年轻	6	5	6	17	0.352941176471
即将	6	5	6	17	0.352941176471
关于	13	11	13	37	0.351351351351
难民	7	6	7	20	0.35
消息	7	8	8	23	0.347826086957
分	8	8	7	23	0.347826086957
存在	8	9	9	26	0.346153846154
称	12	11	12	35	0.342857142857
之前	12	12	12	36	0.333333333333
形成	5	5	5	15	0.333333333333
一款	5	5	5	15	0.333333333333
apple	5	5	5	15	0.333333333333
西安	4	4	4	12	0.333333333333
即	4	4	4	12	0.333333333333
十多	4	4	4	12	0.333333333333
面临	3	3	3	9	0.333333333333
若	3	3	3	9	0.333333333333
理器	3	3	3	9	0.333333333333
文章	3	3	3	9	0.333333333333
处理器	3	3	3	9	0.333333333333
壳	3	3	3	9	0.333333333333
回应	3	3	3	9	0.333333333333
周	3	3	3	9	0.333333333333
化	3	3	3	9	0.333333333333
重大	2	2	2	6	0.333333333333
过于	2	2	2	6	0.333333333333
趋势	2	2	2	6	0.333333333333
行道	2	2	2	6	0.333333333333
能否	2	2	2	6	0.333333333333
继	2	2	2	6	0.333333333333
立交	2	2	2	6	0.333333333333
看似	2	2	2	6	0.333333333333
热点	2	2	2	6	0.333333333333
潮流	2	2	2	6	0.333333333333
漂亮	2	2	2	6	0.333333333333
源头	2	2	2	6	0.333333333333
成立	2	2	2	6	0.333333333333
慢慢	2	2	2	6	0.333333333333
恋爱	2	2	2	6	0.333333333333
少不了	2	2	2	6	0.333333333333
呐	2	2	2	6	0.333333333333
后者	2	2	2	6	0.333333333333
刚才	2	2	2	6	0.333333333333
分辨	2	2	2	6	0.333333333333
分裂	2	2	2	6	0.333333333333
公然	2	2	2	6	0.333333333333
依法	2	2	2	6	0.333333333333
不但	2	2	2	6	0.333333333333
上学	2	2	2	6	0.333333333333
app	2	2	2	6	0.333333333333
高龄产妇	1	1	1	3	0.333333333333
靠近	1	1	1	3	0.333333333333
非一日之寒	1	1	1	3	0.333333333333
零件	1	1	1	3	0.333333333333
陷入	1	1	1	3	0.333333333333
间接	1	1	1	3	0.333333333333
长春市	1	1	1	3	0.333333333333
锣鼓	1	1	1	3	0.333333333333
郭	1	1	1	3	0.333333333333
遵	1	1	1	3	0.333333333333
送暖	1	1	1	3	0.333333333333
进来	1	1	1	3	0.333333333333
这项	1	1	1	3	0.333333333333
这方面	1	1	1	3	0.333333333333
这方	1	1	1	3	0.333333333333
踏	1	1	1	3	0.333333333333
越界	1	1	1	3	0.333333333333
起到	1	1	1	3	0.333333333333
资本主义	1	1	1	3	0.333333333333
购	1	1	1	3	0.333333333333
账	1	1	1	3	0.333333333333
说法	1	1	1	3	0.333333333333
试管	1	1	1	3	0.333333333333
试	1	1	1	3	0.333333333333
讲究	1	1	1	3	0.333333333333
解禁	1	1	1	3	0.333333333333
规律	1	1	1	3	0.333333333333
融入	1	1	1	3	0.333333333333
虽说	1	1	1	3	0.333333333333
虎	1	1	1	3	0.333333333333
艰难	1	1	1	3	0.333333333333
联欢晚会	1	1	1	3	0.333333333333
联欢	1	1	1	3	0.333333333333
美国佬	1	1	1	3	0.333333333333
缴纳	1	1	1	3	0.333333333333
统计	1	1	1	3	0.333333333333
统一战线	1	1	1	3	0.333333333333
绝不	1	1	1	3	0.333333333333
细节	1	1	1	3	0.333333333333
纵	1	1	1	3	0.333333333333
纳入	1	1	1	3	0.333333333333
索尼	1	1	1	3	0.333333333333
粤	1	1	1	3	0.333333333333
粘	1	1	1	3	0.333333333333
篱笆	1	1	1	3	0.333333333333
真真是	1	1	1	3	0.333333333333
真真	1	1	1	3	0.333333333333
看病	1	1	1	3	0.333333333333
相互	1	1	1	3	0.333333333333
盘点	1	1	1	3	0.333333333333
疑似	1	1	1	3	0.333333333333
男朋友	1	1	1	3	0.333333333333
由此	1	1	1	3	0.333333333333
现阶段	1	1	1	3	0.333333333333
环境保护	1	1	1	3	0.333333333333
犯	1	1	1	3	0.333333333333
物料	1	1	1	3	0.333333333333
物	1	1	1	3	0.333333333333
爬	1	1	1	3	0.333333333333
焰火	1	1	1	3	0.333333333333
焦虑	1	1	1	3	0.333333333333
激烈	1	1	1	3	0.333333333333
流入	1	1	1	3	0.333333333333
河北	1	1	1	3	0.333333333333
气息	1	1	1	3	0.333333333333
步行	1	1	1	3	0.333333333333
正规	1	1	1	3	0.333333333333
欢喜	1	1	1	3	0.333333333333
查获	1	1	1	3	0.333333333333
本主	1	1	1	3	0.333333333333
木	1	1	1	3	0.333333333333
月经	1	1	1	3	0.333333333333
晴朗	1	1	1	3	0.333333333333
早恋	1	1	1	3	0.333333333333
早上好	1	1	1	3	0.333333333333
既得利益	1	1	1	3	0.333333333333
既得	1	1	1	3	0.333333333333
数	1	1	1	3	0.333333333333
放进	1	1	1	3	0.333333333333
播放	1	1	1	3	0.333333333333
搞定	1	1	1	3	0.333333333333
搜索	1	1	1	3	0.333333333333
接到	1	1	1	3	0.333333333333
捍卫	1	1	1	3	0.333333333333
指手画脚	1	1	1	3	0.333333333333
指定	1	1	1	3	0.333333333333
招手	1	1	1	3	0.333333333333
拉动	1	1	1	3	0.333333333333
抢红包	1	1	1	3	0.333333333333
扰	1	1	1	3	0.333333333333
战线	1	1	1	3	0.333333333333
想着	1	1	1	3	0.333333333333
想像	1	1	1	3	0.333333333333
惨	1	1	1	3	0.333333333333
怎么回事	1	1	1	3	0.333333333333
当成	1	1	1	3	0.333333333333
弹药	1	1	1	3	0.333333333333
弊端	1	1	1	3	0.333333333333
开战	1	1	1	3	0.333333333333
年糕	1	1	1	3	0.333333333333
干掉	1	1	1	3	0.333333333333
布局	1	1	1	3	0.333333333333
差异	1	1	1	3	0.333333333333
崇洋	1	1	1	3	0.333333333333
山姆	1	1	1	3	0.333333333333
居住	1	1	1	3	0.333333333333
尚未	1	1	1	3	0.333333333333
尊严	1	1	1	3	0.333333333333
富	1	1	1	3	0.333333333333
官兵	1	1	1	3	0.333333333333
嫌疑	1	1	1	3	0.333333333333
娘	1	1	1	3	0.333333333333
威	1	1	1	3	0.333333333333
妹子	1	1	1	3	0.333333333333
女强人	1	1	1	3	0.333333333333
大跌	1	1	1	3	0.333333333333
大吉	1	1	1	3	0.333333333333
大于	1	1	1	3	0.333333333333
多名	1	1	1	3	0.333333333333
外面	1	1	1	3	0.333333333333
外界	1	1	1	3	0.333333333333
声声	1	1	1	3	0.333333333333
回味	1	1	1	3	0.333333333333
四寸	1	1	1	3	0.333333333333
喜爱	1	1	1	3	0.333333333333
喜乐	1	1	1	3	0.333333333333
商人	1	1	1	3	0.333333333333
唐人	1	1	1	3	0.333333333333
周知	1	1	1	3	0.333333333333
吋	1	1	1	3	0.333333333333
各方	1	1	1	3	0.333333333333
吃喝	1	1	1	3	0.333333333333
可否	1	1	1	3	0.333333333333
发黄	1	1	1	3	0.333333333333
县	1	1	1	3	0.333333333333
十八	1	1	1	3	0.333333333333
区间	1	1	1	3	0.333333333333
包装	1	1	1	3	0.333333333333
办公室	1	1	1	3	0.333333333333
前者	1	1	1	3	0.333333333333
前年	1	1	1	3	0.333333333333
前天	1	1	1	3	0.333333333333
删	1	1	1	3	0.333333333333
初七	1	1	1	3	0.333333333333
分给	1	1	1	3	0.333333333333
出于	1	1	1	3	0.333333333333
出事	1	1	1	3	0.333333333333
出乎意料	1	1	1	3	0.333333333333
凑	1	1	1	3	0.333333333333
净	1	1	1	3	0.333333333333
冰冻三尺	1	1	1	3	0.333333333333
冰冻	1	1	1	3	0.333333333333
军备	1	1	1	3	0.333333333333
内地	1	1	1	3	0.333333333333
关闭	1	1	1	3	0.333333333333
共计	1	1	1	3	0.333333333333
公路	1	1	1	3	0.333333333333
公室	1	1	1	3	0.333333333333
公告	1	1	1	3	0.333333333333
全身	1	1	1	3	0.333333333333
做成	1	1	1	3	0.333333333333
假如	1	1	1	3	0.333333333333
俺	1	1	1	3	0.333333333333
保留节目	1	1	1	3	0.333333333333
保安	1	1	1	3	0.333333333333
保守	1	1	1	3	0.333333333333
何时	1	1	1	3	0.333333333333
传递	1	1	1	3	0.333333333333
传播	1	1	1	3	0.333333333333
众生	1	1	1	3	0.333333333333
人物	1	1	1	3	0.333333333333
交通安全	1	1	1	3	0.333333333333
亚	1	1	1	3	0.333333333333
五十	1	1	1	3	0.333333333333
五一	1	1	1	3	0.333333333333
之上	1	1	1	3	0.333333333333
举报	1	1	1	3	0.333333333333
严打	1	1	1	3	0.333333333333
两会	1	1	1	3	0.333333333333
不要脸	1	1	1	3	0.333333333333
不育	1	1	1	3	0.333333333333
不用说	1	1	1	3	0.333333333333
不服	1	1	1	3	0.333333333333
不曾	1	1	1	3	0.333333333333
上好	1	1	1	3	0.333333333333
三尺	1	1	1	3	0.333333333333
一身	1	1	1	3	0.333333333333
一流	1	1	1	3	0.333333333333
一来	1	1	1	3	0.333333333333
一套	1	1	1	3	0.333333333333
vs	1	1	1	3	0.333333333333
r9	1	1	1	3	0.333333333333
p9	1	1	1	3	0.333333333333
nfc	1	1	1	3	0.333333333333
