WORD	FAVOR	AGAINST	NONE	FREQ	SUPPORT
底层	0	18	0	18	1.0
生存	0	16	0	16	1.0
单手	16	0	0	16	1.0
环保局	0	11	0	11	1.0
单手操作	10	0	0	10	1.0
从我做起	0	10	0	10	1.0
超女	0	0	9	9	1.0
美少女	0	0	9	9	1.0
时间表	0	0	9	9	1.0
无敌	0	0	9	9	1.0
红绿灯	8	0	0	8	1.0
红绿	8	0	0	8	1.0
正好	8	0	0	8	1.0
备	8	0	0	8	1.0
危害	0	8	0	8	1.0
节约	0	7	0	7	1.0
腐败	0	7	0	7	1.0
生就	0	7	0	7	1.0
婚假	0	7	0	7	1.0
大宝	7	0	0	7	1.0
口号	0	7	0	7	1.0
九件	7	0	0	7	1.0
中秋	7	0	0	7	1.0
解决问题	0	6	0	6	1.0
秋节	6	0	0	6	1.0
浓度	0	6	0	6	1.0
延迟	0	6	0	6	1.0
布	6	0	0	6	1.0
巫术	6	0	0	6	1.0
嫌弃	6	0	0	6	1.0
吉	6	0	0	6	1.0
刹车	6	0	0	6	1.0
公	6	0	0	6	1.0
儿时	6	0	0	6	1.0
人力	0	6	0	6	1.0
买车	0	6	0	6	1.0
中秋节	6	0	0	6	1.0
锅铲	0	0	5	5	1.0
逊尼派	0	5	0	5	1.0
逊尼	0	5	0	5	1.0
车尾	5	0	0	5	1.0
老伴	0	0	5	5	1.0
罗斯国	5	0	0	5	1.0
纳	5	0	0	5	1.0
端午节	5	0	0	5	1.0
端午	5	0	0	5	1.0
盼望	5	0	0	5	1.0
淡	5	0	0	5	1.0
汽车尾气	5	0	0	5	1.0
月饼	5	0	0	5	1.0
抢劫	0	5	0	5	1.0
情景	5	0	0	5	1.0
差点	5	0	0	5	1.0
屁用	0	5	0	5	1.0
安全事故	0	5	0	5	1.0
士兵	5	0	0	5	1.0
团圆饭	5	0	0	5	1.0
原始	0	5	0	5	1.0
俄罗斯国防部	5	0	0	5	1.0
乱窜	5	0	0	5	1.0
买得起	0	5	0	5	1.0
买得	0	5	0	5	1.0
下滑	0	5	0	5	1.0
蓝天	1	20	0	21	0.952380952381
做起	1	19	0	20	0.95
碳	1	13	0	14	0.928571428571
年货	13	1	0	14	0.928571428571
断崖	0	12	1	13	0.923076923077
亲戚	12	1	0	13	0.923076923077
穷人	0	11	1	12	0.916666666667
少女	1	0	11	12	0.916666666667
劳动力	0	11	1	12	0.916666666667
普通	1	10	0	11	0.909090909091
自觉	1	9	0	10	0.9
粗暴	0	9	1	10	0.9
疯狂	1	9	0	10	0.9
同一	0	1	9	10	0.9
再也	0	9	1	10	0.9
餐饮业	3	24	0	27	0.888888888889
对准	3	24	0	27	0.888888888889
劳动	1	16	1	18	0.888888888889
远离	0	8	1	9	0.888888888889
没收	0	8	1	9	0.888888888889
扎堆	1	0	8	9	0.888888888889
嫌	1	8	0	9	0.888888888889
三年	8	0	1	9	0.888888888889
通工	0	15	2	17	0.882352941176
交通工具	0	15	2	17	0.882352941176
首映	7	0	1	8	0.875
隐患	0	7	1	8	0.875
退	1	7	0	8	0.875
违反	1	7	0	8	0.875
民意	0	7	1	8	0.875
新款	1	0	7	8	0.875
擦	7	1	0	8	0.875
承担	1	7	0	8	0.875
恐	0	7	1	8	0.875
尴尬	0	7	1	8	0.875
宝贝	7	1	0	8	0.875
奇葩	0	7	1	8	0.875
唱	7	1	0	8	0.875
典型	1	7	0	8	0.875
退休	1	13	1	15	0.866666666667
横冲	13	1	1	15	0.866666666667
新衣	13	1	1	15	0.866666666667
弟弟	13	2	0	15	0.866666666667
哈哈哈	13	2	0	15	0.866666666667
倡议	2	30	3	35	0.857142857143
孕	18	1	2	21	0.857142857143
承诺	2	12	0	14	0.857142857143
坑	2	12	0	14	0.857142857143
青年	0	6	1	7	0.857142857143
锵锵	1	0	6	7	0.857142857143
迎接	6	1	0	7	0.857142857143
跟不上	0	6	1	7	0.857142857143
证	0	6	1	7	0.857142857143
稳定	6	1	0	7	0.857142857143
爸爸妈妈	6	0	1	7	0.857142857143
爱护	1	6	0	7	0.857142857143
添个	6	0	1	7	0.857142857143
涨	1	6	0	7	0.857142857143
智商	6	1	0	7	0.857142857143
操	1	6	0	7	0.857142857143
摔	6	1	0	7	0.857142857143
打着	1	6	0	7	0.857142857143
孤单	6	0	1	7	0.857142857143
合适	6	0	1	7	0.857142857143
可爱	6	1	0	7	0.857142857143
出席	6	0	1	7	0.857142857143
低于	0	1	6	7	0.857142857143
传说	6	0	1	7	0.857142857143
三人行	1	0	6	7	0.857142857143
ps	6	1	0	7	0.857142857143
春晚	17	2	1	20	0.85
亲人	22	3	1	26	0.846153846154
晚婚	2	16	1	19	0.842105263158
餐饮	4	25	1	30	0.833333333333
小时候	20	3	1	24	0.833333333333
逆行	15	3	0	18	0.833333333333
妹妹	15	3	0	18	0.833333333333
龙岗	10	2	0	12	0.833333333333
绿灯	10	0	2	12	0.833333333333
直撞	10	1	1	12	0.833333333333
烧纸	1	10	1	12	0.833333333333
横冲直撞	10	1	1	12	0.833333333333
齐	5	1	0	6	0.833333333333
颜	5	0	1	6	0.833333333333
隆重	5	0	1	6	0.833333333333
陪伴	5	1	0	6	0.833333333333
防部	5	0	1	6	0.833333333333
门神	5	0	1	6	0.833333333333
长假	0	1	5	6	0.833333333333
走亲戚	5	1	0	6	0.833333333333
貌似	5	0	1	6	0.833333333333
谋生	0	5	1	6	0.833333333333
该机	1	0	5	6	0.833333333333
警力	5	0	1	6	0.833333333333
规矩	5	0	1	6	0.833333333333
苏联	0	5	1	6	0.833333333333
舞狮	5	0	1	6	0.833333333333
聚集	5	0	1	6	0.833333333333
物价	1	5	0	6	0.833333333333
炸弹	1	5	0	6	0.833333333333
温和	5	1	0	6	0.833333333333
比比皆是	5	1	0	6	0.833333333333
比比	5	1	0	6	0.833333333333
无数	0	5	1	6	0.833333333333
握	5	0	1	6	0.833333333333
成长	5	0	1	6	0.833333333333
感人	5	1	0	6	0.833333333333
恶心	1	5	0	6	0.833333333333
录制	5	0	1	6	0.833333333333
局势	5	1	0	6	0.833333333333
小小	5	0	1	6	0.833333333333
小妹	1	0	5	6	0.833333333333
对此	0	1	5	6	0.833333333333
官员	1	5	0	6	0.833333333333
大姚	5	0	1	6	0.833333333333
大人	0	5	1	6	0.833333333333
坪	5	1	0	6	0.833333333333
国防部	5	0	1	6	0.833333333333
国防	5	0	1	6	0.833333333333
听见	5	1	0	6	0.833333333333
发财	0	5	1	6	0.833333333333
厂家	0	5	1	6	0.833333333333
印象	5	0	1	6	0.833333333333
千元	1	5	0	6	0.833333333333
加大	0	5	1	6	0.833333333333
创新	0	5	1	6	0.833333333333
养老	1	5	0	6	0.833333333333
公益	1	5	0	6	0.833333333333
借	1	5	0	6	0.833333333333
介绍	5	0	1	6	0.833333333333
争议	0	1	5	6	0.833333333333
义务	0	5	1	6	0.833333333333
严峻	1	5	0	6	0.833333333333
两周	5	0	1	6	0.833333333333
一顿	0	5	1	6	0.833333333333
一阵	5	1	0	6	0.833333333333
x	1	0	5	6	0.833333333333
pro	1	0	5	6	0.833333333333
取消	1	19	3	23	0.826086956522
西方	14	2	1	17	0.823529411765
发出	2	14	1	17	0.823529411765
中华民族	14	2	1	17	0.823529411765
宝	18	0	4	22	0.818181818182
申请	0	2	9	11	0.818181818182
毫无	2	9	0	11	0.818181818182
户户	9	0	2	11	0.818181818182
成都	0	9	2	11	0.818181818182
恐怖主义	9	2	0	11	0.818181818182
广大	1	9	1	11	0.818181818182
帅	2	0	9	11	0.818181818182
家户	9	0	2	11	0.818181818182
家家户户	9	0	2	11	0.818181818182
实话	2	9	0	11	0.818181818182
哥哥	9	2	0	11	0.818181818182
失望	0	13	3	16	0.8125
千年	13	1	2	16	0.8125
团圆	17	4	0	21	0.809523809524
今年春节	3	55	10	68	0.808823529412
懒	2	16	2	20	0.8
铁站	12	1	2	15	0.8
越	12	3	0	15	0.8
收	3	12	0	15	0.8
地铁站	12	1	2	15	0.8
土鸡	12	3	0	15	0.8
响	3	12	0	15	0.8
财产	0	8	2	10	0.8
记忆	8	0	2	10	0.8
消防	0	8	2	10	0.8
济南	1	8	1	10	0.8
拍照	8	2	0	10	0.8
怎么办	1	8	1	10	0.8
客	8	0	2	10	0.8
姐姐	8	2	0	10	0.8
大气	2	8	0	10	0.8
呼吸	1	8	1	10	0.8
可笑	2	8	0	10	0.8
几千年	8	1	1	10	0.8
几千	8	1	1	10	0.8
冲	8	1	1	10	0.8
全家	8	1	1	10	0.8
倡导	1	8	1	10	0.8
鱼	4	0	1	5	0.8
首映礼	4	0	1	5	0.8
面积	0	4	1	5	0.8
难题	1	0	4	5	0.8
陶	1	4	0	5	0.8
道德	1	4	0	5	0.8
迟早	1	4	0	5	0.8
车牌	1	4	0	5	0.8
趟	4	1	0	5	0.8
详见	0	4	1	5	0.8
许	0	4	1	5	0.8
记录	1	4	0	5	0.8
解放	4	1	0	5	0.8
规章	0	4	1	5	0.8
观看	1	0	4	5	0.8
行政拘留	4	1	0	5	0.8
蜜月	1	4	0	5	0.8
营销	0	4	1	5	0.8
航母	4	1	0	5	0.8
耳朵	1	0	4	5	0.8
翻新	1	4	0	5	0.8
纵容	4	1	0	5	0.8
纳税	1	4	0	5	0.8
累死	1	4	0	5	0.8
糖	4	0	1	5	0.8
精力	4	0	1	5	0.8
移风易俗	0	4	1	5	0.8
礼花	1	4	0	5	0.8
短时	1	4	0	5	0.8
知识	4	0	1	5	0.8
生生	1	4	0	5	0.8
特种部队	1	4	0	5	0.8
特定	4	0	1	5	0.8
熟悉	4	0	1	5	0.8
烦恼	1	4	0	5	0.8
炮竹	1	4	0	5	0.8
有趣	4	1	0	5	0.8
有理	4	1	0	5	0.8
显得	4	1	0	5	0.8
春节快乐	1	4	0	5	0.8
易俗	0	4	1	5	0.8
新春佳节	0	4	1	5	0.8
新意	0	4	1	5	0.8
救	0	4	1	5	0.8
效率	0	4	1	5	0.8
放火	1	4	0	5	0.8
改成	1	4	0	5	0.8
搞笑	4	1	0	5	0.8
搞不懂	0	4	1	5	0.8
揽客	4	1	0	5	0.8
揍	4	1	0	5	0.8
挑	4	0	1	5	0.8
拟	0	4	1	5	0.8
拜神	4	0	1	5	0.8
抚养	1	4	0	5	0.8
批	4	1	0	5	0.8
打麻将	4	0	1	5	0.8
打压	0	4	1	5	0.8
愤怒	1	4	0	5	0.8
意愿	1	4	0	5	0.8
恐怖袭击	4	0	1	5	0.8
总理	1	0	4	5	0.8
性	1	4	0	5	0.8
彰显	1	4	0	5	0.8
建国	4	1	0	5	0.8
广东	1	4	0	5	0.8
年后	1	4	0	5	0.8
干部	1	4	0	5	0.8
小国	0	4	1	5	0.8
对不起	4	1	0	5	0.8
实实	0	1	4	5	0.8
定价	0	1	4	5	0.8
宇	4	0	1	5	0.8
好不容易	0	4	1	5	0.8
夫妇	4	0	1	5	0.8
天空	0	4	1	5	0.8
大道	4	1	0	5	0.8
大叔	4	1	0	5	0.8
基督	4	1	0	5	0.8
基本上	0	4	1	5	0.8
埋	0	4	1	5	0.8
坚强	4	1	0	5	0.8
圣诞节	4	1	0	5	0.8
困难	4	0	1	5	0.8
回收	1	4	0	5	0.8
四分	0	4	1	5	0.8
噢	4	0	1	5	0.8
喇叭	4	0	1	5	0.8
品	4	0	1	5	0.8
咋办	0	1	4	5	0.8
周边	1	4	0	5	0.8
吨	0	4	1	5	0.8
号称	1	4	0	5	0.8
可悲	1	4	0	5	0.8
只许	1	4	0	5	0.8
发明	1	4	0	5	0.8
去年同期	0	1	4	5	0.8
却是	4	1	0	5	0.8
协议	0	4	1	5	0.8
半句话	1	4	0	5	0.8
半句	1	4	0	5	0.8
勒	0	4	1	5	0.8
办事	1	4	0	5	0.8
制作	0	1	4	5	0.8
出色	4	0	1	5	0.8
关	0	4	1	5	0.8
偏	1	4	0	5	0.8
你好	4	1	0	5	0.8
何必	0	4	1	5	0.8
何以	0	4	1	5	0.8
位	1	4	0	5	0.8
似的	4	0	1	5	0.8
伴	4	1	0	5	0.8
伊	4	1	0	5	0.8
代	0	4	1	5	0.8
九	4	0	1	5	0.8
之下	0	4	1	5	0.8
主持人	4	0	1	5	0.8
主持	4	0	1	5	0.8
不能不	1	4	0	5	0.8
不怎么	1	4	0	5	0.8
下场	1	4	0	5	0.8
穿	15	1	3	19	0.789473684211
没钱	2	11	1	14	0.785714285714
月份	11	2	1	14	0.785714285714
家家	11	1	2	14	0.785714285714
合伙人	11	0	3	14	0.785714285714
合伙	11	0	3	14	0.785714285714
土豆	14	0	4	18	0.777777777778
产生	3	14	1	18	0.777777777778
赚钱	1	7	1	9	0.777777777778
说实话	2	7	0	9	0.777777777778
福	7	1	1	9	0.777777777778
没法	1	7	1	9	0.777777777778
歧视	1	7	1	9	0.777777777778
明确	0	7	2	9	0.777777777778
打死	2	7	0	9	0.777777777778
库曼	7	2	0	9	0.777777777778
平等	1	7	1	9	0.777777777778
威胁	1	7	1	9	0.777777777778
土库曼	7	2	0	9	0.777777777778
土库	7	2	0	9	0.777777777778
别的	7	2	0	9	0.777777777778
兜	7	2	0	9	0.777777777778
倒退	1	7	1	9	0.777777777778
仅仅	1	7	1	9	0.777777777778
一片	0	7	2	9	0.777777777778
一旦	0	7	2	9	0.777777777778
ipad	1	1	7	9	0.777777777778
号召	4	17	1	22	0.772727272727
腿	2	1	10	13	0.769230769231
晚育	2	10	1	13	0.769230769231
年夜饭	10	1	2	13	0.769230769231
尾气	10	3	0	13	0.769230769231
就业	1	10	2	13	0.769230769231
对联	10	2	1	13	0.769230769231
夜饭	10	1	2	13	0.769230769231
地球	3	10	0	13	0.769230769231
受到	3	10	0	13	0.769230769231
绿色	2	23	5	30	0.766666666667
目的	3	13	1	17	0.764705882353
小土豆	13	0	4	17	0.764705882353
小土	13	0	4	17	0.764705882353
吃饺子	13	1	3	17	0.764705882353
鼓励	3	19	3	25	0.76
环保	16	109	20	145	0.751724137931
法律	3	18	3	24	0.75
总统	18	4	2	24	0.75
工具	3	18	3	24	0.75
式	4	15	1	20	0.75
买不起	2	15	3	20	0.75
照顾	12	3	1	16	0.75
权力	3	12	1	16	0.75
拜年	12	2	2	16	0.75
同意	1	12	3	16	0.75
重点	9	1	2	12	0.75
蜀黍	9	3	0	12	0.75
火灾	0	9	3	12	0.75
怀上	9	0	3	12	0.75
噪音	2	9	1	12	0.75
公民	2	9	1	12	0.75
路段	6	1	1	8	0.75
类	1	6	1	8	0.75
电车	1	6	1	8	0.75
法律依据	1	6	1	8	0.75
来源	1	1	6	8	0.75
朋友圈	2	0	6	8	0.75
明星	6	0	2	8	0.75
敏感	0	2	6	8	0.75
政权	0	6	2	8	0.75
携带	6	2	0	8	0.75
拥堵	0	6	2	8	0.75
恶劣	6	1	1	8	0.75
恭喜	6	0	2	8	0.75
总之	6	1	1	8	0.75
志愿	2	6	0	8	0.75
幼儿园	6	2	0	8	0.75
小车	1	6	1	8	0.75
宝安	6	0	2	8	0.75
多多	2	6	0	8	0.75
后来	6	1	1	8	0.75
各界	0	6	2	8	0.75
千万	1	6	1	8	0.75
偷	1	1	6	8	0.75
值	6	1	1	8	0.75
价值	0	6	2	8	0.75
人性	2	6	0	8	0.75
也好	1	6	1	8	0.75
下面	6	0	2	8	0.75
一律	6	2	0	8	0.75
老百姓	10	32	1	43	0.744186046512
外卖	7	26	2	35	0.742857142857
一代	5	20	2	27	0.740740740741
春联	34	6	6	46	0.739130434783
操作	14	4	1	19	0.736842105263
尽量	2	14	3	19	0.736842105263
到处	14	2	3	19	0.736842105263
鞭	3	11	1	15	0.733333333333
道理	3	11	1	15	0.733333333333
纠结	11	2	2	15	0.733333333333
疫苗	2	11	2	15	0.733333333333
添	11	1	3	15	0.733333333333
流氓	3	11	1	15	0.733333333333
油价	3	11	1	15	0.733333333333
有钱	4	11	0	15	0.733333333333
最新	1	3	11	15	0.733333333333
撞	11	2	2	15	0.733333333333
拒绝	2	11	2	15	0.733333333333
动力	2	11	2	15	0.733333333333
生产	5	19	2	26	0.730769230769
感受	19	5	2	26	0.730769230769
低	9	27	1	37	0.72972972973
贴	48	9	9	66	0.727272727273
这里	16	6	0	22	0.727272727273
上路	4	16	2	22	0.727272727273
符合	3	8	0	11	0.727272727273
祥和	2	8	1	11	0.727272727273
清理	0	8	3	11	0.727272727273
清新	1	8	2	11	0.727272727273
晚婚晚育	2	8	1	11	0.727272727273
无证	8	1	2	11	0.727272727273
教	8	0	3	11	0.727272727273
排放	8	2	1	11	0.727272727273
库克	1	8	2	11	0.727272727273
城区	3	8	0	11	0.727272727273
医生	1	8	2	11	0.727272727273
加油	8	2	1	11	0.727272727273
到来	8	1	2	11	0.727272727273
别说	3	8	0	11	0.727272727273
产假	3	8	0	11	0.727272727273
不够	5	13	0	18	0.722222222222
中华	18	5	2	25	0.72
减少	12	46	6	64	0.71875
抓	8	25	2	35	0.714285714286
终于	20	4	4	28	0.714285714286
权利	3	15	3	21	0.714285714286
变成	5	15	1	21	0.714285714286
青春	3	1	10	14	0.714285714286
近	3	10	1	14	0.714285714286
浪费	3	10	1	14	0.714285714286
流畅	10	3	1	14	0.714285714286
民众	2	10	2	14	0.714285714286
新机	3	1	10	14	0.714285714286
姐妹	10	4	0	14	0.714285714286
大概	10	4	0	14	0.714285714286
团聚	10	3	1	14	0.714285714286
员工	2	2	10	14	0.714285714286
农村	10	3	1	14	0.714285714286
上市	2	2	10	14	0.714285714286
默默	5	2	0	7	0.714285714286
鬼	1	5	1	7	0.714285714286
难过	0	5	2	7	0.714285714286
都市	5	2	0	7	0.714285714286
逛庙会	5	1	1	7	0.714285714286
逗	2	0	5	7	0.714285714286
车祸	2	5	0	7	0.714285714286
舒服	5	2	0	7	0.714285714286
第	5	1	1	7	0.714285714286
祝愿	5	2	0	7	0.714285714286
确定	5	0	2	7	0.714285714286
眼中	5	1	1	7	0.714285714286
独特	5	1	1	7	0.714285714286
热热闹闹	5	2	0	7	0.714285714286
热热	5	2	0	7	0.714285714286
渣	2	5	0	7	0.714285714286
没错	5	2	0	7	0.714285714286
武	1	5	1	7	0.714285714286
最终	5	2	0	7	0.714285714286
晚安	1	5	1	7	0.714285714286
春季	2	0	5	7	0.714285714286
日前	0	5	2	7	0.714285714286
无能	1	5	1	7	0.714285714286
提	1	5	1	7	0.714285714286
控	5	0	2	7	0.714285714286
我市	0	2	5	7	0.714285714286
愿者	2	5	0	7	0.714285714286
心中	5	1	1	7	0.714285714286
布斯	1	5	1	7	0.714285714286
巴马	5	2	0	7	0.714285714286
安安	2	5	0	7	0.714285714286
奥巴马	5	2	0	7	0.714285714286
奥巴	5	2	0	7	0.714285714286
天上	5	2	0	7	0.714285714286
大幅	1	5	1	7	0.714285714286
大城市	5	1	1	7	0.714285714286
大城	5	1	1	7	0.714285714286
国产机	5	2	0	7	0.714285714286
喝	5	0	2	7	0.714285714286
味道	5	2	0	7	0.714285714286
发动	2	5	0	7	0.714285714286
半个	5	2	0	7	0.714285714286
到手	5	2	0	7	0.714285714286
几百	5	1	1	7	0.714285714286
农民	1	5	1	7	0.714285714286
休息	2	5	0	7	0.714285714286
令人	1	5	1	7	0.714285714286
代替	5	2	0	7	0.714285714286
乔布斯	1	5	1	7	0.714285714286
乔布	1	5	1	7	0.714285714286
主题	5	2	0	7	0.714285714286
中间	5	2	0	7	0.714285714286
严	1	1	5	7	0.714285714286
不顾	2	5	0	7	0.714285714286
百姓	17	59	7	83	0.710843373494
计划生育	6	27	5	38	0.710526315789
政	3	17	4	24	0.708333333333
载客	12	2	3	17	0.705882352941
国人	3	12	2	17	0.705882352941
刀切	2	12	3	17	0.705882352941
一刀切	2	12	3	17	0.705882352941
想想	5	19	3	27	0.703703703704
传统节日	26	4	7	37	0.702702702703
一家	14	4	2	20	0.7
规划	1	7	2	10	0.7
行人	7	3	0	10	0.7
苹果公司	1	2	7	10	0.7
祝福	7	2	1	10	0.7
生日	7	0	3	10	0.7
熊	3	7	0	10	0.7
满意	7	3	0	10	0.7
无疑	1	7	2	10	0.7
方法	0	7	3	10	0.7
房价	2	7	1	10	0.7
幼儿	7	3	0	10	0.7
对比	7	2	1	10	0.7
官方	0	7	3	10	0.7
动	7	2	1	10	0.7
其它	7	3	0	10	0.7
依据	1	7	2	10	0.7
上去	7	3	0	10	0.7
ios	7	0	3	10	0.7
文化	32	7	7	46	0.695652173913
伙伴	18	2	6	26	0.692307692308
驾驶	9	1	3	13	0.692307692308
重	1	9	3	13	0.692307692308
遭遇	0	4	9	13	0.692307692308
群众	3	9	1	13	0.692307692308
欢乐	2	9	2	13	0.692307692308
机会	9	2	2	13	0.692307692308
暴力	3	9	1	13	0.692307692308
故事	9	3	1	13	0.692307692308
收入	4	9	0	13	0.692307692308
库存	1	9	3	13	0.692307692308
咱	4	9	0	13	0.692307692308
共同	2	9	2	13	0.692307692308
难道	9	24	2	35	0.685714285714
适合	13	3	3	19	0.684210526316
大量	4	13	2	19	0.684210526316
女儿	15	5	2	22	0.681818181818
每	7	17	1	25	0.68
烟花爆竹	8	44	13	65	0.676923076923
饺子	25	7	5	37	0.675675675676
社会	15	56	12	83	0.674698795181
政府	29	89	15	133	0.669172932331
喜欢	64	18	14	96	0.666666666667
燃放烟花	7	32	9	48	0.666666666667
来说	28	8	6	42	0.666666666667
小伙伴	16	2	6	24	0.666666666667
年夜	14	3	4	21	0.666666666667
企业	4	14	3	21	0.666666666667
负责	2	12	4	18	0.666666666667
请问	3	12	3	18	0.666666666667
分析	4	2	12	18	0.666666666667
不知	12	3	3	18	0.666666666667
不仅	5	12	1	18	0.666666666667
留下	10	5	0	15	0.666666666667
猴	10	3	2	15	0.666666666667
旗舰	2	10	3	15	0.666666666667
尽	2	10	3	15	0.666666666667
好看	10	4	1	15	0.666666666667
多么	3	10	2	15	0.666666666667
元宵节	10	4	1	15	0.666666666667
亲	10	2	3	15	0.666666666667
迎来	8	1	3	12	0.666666666667
资源	2	8	2	12	0.666666666667
贡献	3	8	1	12	0.666666666667
战略	8	3	1	12	0.666666666667
当初	3	8	1	12	0.666666666667
庙会	8	2	2	12	0.666666666667
境内	8	1	3	12	0.666666666667
力量	8	4	0	12	0.666666666667
分析师	3	1	8	12	0.666666666667
侵略	4	8	0	12	0.666666666667
任务	8	4	0	12	0.666666666667
为啥	2	8	2	12	0.666666666667
顺产	6	2	1	9	0.666666666667
非机动	6	3	0	9	0.666666666667
铁口	6	1	2	9	0.666666666667
适应	6	0	3	9	0.666666666667
花钱	1	6	2	9	0.666666666667
者	3	6	0	9	0.666666666667
老妈	6	0	3	9	0.666666666667
罚	1	6	2	9	0.666666666667
管管	6	2	1	9	0.666666666667
算	6	2	1	9	0.666666666667
牌照	2	6	1	9	0.666666666667
求	6	1	2	9	0.666666666667
权益	2	6	1	9	0.666666666667
曝	6	1	2	9	0.666666666667
撤军	2	6	1	9	0.666666666667
技术	1	2	6	9	0.666666666667
扶持	2	6	1	9	0.666666666667
房	1	6	2	9	0.666666666667
很快	6	1	2	9	0.666666666667
弱势群体	3	6	0	9	0.666666666667
弱势	3	6	0	9	0.666666666667
干净	6	2	1	9	0.666666666667
屁	2	6	1	9	0.666666666667
地铁口	6	1	2	9	0.666666666667
土地	3	6	0	9	0.666666666667
哎	2	6	1	9	0.666666666667
和谐	2	6	1	9	0.666666666667
后台	6	3	0	9	0.666666666667
台	6	0	3	9	0.666666666667
卵	1	6	2	9	0.666666666667
催	6	0	3	9	0.666666666667
传承	6	2	1	9	0.666666666667
今年过年	1	6	2	9	0.666666666667
人人	2	6	1	9	0.666666666667
人为	2	6	1	9	0.666666666667
东突	6	1	2	9	0.666666666667
一批	1	6	2	9	0.666666666667
龙	4	1	1	6	0.666666666667
麻将	4	1	1	6	0.666666666667
风	0	2	4	6	0.666666666667
预产期	4	0	2	6	0.666666666667
预产	4	0	2	6	0.666666666667
面前	4	0	2	6	0.666666666667
阿富汗	4	1	1	6	0.666666666667
遗憾	4	2	0	6	0.666666666667
逆	4	1	1	6	0.666666666667
辣	4	1	1	6	0.666666666667
软件	4	0	2	6	0.666666666667
跳	4	1	1	6	0.666666666667
路权	0	4	2	6	0.666666666667
起码	4	1	1	6	0.666666666667
赞同	1	4	1	6	0.666666666667
负担	4	2	0	6	0.666666666667
试试	0	4	2	6	0.666666666667
觉悟	4	2	0	6	0.666666666667
观点	0	2	4	6	0.666666666667
观	1	4	1	6	0.666666666667
融融	4	1	1	6	0.666666666667
落后	1	4	1	6	0.666666666667
良好	4	0	2	6	0.666666666667
自身	4	2	0	6	0.666666666667
腊月	4	1	1	6	0.666666666667
脑袋	4	2	0	6	0.666666666667
聚会	4	0	2	6	0.666666666667
联系	2	0	4	6	0.666666666667
职业	1	4	1	6	0.666666666667
红火	4	2	0	6	0.666666666667
第四	2	0	4	6	0.666666666667
第一天	4	2	0	6	0.666666666667
突厥	4	1	1	6	0.666666666667
秀	4	0	2	6	0.666666666667
祖宗	4	2	0	6	0.666666666667
短信	0	4	2	6	0.666666666667
相反	1	4	1	6	0.666666666667
电脑	4	0	2	6	0.666666666667
生育权	1	4	1	6	0.666666666667
特区	1	4	1	6	0.666666666667
燃	1	4	1	6	0.666666666667
消耗	1	4	1	6	0.666666666667
比起	4	1	1	6	0.666666666667
残	1	4	1	6	0.666666666667
梅	4	1	1	6	0.666666666667
格	4	2	0	6	0.666666666667
杨	1	4	1	6	0.666666666667
权	1	4	1	6	0.666666666667
普遍	2	4	0	6	0.666666666667
晚报	0	4	2	6	0.666666666667
日常生活	1	4	1	6	0.666666666667
族	0	4	2	6	0.666666666667
新鲜	0	4	2	6	0.666666666667
新生	4	0	2	6	0.666666666667
攻击	4	2	0	6	0.666666666667
改装	4	1	1	6	0.666666666667
提出	1	4	1	6	0.666666666667
排号	1	4	1	6	0.666666666667
挣钱	4	2	0	6	0.666666666667
指出	2	4	0	6	0.666666666667
批评	4	2	0	6	0.666666666667
想象	4	2	0	6	0.666666666667
情绪	4	1	1	6	0.666666666667
志愿者	2	4	0	6	0.666666666667
引力	2	4	0	6	0.666666666667
弄死	0	4	2	6	0.666666666667
延续	2	4	0	6	0.666666666667
年画	4	1	1	6	0.666666666667
平平安安	2	4	0	6	0.666666666667
平平	2	4	0	6	0.666666666667
常生	1	4	1	6	0.666666666667
常	4	0	2	6	0.666666666667
巴尔米	4	1	1	6	0.666666666667
巴尔	4	1	1	6	0.666666666667
工厂	4	1	1	6	0.666666666667
实力	4	2	0	6	0.666666666667
守	1	4	1	6	0.666666666667
媒	2	0	4	6	0.666666666667
娶	0	4	2	6	0.666666666667
好玩	4	2	0	6	0.666666666667
好久	4	2	0	6	0.666666666667
央视	0	4	2	6	0.666666666667
大都	4	1	1	6	0.666666666667
大屏幕	4	1	1	6	0.666666666667
外地	1	4	1	6	0.666666666667
圣诞	4	1	1	6	0.666666666667
团结	2	4	0	6	0.666666666667
嗯	4	1	1	6	0.666666666667
啥时候	2	4	0	6	0.666666666667
响声	1	4	1	6	0.666666666667
吸引力	2	4	0	6	0.666666666667
同事	4	1	1	6	0.666666666667
司机	4	1	1	6	0.666666666667
发起	4	2	0	6	0.666666666667
发言人	4	2	0	6	0.666666666667
反映	1	4	1	6	0.666666666667
千	4	1	1	6	0.666666666667
十万	0	4	2	6	0.666666666667
办理	4	0	2	6	0.666666666667
刘	1	4	1	6	0.666666666667
凭	4	0	2	6	0.666666666667
几次	4	1	1	6	0.666666666667
其乐融融	4	1	1	6	0.666666666667
公平	1	1	4	6	0.666666666667
保险	4	0	2	6	0.666666666667
俗称	4	0	2	6	0.666666666667
作用	2	4	0	6	0.666666666667
伤害	2	4	0	6	0.666666666667
伤	1	4	1	6	0.666666666667
优秀	4	1	1	6	0.666666666667
价位	2	4	0	6	0.666666666667
仗	4	2	0	6	0.666666666667
产期	4	0	2	6	0.666666666667
买到	2	4	0	6	0.666666666667
乐融融	4	1	1	6	0.666666666667
中队	4	0	2	6	0.666666666667
两轮	1	4	1	6	0.666666666667
不许	2	4	0	6	0.666666666667
不准	2	4	0	6	0.666666666667
一线	2	4	0	6	0.666666666667
一代人	1	4	1	6	0.666666666667
k	4	1	1	6	0.666666666667
恐怖分子	44	19	4	67	0.65671641791
钱	14	34	4	52	0.653846153846
送	15	34	3	52	0.653846153846
幸福	17	7	2	26	0.653846153846
放烟	7	32	10	49	0.65306122449
打击	26	10	4	40	0.65
小时	26	10	4	40	0.65
避免	3	4	13	20	0.65
营运	13	1	6	20	0.65
群体	5	13	2	20	0.65
续航	13	6	1	20	0.65
得到	5	13	2	20	0.65
允许	4	13	3	20	0.65
做法	6	13	1	20	0.65
人员	1	13	6	20	0.65
一刀	3	13	4	20	0.65
女性	9	24	4	37	0.648648648649
爆竹	15	68	22	105	0.647619047619
销量	4	2	11	17	0.647058823529
贵	2	11	4	17	0.647058823529
老家	11	3	3	17	0.647058823529
方便	11	5	1	17	0.647058823529
当年	5	11	1	17	0.647058823529
干嘛	5	11	1	17	0.647058823529
声音	3	11	3	17	0.647058823529
和平	11	2	4	17	0.647058823529
听说	4	11	2	17	0.647058823529
办	11	5	1	17	0.647058823529
霾	12	47	14	73	0.643835616438
哦	18	6	4	28	0.642857142857
赶紧	9	3	2	14	0.642857142857
详情	9	3	2	14	0.642857142857
节奏	9	5	0	14	0.642857142857
统一	2	9	3	14	0.642857142857
现代	9	1	4	14	0.642857142857
某些	4	9	1	14	0.642857142857
忙	9	4	1	14	0.642857142857
心里	4	9	1	14	0.642857142857
市	1	9	4	14	0.642857142857
压岁钱	9	0	5	14	0.642857142857
压岁	9	0	5	14	0.642857142857
加强	5	9	0	14	0.642857142857
剥夺	3	9	2	14	0.642857142857
再生	9	3	2	14	0.642857142857
一起	41	11	12	64	0.640625
活	6	16	3	25	0.64
意思	16	7	2	25	0.64
小伙	16	3	6	25	0.64
增加	5	23	8	36	0.638888888889
今年	30	99	26	155	0.638709677419
解决	14	30	3	47	0.63829787234
经济	7	30	10	47	0.63829787234
分子	49	22	6	77	0.636363636364
开心	21	7	5	33	0.636363636364
服务	3	14	5	22	0.636363636364
需	2	2	7	11	0.636363636364
违规	7	3	1	11	0.636363636364
该不该	1	3	7	11	0.636363636364
表	0	7	4	11	0.636363636364
行政	7	4	0	11	0.636363636364
监管	2	7	2	11	0.636363636364
模式	2	7	2	11	0.636363636364
样子	7	3	1	11	0.636363636364
李	7	2	2	11	0.636363636364
春	7	2	2	11	0.636363636364
无奈	3	7	1	11	0.636363636364
提供	7	0	4	11	0.636363636364
指数	1	7	3	11	0.636363636364
所有人	7	3	1	11	0.636363636364
守岁	7	2	2	11	0.636363636364
婴儿	7	1	3	11	0.636363636364
大力	3	7	1	11	0.636363636364
哈尔滨	1	7	3	11	0.636363636364
哈尔	1	7	3	11	0.636363636364
发言	7	3	1	11	0.636363636364
制度	3	7	1	11	0.636363636364
作	7	1	3	11	0.636363636364
代人	2	7	2	11	0.636363636364
从来	3	7	1	11	0.636363636364
touch	2	7	2	11	0.636363636364
她	26	5	10	41	0.634146341463
玫瑰	12	5	2	19	0.631578947368
梦想	12	4	3	19	0.631578947368
成本	2	12	5	19	0.631578947368
倒	12	6	1	19	0.631578947368
谁	18	44	8	70	0.628571428571
车	8	30	10	48	0.625
民族	25	10	5	40	0.625
老龄化	5	10	1	16	0.625
老龄	5	10	1	16	0.625
实施	10	4	2	16	0.625
中心	10	4	2	16	0.625
高中	2	5	1	8	0.625
领空	5	2	1	8	0.625
预订	2	1	5	8	0.625
韩	5	1	2	8	0.625
非机动车	5	3	0	8	0.625
说话	5	2	1	8	0.625
良心	5	2	1	8	0.625
老二	5	2	1	8	0.625
粉	1	2	5	8	0.625
称为	1	2	5	8	0.625
离	1	5	2	8	0.625
疼	5	2	1	8	0.625
猪	5	3	0	8	0.625
特种	3	5	0	8	0.625
灯笼	5	1	2	8	0.625
淘汰	5	2	1	8	0.625
法治	1	5	2	8	0.625
比例	5	1	2	8	0.625
月初	5	2	1	8	0.625
更为	0	5	3	8	0.625
新疆	5	2	1	8	0.625
数量	5	1	2	8	0.625
挤	5	3	0	8	0.625
报复	5	3	0	8	0.625
折腾	5	2	1	8	0.625
想法	5	1	2	8	0.625
悲哀	2	5	1	8	0.625
悲剧	2	5	1	8	0.625
怒	5	1	2	8	0.625
形势	1	5	2	8	0.625
弱	5	1	2	8	0.625
干什么	1	5	2	8	0.625
工业	5	2	1	8	0.625
小宝	5	2	1	8	0.625
尊重	3	5	0	8	0.625
害怕	5	2	1	8	0.625
客户	1	5	2	8	0.625
好意思	5	2	1	8	0.625
好意	5	2	1	8	0.625
多月	5	1	2	8	0.625
外国	3	5	0	8	0.625
增长	1	5	2	8	0.625
在于	0	5	3	8	0.625
国家标准	0	3	5	8	0.625
名义	2	5	1	8	0.625
各地	2	5	1	8	0.625
叔叔	5	3	0	8	0.625
出发	2	5	1	8	0.625
借口	2	5	1	8	0.625
人民日报	2	5	1	8	0.625
不禁	5	3	0	8	0.625
下一代	3	5	0	8	0.625
一部分	5	2	1	8	0.625
一段	5	2	1	8	0.625
一方面	2	5	1	8	0.625
一位	1	5	2	8	0.625
挺	28	10	7	45	0.622222222222
恐怖	74	34	11	119	0.621848739496
骑	8	23	6	37	0.621621621622
地铁	23	6	8	37	0.621621621622
简单	4	18	7	29	0.620689655172
哈哈	18	9	2	29	0.620689655172
汽车	16	39	8	63	0.619047619048
过节	5	13	3	21	0.619047619048
根据	4	4	13	21	0.619047619048
数据	4	4	13	21	0.619047619048
意识	6	13	2	21	0.619047619048
尺寸	13	3	5	21	0.619047619048
实在	13	7	1	21	0.619047619048
味儿	13	6	2	21	0.619047619048
节日	45	13	15	73	0.616438356164
雾	12	40	13	65	0.615384615385
不错	24	6	9	39	0.615384615385
毛子	8	16	2	26	0.615384615385
明显	5	16	5	26	0.615384615385
谢谢	8	2	3	13	0.615384615385
警察	5	8	0	13	0.615384615385
脑子	3	8	2	13	0.615384615385
石油	8	4	1	13	0.615384615385
知	8	2	3	13	0.615384615385
真不	5	8	0	13	0.615384615385
消费者	2	3	8	13	0.615384615385
按	2	8	3	13	0.615384615385
广	2	8	3	13	0.615384615385
博弈	3	8	2	13	0.615384615385
做到	3	8	2	13	0.615384615385
俄军	8	3	2	13	0.615384615385
你家	8	3	2	13	0.615384615385
严查	8	1	4	13	0.615384615385
不容	2	8	3	13	0.615384615385
英寸	5	7	19	31	0.612903225806
计划	11	30	8	49	0.612244897959
人口	12	30	7	49	0.612244897959
觉得	66	28	14	108	0.611111111111
回家	33	11	10	54	0.611111111111
相关	4	11	3	18	0.611111111111
奖励	4	11	3	18	0.611111111111
力	5	11	2	18	0.611111111111
值得	11	4	3	18	0.611111111111
上班	4	11	3	18	0.611111111111
道路	3	14	6	23	0.608695652174
老人	8	14	1	23	0.608695652174
本	6	14	3	23	0.608695652174
新春	4	14	5	23	0.608695652174
反	7	14	2	23	0.608695652174
吃	43	17	11	71	0.605633802817
不放	8	23	7	38	0.605263157895
根本	13	26	4	43	0.604651162791
空气	26	63	16	105	0.6
呼吁	13	27	5	45	0.6
到底	6	21	8	35	0.6
垃圾	8	15	2	25	0.6
假	9	15	1	25	0.6
记得	12	6	2	20	0.6
爸爸	12	2	6	20	0.6
燃放鞭炮	6	12	2	20	0.6
更是	7	12	1	20	0.6
处理	4	12	4	20	0.6
责任	6	9	0	15	0.6
苦	2	9	4	15	0.6
老公	9	3	3	15	0.6
普	6	9	0	15	0.6
拉客	9	4	2	15	0.6
学	3	9	3	15	0.6
俄国	4	9	2	15	0.6
任	3	3	9	15	0.6
须	1	3	6	10	0.6
难以	3	6	1	10	0.6
降低	2	6	2	10	0.6
逻辑	3	6	1	10	0.6
调整	2	6	2	10	0.6
节	6	4	0	10	0.6
精神	3	6	1	10	0.6
白	6	2	2	10	0.6
独立	4	6	0	10	0.6
没想到	2	6	2	10	0.6
没想	2	6	2	10	0.6
没人	6	3	1	10	0.6
平时	6	3	1	10	0.6
居民	4	6	0	10	0.6
娱乐	6	2	2	10	0.6
好友	6	3	1	10	0.6
哈	6	3	1	10	0.6
发达	6	3	1	10	0.6
加入	6	3	1	10	0.6
军队	6	2	2	10	0.6
再说	4	6	0	10	0.6
内容	6	1	3	10	0.6
公里	3	6	1	10	0.6
付出	3	6	1	10	0.6
今	2	6	2	10	0.6
不再	6	2	2	10	0.6
一周	6	1	3	10	0.6
鲜花	3	1	1	5	0.6
高调	1	3	1	5	0.6
首发	1	1	3	5	0.6
饭	1	3	1	5	0.6
食品	2	3	0	5	0.6
额	0	3	2	5	0.6
颜色	1	1	3	5	0.6
领导人	2	3	0	5	0.6
音乐	3	0	2	5	0.6
青岛	1	3	1	5	0.6
零部件	0	3	2	5	0.6
间	3	2	0	5	0.6
遭殃	2	3	0	5	0.6
遇到	3	0	2	5	0.6
逐渐	3	0	2	5	0.6
送到	2	3	0	5	0.6
这年头	1	3	1	5	0.6
达成	1	3	1	5	0.6
达姆	2	3	0	5	0.6
轻松	3	1	1	5	0.6
轻易	3	2	0	5	0.6
轰炸机	3	2	0	5	0.6
路边	3	1	1	5	0.6
超生	2	3	0	5	0.6
走路	2	3	0	5	0.6
调	3	1	1	5	0.6
诸多	2	3	0	5	0.6
该禁	3	2	0	5	0.6
诚意	2	3	0	5	0.6
论坛	3	1	1	5	0.6
认识	3	2	0	5	0.6
认	2	3	0	5	0.6
警方	0	3	2	5	0.6
见到	3	0	2	5	0.6
要死	3	1	1	5	0.6
补充	3	2	0	5	0.6
蛮	3	1	1	5	0.6
萨达姆	2	3	0	5	0.6
花样	1	3	1	5	0.6
芯片	2	3	0	5	0.6
舞龙	3	1	1	5	0.6
自动	0	3	2	5	0.6
联	3	1	1	5	0.6
聊天	3	1	1	5	0.6
耍流氓	1	3	1	5	0.6
老婆	1	3	1	5	0.6
绝	2	3	0	5	0.6
经验	1	1	3	5	0.6
第二天	1	3	1	5	0.6
窗外	3	2	0	5	0.6
穆斯	3	2	0	5	0.6
私家车	3	2	0	5	0.6
私家	3	2	0	5	0.6
礼物	3	1	1	5	0.6
眼睛	3	1	1	5	0.6
眼看	1	3	1	5	0.6
眼	1	3	1	5	0.6
相当于	1	1	3	5	0.6
百	1	3	1	5	0.6
癌	1	3	1	5	0.6
疑问	2	3	0	5	0.6
电源	1	3	1	5	0.6
用来	1	3	1	5	0.6
用惯	3	2	0	5	0.6
环保部	1	3	1	5	0.6
特点	3	1	1	5	0.6
爷爷	3	1	1	5	0.6
父亲	3	1	1	5	0.6
爆竹声	1	3	1	5	0.6
烧香	3	1	1	5	0.6
点燃	2	3	0	5	0.6
灾难	1	3	1	5	0.6
激动	2	3	0	5	0.6
演戏	3	1	1	5	0.6
演	3	1	1	5	0.6
满	3	2	0	5	0.6
溪	3	1	1	5	0.6
混	3	0	2	5	0.6
涉	2	0	3	5	0.6
测试	1	1	3	5	0.6
派出所	3	1	1	5	0.6
油	3	1	1	5	0.6
每月	3	1	1	5	0.6
正月初一	3	1	1	5	0.6
欧	3	2	0	5	0.6
棒	2	3	0	5	0.6
标	2	3	0	5	0.6
果然	3	2	0	5	0.6
松动	3	1	1	5	0.6
暴政	3	2	0	5	0.6
暗	2	3	0	5	0.6
晒	3	1	1	5	0.6
春风	3	1	1	5	0.6
明年	3	2	0	5	0.6
早日	3	1	1	5	0.6
无辜	2	3	0	5	0.6
无意	3	1	1	5	0.6
新政	1	1	3	5	0.6
斯拉	3	2	0	5	0.6
改革开放	1	3	1	5	0.6
收缴	0	3	2	5	0.6
摊	3	1	1	5	0.6
搭	1	3	1	5	0.6
推翻	3	2	0	5	0.6
挑战	3	2	0	5	0.6
拼命	1	3	1	5	0.6
投资	1	1	3	5	0.6
扩散	1	3	1	5	0.6
打扫卫生	2	3	0	5	0.6
戴	3	1	1	5	0.6
戳	3	0	2	5	0.6
成绩	3	0	2	5	0.6
愿	2	0	3	5	0.6
想买	2	3	0	5	0.6
情怀	2	3	0	5	0.6
恶化	2	3	0	5	0.6
性质	3	0	2	5	0.6
忽悠	2	3	0	5	0.6
志	0	2	3	5	0.6
德	2	3	0	5	0.6
微笑	3	2	0	5	0.6
很少	3	2	0	5	0.6
很多年	2	3	0	5	0.6
当前	1	3	1	5	0.6
当于	1	1	3	5	0.6
强硬	0	2	3	5	0.6
引	1	1	3	5	0.6
开开	3	2	0	5	0.6
开启	3	2	0	5	0.6
年饭	3	2	0	5	0.6
年头	1	3	1	5	0.6
市政府	2	3	0	5	0.6
市政	2	3	0	5	0.6
屌	3	1	1	5	0.6
屁股	2	3	0	5	0.6
尽情	3	2	0	5	0.6
尽快	3	0	2	5	0.6
就行了	1	3	1	5	0.6
小年夜	3	1	1	5	0.6
小学生	1	3	1	5	0.6
对付	1	3	1	5	0.6
室友	3	0	2	5	0.6
实际上	3	2	0	5	0.6
定义	3	1	1	5	0.6
孤独	3	2	0	5	0.6
子	3	1	1	5	0.6
妨碍	2	3	0	5	0.6
好听	2	3	0	5	0.6
奇	1	1	3	5	0.6
大妈	1	3	1	5	0.6
大众	0	3	2	5	0.6
多彩	3	1	1	5	0.6
增	0	3	2	5	0.6
回忆	2	3	0	5	0.6
回到	3	1	1	5	0.6
噪声	0	3	2	5	0.6
喜气	3	2	0	5	0.6
哪怕	2	3	0	5	0.6
咱们	3	2	0	5	0.6
和谈	3	2	0	5	0.6
后悔	3	2	0	5	0.6
同胞	0	3	2	5	0.6
合格	0	3	2	5	0.6
可见	3	2	0	5	0.6
厉害	3	2	0	5	0.6
卷	2	3	0	5	0.6
南山	3	0	2	5	0.6
单独	3	2	0	5	0.6
协调	2	3	0	5	0.6
升高	2	3	0	5	0.6
十字军	3	2	0	5	0.6
医疗	1	3	1	5	0.6
动静	0	3	2	5	0.6
加重	0	3	2	5	0.6
出动	3	0	2	5	0.6
冷	3	2	0	5	0.6
兴	1	3	1	5	0.6
公交车	3	2	0	5	0.6
全年	3	1	1	5	0.6
催生	0	3	2	5	0.6
停车	1	3	1	5	0.6
做生意	3	2	0	5	0.6
信仰	3	2	0	5	0.6
便于	2	3	0	5	0.6
供应链	0	3	2	5	0.6
佳	3	0	2	5	0.6
位置	1	3	1	5	0.6
会儿	1	3	1	5	0.6
他妈的	2	3	0	5	0.6
介入	1	3	1	5	0.6
今天上午	3	2	0	5	0.6
亿	2	3	0	5	0.6
人民币	2	0	3	5	0.6
京东	3	1	1	5	0.6
产妇	3	1	1	5	0.6
二轮	3	1	1	5	0.6
二房	0	2	3	5	0.6
二天	1	3	1	5	0.6
二十年	3	2	0	5	0.6
事实上	1	3	1	5	0.6
事业	2	3	0	5	0.6
乎	1	1	3	5	0.6
之际	3	2	0	5	0.6
之中	1	1	3	5	0.6
举行	3	1	1	5	0.6
丰富多彩	3	1	1	5	0.6
中低	0	3	2	5	0.6
两家	1	3	1	5	0.6
东部	0	3	2	5	0.6
专门	1	3	1	5	0.6
上下班	2	3	0	5	0.6
三百余	3	0	2	5	0.6
一路	2	3	0	5	0.6
一模一样	0	3	2	5	0.6
一对	1	1	3	5	0.6
一会儿	1	3	1	5	0.6
一个月	3	1	1	5	0.6
一两	3	1	1	5	0.6
oppo	3	1	1	5	0.6
