WORD	FAVOR	AGAINST	NONE	FREQ	SUPPORT
单手	13	0	0	13	1.0
生存	0	12	0	12	1.0
底层	0	10	0	10	1.0
劳动力	0	10	0	10	1.0
同一	0	0	8	8	1.0
做起	0	8	0	8	1.0
龙岗	7	0	0	7	1.0
生就	0	7	0	7	1.0
环保局	0	7	0	7	1.0
时间表	0	0	7	7	1.0
单手操作	7	0	0	7	1.0
退	0	6	0	6	1.0
解决问题	0	6	0	6	1.0
节约	0	6	0	6	1.0
稳定	6	0	0	6	1.0
法律依据	0	6	0	6	1.0
民众	0	6	0	6	1.0
正好	6	0	0	6	1.0
普通	0	6	0	6	1.0
少女	0	0	6	6	1.0
婚假	0	6	0	6	1.0
医生	0	6	0	6	1.0
几千年	6	0	0	6	1.0
几千	6	0	0	6	1.0
中秋	6	0	0	6	1.0
远离	0	5	0	5	1.0
超女	0	0	5	5	1.0
美少女	0	0	5	5	1.0
红绿灯	5	0	0	5	1.0
红绿	5	0	0	5	1.0
端午节	5	0	0	5	1.0
端午	5	0	0	5	1.0
秋节	5	0	0	5	1.0
爸爸妈妈	5	0	0	5	1.0
清新	0	5	0	5	1.0
淡	5	0	0	5	1.0
没收	0	5	0	5	1.0
比比皆是	5	0	0	5	1.0
比比	5	0	0	5	1.0
无敌	0	0	5	5	1.0
延迟	0	5	0	5	1.0
巫术	5	0	0	5	1.0
尊重	0	5	0	5	1.0
安安	0	5	0	5	1.0
大宝	5	0	0	5	1.0
团圆饭	5	0	0	5	1.0
再也	0	5	0	5	1.0
中秋节	5	0	0	5	1.0
三年	5	0	0	5	1.0
默默	4	0	0	4	1.0
门神	4	0	0	4	1.0
路权	0	4	0	4	1.0
证	0	4	0	4	1.0
觉	0	4	0	4	1.0
花钱	0	4	0	4	1.0
腐败	0	4	0	4	1.0
胜	4	0	0	4	1.0
老伴	0	0	4	4	1.0
精力	4	0	0	4	1.0
粮食	0	4	0	4	1.0
移风易俗	0	4	0	4	1.0
炸弹	0	4	0	4	1.0
灯笼	4	0	0	4	1.0
温和	4	0	0	4	1.0
污染物	0	4	0	4	1.0
杀人	0	4	0	4	1.0
有趣	4	0	0	4	1.0
有害	0	4	0	4	1.0
月饼	4	0	0	4	1.0
最底层	0	4	0	4	1.0
易俗	0	4	0	4	1.0
无能	0	4	0	4	1.0
救	0	4	0	4	1.0
效率	0	4	0	4	1.0
操	0	4	0	4	1.0
拜神	4	0	0	4	1.0
扰民	0	4	0	4	1.0
心想	4	0	0	4	1.0
录制	4	0	0	4	1.0
开除	4	0	0	4	1.0
平平安安	0	4	0	4	1.0
平平	0	4	0	4	1.0
布	4	0	0	4	1.0
小小	4	0	0	4	1.0
对此	0	0	4	4	1.0
宝贝	4	0	0	4	1.0
嫌弃	4	0	0	4	1.0
培训	4	0	0	4	1.0
圣诞节	4	0	0	4	1.0
噢	4	0	0	4	1.0
品	4	0	0	4	1.0
吉	4	0	0	4	1.0
各地	0	4	0	4	1.0
口号	0	4	0	4	1.0
发动	0	4	0	4	1.0
原始社会	0	4	0	4	1.0
原始	0	4	0	4	1.0
压	0	4	0	4	1.0
厂家	0	4	0	4	1.0
危害	0	4	0	4	1.0
千多	0	4	0	4	1.0
刹车	4	0	0	4	1.0
典型	0	4	0	4	1.0
公	4	0	0	4	1.0
儿时	4	0	0	4	1.0
傻子	0	4	0	4	1.0
做点事	0	4	0	4	1.0
偏	0	4	0	4	1.0
低收入	0	4	0	4	1.0
伤害	0	4	0	4	1.0
传说	4	0	0	4	1.0
人力	0	4	0	4	1.0
五千	4	0	0	4	1.0
乱窜	4	0	0	4	1.0
买车	0	4	0	4	1.0
买得起	0	4	0	4	1.0
买得	0	4	0	4	1.0
九件	4	0	0	4	1.0
乖	4	0	0	4	1.0
之下	0	4	0	4	1.0
义务	0	4	0	4	1.0
主力	0	4	0	4	1.0
严峻	0	4	0	4	1.0
一阵	4	0	0	4	1.0
高价	0	3	0	3	1.0
香味	3	0	0	3	1.0
顶	0	3	0	3	1.0
面积	0	3	0	3	1.0
青年	0	3	0	3	1.0
青	3	0	0	3	1.0
霸道	0	3	0	3	1.0
雪上加霜	0	3	0	3	1.0
雪上	0	3	0	3	1.0
难题	0	0	3	3	1.0
阳光	3	0	0	3	1.0
送给	3	0	0	3	1.0
进去	0	3	0	3	1.0
这部	3	0	0	3	1.0
运输	0	3	0	3	1.0
辆车	0	0	3	3	1.0
车尾	3	0	0	3	1.0
跟不上	0	3	0	3	1.0
走向	0	3	0	3	1.0
赖以生存	0	3	0	3	1.0
赖以	0	3	0	3	1.0
资金	0	0	3	3	1.0
调皮	3	0	0	3	1.0
说到底	0	3	0	3	1.0
观看	0	0	3	3	1.0
蓝天白云	0	3	0	3	1.0
蓝	0	3	0	3	1.0
莫斯科	3	0	0	3	1.0
药丸	0	3	0	3	1.0
草泥马	0	3	0	3	1.0
茶	3	0	0	3	1.0
脚踏	3	0	0	3	1.0
聪明	3	0	0	3	1.0
联系	0	0	3	3	1.0
聊聊	0	0	3	3	1.0
老祖宗	3	0	0	3	1.0
老祖	3	0	0	3	1.0
耀	3	0	0	3	1.0
美食	3	0	0	3	1.0
罚钱	0	3	0	3	1.0
罗拉	0	0	3	3	1.0
绝大	3	0	0	3	1.0
组	0	3	0	3	1.0
纳	3	0	0	3	1.0
纯属	3	0	0	3	1.0
繁殖	0	3	0	3	1.0
第二次	0	0	3	3	1.0
窗花	3	0	0	3	1.0
种种	0	0	3	3	1.0
私人	0	3	0	3	1.0
祝贺	3	0	0	3	1.0
瞎	3	0	0	3	1.0
看上去	3	0	0	3	1.0
看上	3	0	0	3	1.0
直闯	3	0	0	3	1.0
直升机	0	3	0	3	1.0
直升	0	3	0	3	1.0
白云	0	3	0	3	1.0
疙瘩	3	0	0	3	1.0
疏	0	3	0	3	1.0
由来	3	0	0	3	1.0
环保部门	0	3	0	3	1.0
玩意儿	0	3	0	3	1.0
爆发	0	3	0	3	1.0
焦点	0	0	3	3	1.0
浓度	0	3	0	3	1.0
济南市	0	3	0	3	1.0
洋	3	0	0	3	1.0
没见	3	0	0	3	1.0
汽车尾气	3	0	0	3	1.0
汤圆	3	0	0	3	1.0
氧化	0	3	0	3	1.0
民百	0	3	0	3	1.0
毫无疑问	0	3	0	3	1.0
每月	3	0	0	3	1.0
步伐	3	0	0	3	1.0
横冲直闯	3	0	0	3	1.0
格局	3	0	0	3	1.0
条例	0	3	0	3	1.0
本土	0	0	3	3	1.0
朗德	3	0	0	3	1.0
有害物质	0	3	0	3	1.0
有害物	0	3	0	3	1.0
月子	3	0	0	3	1.0
普特	0	3	0	3	1.0
早晚	3	0	0	3	1.0
新浪网	0	3	0	3	1.0
新文化	0	0	3	3	1.0
新文	0	0	3	3	1.0
新意	0	3	0	3	1.0
斯拉	3	0	0	3	1.0
放下	0	3	0	3	1.0
收费	0	3	0	3	1.0
撤	0	3	0	3	1.0
摩托罗拉	0	0	3	3	1.0
搭载	0	0	3	3	1.0
指挥	3	0	0	3	1.0
托罗	0	0	3	3	1.0
成效	0	3	0	3	1.0
意愿	0	3	0	3	1.0
想干什么	0	3	0	3	1.0
情结	0	3	0	3	1.0
情景	3	0	0	3	1.0
恩	3	0	0	3	1.0
总理	0	0	3	3	1.0
思路	0	3	0	3	1.0
循环	0	3	0	3	1.0
待产	3	0	0	3	1.0
彼此	3	0	0	3	1.0
当权	0	3	0	3	1.0
强调	3	0	0	3	1.0
引燃	0	0	3	3	1.0
延长	0	3	0	3	1.0
度蜜月	0	3	0	3	1.0
平民百姓	0	3	0	3	1.0
干的事	3	0	0	3	1.0
幕后	3	0	0	3	1.0
帝都	0	3	0	3	1.0
差点	3	0	0	3	1.0
尚	0	0	3	3	1.0
小小的	3	0	0	3	1.0
对内	0	3	0	3	1.0
家门口	0	3	0	3	1.0
家门	0	3	0	3	1.0
害苦	0	3	0	3	1.0
宁	0	3	0	3	1.0
季度	0	0	3	3	1.0
妥协	0	3	0	3	1.0
如果说	0	3	0	3	1.0
如意	3	0	0	3	1.0
奇怪	3	0	0	3	1.0
夫	0	3	0	3	1.0
太贵	0	3	0	3	1.0
大气污染	0	3	0	3	1.0
大叔	3	0	0	3	1.0
夜	3	0	0	3	1.0
多次	0	3	0	3	1.0
备货	0	0	3	3	1.0
备	3	0	0	3	1.0
增多	0	3	0	3	1.0
城管	0	3	0	3	1.0
固然	0	3	0	3	1.0
困难	3	0	0	3	1.0
回老家	3	0	0	3	1.0
四季	0	0	3	3	1.0
喷子	3	0	0	3	1.0
售	0	3	0	3	1.0
吓死	3	0	0	3	1.0
名义	0	3	0	3	1.0
合家	3	0	0	3	1.0
台湾	0	0	3	3	1.0
可见	3	0	0	3	1.0
发扬	3	0	0	3	1.0
南市	0	3	0	3	1.0
单身	0	0	3	3	1.0
协议	0	3	0	3	1.0
升机	0	3	0	3	1.0
十足	3	0	0	3	1.0
北京市	0	0	3	3	1.0
勇气	0	3	0	3	1.0
势必	0	3	0	3	1.0
加以	0	0	3	3	1.0
前面	3	0	0	3	1.0
到时候	0	3	0	3	1.0
创造	0	3	0	3	1.0
出去玩	3	0	0	3	1.0
凑个	3	0	0	3	1.0
冒充	3	0	0	3	1.0
养不起	0	3	0	3	1.0
共享	3	0	0	3	1.0
公益	0	3	0	3	1.0
公斤	0	3	0	3	1.0
充分	0	3	0	3	1.0
侵略战争	0	3	0	3	1.0
低估	3	0	0	3	1.0
优雅	3	0	0	3	1.0
伊	3	0	0	3	1.0
人群	0	3	0	3	1.0
亲属	3	0	0	3	1.0
亮	3	0	0	3	1.0
京市	0	0	3	3	1.0
享有	0	3	0	3	1.0
五千年	3	0	0	3	1.0
互联	0	3	0	3	1.0
二次	0	0	3	3	1.0
争论	0	0	3	3	1.0
买房	0	3	0	3	1.0
买卖	0	3	0	3	1.0
主权	3	0	0	3	1.0
丹	3	0	0	3	1.0
中学	0	3	0	3	1.0
专用	0	0	3	3	1.0
不值	0	0	3	3	1.0
不为	0	3	0	3	1.0
下滑	0	3	0	3	1.0
上牌	0	3	0	3	1.0
上涨	0	3	0	3	1.0
一家亲	3	0	0	3	1.0
r46hp1p	0	0	3	3	1.0
龙舟	2	0	0	2	1.0
黔驴技穷	0	2	0	2	1.0
黔驴	0	2	0	2	1.0
黑白	2	0	0	2	1.0
黎明	2	0	0	2	1.0
麻痹	0	2	0	2	1.0
鲜血	0	2	0	2	1.0
鲜	0	0	2	2	1.0
高血压	2	0	0	2	1.0
高手	2	0	0	2	1.0
高峰期	2	0	0	2	1.0
高价位	0	2	0	2	1.0
骨	0	2	0	2	1.0
骚	0	0	2	2	1.0
骑行	0	2	0	2	1.0
驾驶证	2	0	0	2	1.0
驾	0	2	0	2	1.0
饭碗	0	2	0	2	1.0
食	0	2	0	2	1.0
飞速	2	0	0	2	1.0
飙升	0	2	0	2	1.0
颠倒黑白	2	0	0	2	1.0
颠倒	2	0	0	2	1.0
颜色	0	0	2	2	1.0
颗粒	0	2	0	2	1.0
颇	2	0	0	2	1.0
预示	0	2	0	2	1.0
预报	0	2	0	2	1.0
颁布	2	0	0	2	1.0
顺手	2	0	0	2	1.0
面上	0	2	0	2	1.0
非要	0	2	0	2	1.0
霸占	2	0	0	2	1.0
霉	2	0	0	2	1.0
雅	0	0	2	2	1.0
陕西	0	2	0	2	1.0
阿姨	2	0	0	2	1.0
阿勒颇	2	0	0	2	1.0
阿勒	2	0	0	2	1.0
阻碍	2	0	0	2	1.0
阶层	0	2	0	2	1.0
阵风	2	0	0	2	1.0
阴影	0	2	0	2	1.0
阳	0	2	0	2	1.0
防御	2	0	0	2	1.0
闻到	2	0	0	2	1.0
闪烁	0	2	0	2	1.0
长龙	2	0	0	2	1.0
长年	0	0	2	2	1.0
长假	0	0	2	2	1.0
锻炼	2	0	0	2	1.0
锅铲	0	0	2	2	1.0
销售额	0	0	2	2	1.0
重担	0	2	0	2	1.0
酿成	2	0	0	2	1.0
酒肉	0	2	0	2	1.0
郑渊洁	0	2	0	2	1.0
郑	0	0	2	2	1.0
那天	2	0	0	2	1.0
遇冷	0	0	2	2	1.0
遇上	0	2	0	2	1.0
逮	0	2	0	2	1.0
通	2	0	0	2	1.0
途	2	0	0	2	1.0
透露	0	0	2	2	1.0
逊尼派	0	2	0	2	1.0
逊尼	0	2	0	2	1.0
退回	0	2	0	2	1.0
追	0	2	0	2	1.0
迷你	0	2	0	2	1.0
迫不及待	2	0	0	2	1.0
迪拜	0	2	0	2	1.0
连绵不断	2	0	0	2	1.0
连绵	2	0	0	2	1.0
违背	0	0	2	2	1.0
这部分	2	0	0	2	1.0
这回	0	2	0	2	1.0
这他	0	2	0	2	1.0
近来	0	0	2	2	1.0
迎春	2	0	0	2	1.0
迎接	2	0	0	2	1.0
迈	0	2	0	2	1.0
过来人	0	2	0	2	1.0
边境地区	0	2	0	2	1.0
辞退	0	0	2	2	1.0
辞旧迎新	2	0	0	2	1.0
辛勤	0	2	0	2	1.0
输出	0	0	2	2	1.0
较大	0	0	2	2	1.0
转变	0	2	0	2	1.0
车位	0	2	0	2	1.0
踏板	2	0	0	2	1.0
践行	0	2	0	2	1.0
路线	0	0	2	2	1.0
路有冻死骨	0	2	0	2	1.0
路子	0	2	0	2	1.0
跟前	2	0	0	2	1.0
跑步	2	0	0	2	1.0
越过	2	0	0	2	1.0
超人	0	2	0	2	1.0
起眼	0	0	2	2	1.0
走走停停	2	0	0	2	1.0
走狗	2	0	0	2	1.0
赤	0	2	0	2	1.0
赡养	0	2	0	2	1.0
赋予	0	2	0	2	1.0
资金来源	0	0	2	2	1.0
资产	2	0	0	2	1.0
贴心	2	0	0	2	1.0
质疑	0	0	2	2	1.0
货车	0	2	0	2	1.0
财神爷	2	0	0	2	1.0
豆腐	2	0	0	2	1.0
谨慎	0	2	0	2	1.0
调侃	0	2	0	2	1.0
请求	0	2	0	2	1.0
诶	2	0	0	2	1.0
诱惑	0	2	0	2	1.0
话说回来	0	2	0	2	1.0
试想	0	2	0	2	1.0
评判	2	0	0	2	1.0
评价	2	0	0	2	1.0
证据	0	2	0	2	1.0
证书	0	0	2	2	1.0
论证	0	2	0	2	1.0
论	0	2	0	2	1.0
许子	0	0	2	2	1.0
讲道理	2	0	0	2	1.0
讲道	2	0	0	2	1.0
议论	0	0	2	2	1.0
计委	0	0	2	2	1.0
触犯	0	2	0	2	1.0
视野	2	0	0	2	1.0
规避	0	2	0	2	1.0
见得	0	2	0	2	1.0
要么	0	2	0	2	1.0
西斯	0	2	0	2	1.0
西乡	0	0	2	2	1.0
襄阳	2	0	0	2	1.0
被窝	2	0	0	2	1.0
被扣	0	0	2	2	1.0
表情	2	0	0	2	1.0
行货	0	2	0	2	1.0
血压	2	0	0	2	1.0
蜗居	2	0	0	2	1.0
蛋糕	0	0	2	2	1.0
蕾	2	0	0	2	1.0
蔑视	0	2	0	2	1.0
蓄电池	0	0	2	2	1.0
蓄电	0	0	2	2	1.0
蒙蒙	0	2	0	2	1.0
葵	0	2	0	2	1.0
著名	2	0	0	2	1.0
落实	0	2	0	2	1.0
落地	0	0	2	2	1.0
落到	0	2	0	2	1.0
萝卜	2	0	0	2	1.0
莫过于	0	0	2	2	1.0
莫过	0	0	2	2	1.0
药味	0	2	0	2	1.0
荔	0	0	2	2	1.0
茜	0	0	2	2	1.0
英勇	2	0	0	2	1.0
苑	2	0	0	2	1.0
花费	0	2	0	2	1.0
花生	2	0	0	2	1.0
节约粮食	0	2	0	2	1.0
节约用电	0	2	0	2	1.0
节约用水	0	2	0	2	1.0
节省	0	2	0	2	1.0
节点	0	2	0	2	1.0
舞狮	2	0	0	2	1.0
致敬	2	0	0	2	1.0
臭	0	2	0	2	1.0
自卫	0	0	2	2	1.0
脚踏板	2	0	0	2	1.0
脚	2	0	0	2	1.0
脖子	0	0	2	2	1.0
脐带	0	0	2	2	1.0
能源	0	2	0	2	1.0
联手	2	0	0	2	1.0
联想	0	0	2	2	1.0
耳光	0	2	0	2	1.0
老老实实	0	0	2	2	1.0
老老	0	0	2	2	1.0
老爷	0	2	0	2	1.0
老太太	0	2	0	2	1.0
老太	0	2	0	2	1.0
翻译	2	0	0	2	1.0
美金	0	2	0	2	1.0
美感	2	0	0	2	1.0
美德	2	0	0	2	1.0
美味	2	0	0	2	1.0
罗斯国	2	0	0	2	1.0
罗刹	0	0	2	2	1.0
罗	2	0	0	2	1.0
网点	0	2	0	2	1.0
缺失	0	2	0	2	1.0
缩小	0	2	0	2	1.0
继承	2	0	0	2	1.0
绝大部分	2	0	0	2	1.0
细	0	2	0	2	1.0
组成部分	2	0	0	2	1.0
纵容	2	0	0	2	1.0
纳税人	0	2	0	2	1.0
纳税	0	2	0	2	1.0
纯粹	2	0	0	2	1.0
约束	2	0	0	2	1.0
红火	2	0	0	2	1.0
繁星	0	2	0	2	1.0
糖尿病	2	0	0	2	1.0
糖尿	2	0	0	2	1.0
糖	2	0	0	2	1.0
精致	2	0	0	2	1.0
粽子	2	0	0	2	1.0
箩	0	2	0	2	1.0
管理水平	0	2	0	2	1.0
管理手段	0	2	0	2	1.0
管制	0	2	0	2	1.0
简单化	0	2	0	2	1.0
答应	0	0	2	2	1.0
等一等	2	0	0	2	1.0
第四季度	0	0	2	2	1.0
第四季	0	0	2	2	1.0
笔者	0	0	2	2	1.0
笑话	2	0	0	2	1.0
竹头	2	0	0	2	1.0
立即	2	0	0	2	1.0
立刻	0	2	0	2	1.0
穿行	2	0	0	2	1.0
稻	0	2	0	2	1.0
税收	0	2	0	2	1.0
秦皇岛	2	0	0	2	1.0
秦皇	2	0	0	2	1.0
秒杀	0	2	0	2	1.0
科技园	2	0	0	2	1.0
科夫	2	0	0	2	1.0
私自	2	0	0	2	1.0
离开	2	0	0	2	1.0
祸及	2	0	0	2	1.0
祭灶	2	0	0	2	1.0
神奇	0	2	0	2	1.0
社会秩序	0	2	0	2	1.0
社会底层	0	2	0	2	1.0
社会关系	0	2	0	2	1.0
礼让	2	0	0	2	1.0
礼	2	0	0	2	1.0
碰	0	2	0	2	1.0
碗	0	0	2	2	1.0
确有此事	0	0	2	2	1.0
确有	0	0	2	2	1.0
硬逼	0	2	0	2	1.0
砸烂	0	2	0	2	1.0
破除	2	0	0	2	1.0
破坏	2	0	0	2	1.0
研究生	0	0	2	2	1.0
着手	0	0	2	2	1.0
眼镜	2	0	0	2	1.0
眼中钉	2	0	0	2	1.0
真不错	2	0	0	2	1.0
看重	2	0	0	2	1.0
看样子	0	2	0	2	1.0
看样	0	2	0	2	1.0
看得	0	2	0	2	1.0
看出	2	0	0	2	1.0
盼望	2	0	0	2	1.0
相爱	2	0	0	2	1.0
直至	2	0	0	2	1.0
盟友	0	0	2	2	1.0
皇恩浩荡	2	0	0	2	1.0
皇恩	2	0	0	2	1.0
男权	0	2	0	2	1.0
男女平等	0	2	0	2	1.0
电量	2	0	0	2	1.0
申	2	0	0	2	1.0
用途	2	0	0	2	1.0
用水	0	2	0	2	1.0
生辉	0	2	0	2	1.0
生态环境	0	2	0	2	1.0
生动	2	0	0	2	1.0
生产厂家	0	2	0	2	1.0
生产厂	0	2	0	2	1.0
甚者	2	0	0	2	1.0
瓦	2	0	0	2	1.0
瑞雪	2	0	0	2	1.0
理会	0	2	0	2	1.0
理事长	0	2	0	2	1.0
现行	0	2	0	2	1.0
率	2	0	0	2	1.0
狭窄	2	0	0	2	1.0
独苗	0	2	0	2	1.0
独自	2	0	0	2	1.0
犯法	0	2	0	2	1.0
牵制	2	0	0	2	1.0
物资	2	0	0	2	1.0
物力	0	2	0	2	1.0
物价上涨	0	2	0	2	1.0
牡	2	0	0	2	1.0
爱情	2	0	0	2	1.0
爆料	0	0	2	2	1.0
燃烧	0	2	0	2	1.0
熠熠生辉	0	2	0	2	1.0
熠熠	0	2	0	2	1.0
焚香	2	0	0	2	1.0
烦人	2	0	0	2	1.0
烤	2	0	0	2	1.0
点点	0	2	0	2	1.0
灰蒙蒙	0	2	0	2	1.0
火险	0	2	0	2	1.0
火药味	0	2	0	2	1.0
火药	0	2	0	2	1.0
火星	0	0	2	2	1.0
激增	0	2	0	2	1.0
澄清	2	0	0	2	1.0
演唱	2	0	0	2	1.0
滨江	2	0	0	2	1.0
满月	2	0	0	2	1.0
满怀	2	0	0	2	1.0
满大街	2	0	0	2	1.0
游客	2	0	0	2	1.0
渴望	2	0	0	2	1.0
清晰	2	0	0	2	1.0
淘宝	0	0	2	2	1.0
涉及	0	0	2	2	1.0
消停	0	2	0	2	1.0
海外	2	0	0	2	1.0
浩荡	2	0	0	2	1.0
浓郁	0	2	0	2	1.0
流产	2	0	0	2	1.0
活路	0	2	0	2	1.0
活跃	0	0	2	2	1.0
洗衣服	0	2	0	2	1.0
洗衣	0	2	0	2	1.0
法西斯	0	2	0	2	1.0
法西	0	2	0	2	1.0
法制	0	0	2	2	1.0
法人	0	2	0	2	1.0
治标不治本	0	2	0	2	1.0
治本	0	2	0	2	1.0
治家	0	2	0	2	1.0
没用过	0	2	0	2	1.0
没有勇气	0	2	0	2	1.0
没意思	2	0	0	2	1.0
没吃过	0	2	0	2	1.0
没事	0	0	2	2	1.0
沙	2	0	0	2	1.0
沉默	0	2	0	2	1.0
沈	0	0	2	2	1.0
水军	2	0	0	2	1.0
氧化硫	0	2	0	2	1.0
气象条件	0	2	0	2	1.0
气象	0	2	0	2	1.0
气温	0	2	0	2	1.0
气体	0	2	0	2	1.0
民间	0	2	0	2	1.0
毙	2	0	0	2	1.0
毒瘤	0	2	0	2	1.0
每家	0	2	0	2	1.0
残酷	0	0	2	2	1.0
残忍	0	2	0	2	1.0
殊不知	2	0	0	2	1.0
歼击机	2	0	0	2	1.0
歼击	2	0	0	2	1.0
死哦	0	2	0	2	1.0
歪	0	2	0	2	1.0
此时	2	0	0	2	1.0
此事	0	0	2	2	1.0
正名	0	2	0	2	1.0
歌会	0	0	2	2	1.0
欧美	2	0	0	2	1.0
欢欢乐乐	0	2	0	2	1.0
欢欢	0	2	0	2	1.0
欢庆	2	0	0	2	1.0
欠缺	0	2	0	2	1.0
榜样	0	2	0	2	1.0
楼房	0	2	0	2	1.0
森林	0	2	0	2	1.0
桂林	0	2	0	2	1.0
查出	2	0	0	2	1.0
果	2	0	0	2	1.0
极了	0	2	0	2	1.0
板凳	2	0	0	2	1.0
松动	2	0	0	2	1.0
杆	0	2	0	2	1.0
杀人放火	0	2	0	2	1.0
朱门酒肉臭	0	2	0	2	1.0
朱门	0	2	0	2	1.0
本质	0	2	0	2	1.0
本报	0	2	0	2	1.0
朝鲜	0	0	2	2	1.0
服务行业	0	2	0	2	1.0
有限公司	0	2	0	2	1.0
有限	0	2	0	2	1.0
有钱人	0	2	0	2	1.0
有毒	0	2	0	2	1.0
有此	0	0	2	2	1.0
有权	0	2	0	2	1.0
有名	0	2	0	2	1.0
月底	2	0	0	2	1.0
替代	0	2	0	2	1.0
曹	2	0	0	2	1.0
更有甚者	2	0	0	2	1.0
更多	0	2	0	2	1.0
普通百姓	0	2	0	2	1.0
晚年	0	2	0	2	1.0
晕	0	0	2	2	1.0
晃	0	2	0	2	1.0
显	2	0	0	2	1.0
昨天晚上	0	0	2	2	1.0
明日	0	0	2	2	1.0
时分	0	0	2	2	1.0
时光	2	0	0	2	1.0
早餐	2	0	0	2	1.0
旧迎新	2	0	0	2	1.0
日记	2	0	0	2	1.0
日照	0	2	0	2	1.0
既有	0	0	2	2	1.0
无人	2	0	0	2	1.0
旗鼓相当	0	2	0	2	1.0
旗鼓	0	2	0	2	1.0
旋律	2	0	0	2	1.0
旅途	2	0	0	2	1.0
新高	0	0	2	2	1.0
新潮	0	0	2	2	1.0
斌	2	0	0	2	1.0
救援	0	2	0	2	1.0
效应	0	0	2	2	1.0
政策法规	0	2	0	2	1.0
政治家	0	2	0	2	1.0
放松	2	0	0	2	1.0
放大	0	2	0	2	1.0
攻略	2	0	0	2	1.0
改进	0	2	0	2	1.0
改用	0	2	0	2	1.0
改名字	0	2	0	2	1.0
改名	0	2	0	2	1.0
收藏	0	2	0	2	1.0
收获	2	0	0	2	1.0
收入者	0	2	0	2	1.0
支出	0	2	0	2	1.0
播出	0	0	2	2	1.0
摔	2	0	0	2	1.0
摒弃	0	2	0	2	1.0
摊主	0	0	2	2	1.0
摆摊	0	2	0	2	1.0
摄影	0	0	2	2	1.0
携	2	0	0	2	1.0
搭	0	2	0	2	1.0
搜救	2	0	0	2	1.0
搂	2	0	0	2	1.0
揪心	2	0	0	2	1.0
提过	2	0	0	2	1.0
提到	0	2	0	2	1.0
推手	2	0	0	2	1.0
接下来	0	2	0	2	1.0
接下	0	2	0	2	1.0
掏出	0	0	2	2	1.0
据调查	0	0	2	2	1.0
换新	2	0	0	2	1.0
捕鲸	0	2	0	2	1.0
振振有词	2	0	0	2	1.0
振振	2	0	0	2	1.0
挨	0	0	2	2	1.0
挥之不去	0	2	0	2	1.0
拿出	2	0	0	2	1.0
拼命	0	2	0	2	1.0
拯救	0	2	0	2	1.0
拜拜	2	0	0	2	1.0
拜	2	0	0	2	1.0
拐卖	0	2	0	2	1.0
抽奖	0	2	0	2	1.0
抽	2	0	0	2	1.0
抵抗	2	0	0	2	1.0
报仇	2	0	0	2	1.0
护航	2	0	0	2	1.0
抢劫	0	2	0	2	1.0
抗议	0	2	0	2	1.0
投资者	0	0	2	2	1.0
投入	0	0	2	2	1.0
抓住	2	0	0	2	1.0
技穷	0	2	0	2	1.0
找到	0	2	0	2	1.0
扩展	0	2	0	2	1.0
执法人员	0	2	0	2	1.0
打架	2	0	0	2	1.0
打工	0	2	0	2	1.0
打嘴仗	0	2	0	2	1.0
打嘴	0	2	0	2	1.0
打劫	0	2	0	2	1.0
打下	0	2	0	2	1.0
扎	0	0	2	2	1.0
手足	2	0	0	2	1.0
手持	2	0	0	2	1.0
手中	0	2	0	2	1.0
房贷	0	2	0	2	1.0
战乱	2	0	0	2	1.0
或是	0	2	0	2	1.0
我心	2	0	0	2	1.0
成分	2	0	0	2	1.0
戏	2	0	0	2	1.0
感恩	2	0	0	2	1.0
愚蠢	0	2	0	2	1.0
惰	0	2	0	2	1.0
惊讶	0	2	0	2	1.0
情报	0	0	2	2	1.0
情形	0	0	2	2	1.0
悟空	2	0	0	2	1.0
悄然	2	0	0	2	1.0
恩怨	0	2	0	2	1.0
恨不得	0	2	0	2	1.0
恒定	0	0	2	2	1.0
怨不得	2	0	0	2	1.0
性	0	2	0	2	1.0
思	0	2	0	2	1.0
怀念	0	2	0	2	1.0
忽略	2	0	0	2	1.0
念头	0	2	0	2	1.0
快车道	2	0	0	2	1.0
快车	2	0	0	2	1.0
快捷	0	2	0	2	1.0
忘记	0	2	0	2	1.0
志愿军	0	2	0	2	1.0
必须品	0	2	0	2	1.0
心跳	2	0	0	2	1.0
心形	0	0	2	2	1.0
德	0	2	0	2	1.0
很多年	0	2	0	2	1.0
待遇	0	2	0	2	1.0
往常	0	0	2	2	1.0
形势严峻	0	2	0	2	1.0
当权者	0	2	0	2	1.0
当局	0	2	0	2	1.0
强势	2	0	0	2	1.0
弥漫着	0	2	0	2	1.0
引诱	0	0	2	2	1.0
引来	0	0	2	2	1.0
弃	2	0	0	2	1.0
开火	2	0	0	2	1.0
建宇	2	0	0	2	1.0
废气	2	0	0	2	1.0
店里	2	0	0	2	1.0
应聘	0	0	2	2	1.0
幸好	2	0	0	2	1.0
年画	2	0	0	2	1.0
平静	2	0	0	2	1.0
平民化	2	0	0	2	1.0
平台	0	0	2	2	1.0
干部	0	2	0	2	1.0
干涉	2	0	0	2	1.0
幅度	0	0	2	2	1.0
帽	2	0	0	2	1.0
市长	2	0	0	2	1.0
巴萨	0	2	0	2	1.0
左边	0	2	0	2	1.0
工厂	2	0	0	2	1.0
工作思路	0	2	0	2	1.0
州市	0	2	0	2	1.0
崛起	0	2	0	2	1.0
岿	0	0	2	2	1.0
山东	0	2	0	2	1.0
屁用	0	2	0	2	1.0
尽情	2	0	0	2	1.0
小龄童	2	0	0	2	1.0
小床	2	0	0	2	1.0
小巧	2	0	0	2	1.0
小宝贝	2	0	0	2	1.0
小妹	0	0	2	2	1.0
小女	2	0	0	2	1.0
小偷	0	0	2	2	1.0
封杀	0	2	0	2	1.0
导演	2	0	0	2	1.0
对立	0	2	0	2	1.0
对着干	0	2	0	2	1.0
对不起	2	0	0	2	1.0
富强	0	2	0	2	1.0
容量	0	0	2	2	1.0
宪法	0	2	0	2	1.0
室内外	0	2	0	2	1.0
室内	0	2	0	2	1.0
宣	0	0	2	2	1.0
客人	0	2	0	2	1.0
实现	2	0	0	2	1.0
实战	2	0	0	2	1.0
实惠	0	2	0	2	1.0
宜昌市	0	2	0	2	1.0
定律	0	0	2	2	1.0
宗	2	0	0	2	1.0
安详	0	2	0	2	1.0
安全事故	0	2	0	2	1.0
守法	2	0	0	2	1.0
守恒定律	0	0	2	2	1.0
守恒	0	0	2	2	1.0
学业	2	0	0	2	1.0
字母	0	2	0	2	1.0
字样	0	0	2	2	1.0
子孙后代	0	2	0	2	1.0
婚礼	0	2	0	2	1.0
委员	0	2	0	2	1.0
妇科	2	0	0	2	1.0
妇人	0	0	2	2	1.0
如出一辙	0	2	0	2	1.0
好累	0	2	0	2	1.0
好几年	2	0	0	2	1.0
好几	2	0	0	2	1.0
好事者	0	0	2	2	1.0
奶粉	2	0	0	2	1.0
女性朋友	2	0	0	2	1.0
女同事	2	0	0	2	1.0
奥斯曼帝国	2	0	0	2	1.0
奥斯曼	2	0	0	2	1.0
夹	0	2	0	2	1.0
夸	2	0	0	2	1.0
头等大事	2	0	0	2	1.0
头等	2	0	0	2	1.0
太小	0	2	0	2	1.0
太好了	0	2	0	2	1.0
太太	0	2	0	2	1.0
太原	0	0	2	2	1.0
太会	2	0	0	2	1.0
天朝	2	0	0	2	1.0
大都市	2	0	0	2	1.0
大视野	2	0	0	2	1.0
大肆	0	2	0	2	1.0
大气环境	0	2	0	2	1.0
大有人在	2	0	0	2	1.0
大批	0	0	2	2	1.0
大户	2	0	0	2	1.0
大年夜	0	2	0	2	1.0
大家伙	0	2	0	2	1.0
大半	0	2	0	2	1.0
大力提倡	0	2	0	2	1.0
大利	0	0	2	2	1.0
夜晚	2	0	0	2	1.0
多方	2	0	0	2	1.0
多亏	2	0	0	2	1.0
外地人	0	2	0	2	1.0
夏天	2	0	0	2	1.0
处罚	0	2	0	2	1.0
处	2	0	0	2	1.0
声明	0	2	0	2	1.0
壮	0	2	0	2	1.0
士兵	2	0	0	2	1.0
境界	0	2	0	2	1.0
境地	0	2	0	2	1.0
堵截	0	2	0	2	1.0
堪忧	0	2	0	2	1.0
堂	2	0	0	2	1.0
基数	0	2	0	2	1.0
城管局	0	2	0	2	1.0
型号	0	0	2	2	1.0
坪	2	0	0	2	1.0
坦率	2	0	0	2	1.0
坦	2	0	0	2	1.0
坚守岗位	2	0	0	2	1.0
坚守	2	0	0	2	1.0
块钱	0	0	2	2	1.0
坐等	2	0	0	2	1.0
坏处	2	0	0	2	1.0
地痞	0	2	0	2	1.0
地狱	0	2	0	2	1.0
在我看来	2	0	0	2	1.0
在意	0	2	0	2	1.0
在内	0	0	2	2	1.0
图片库	2	0	0	2	1.0
国民	0	2	0	2	1.0
国欢庆	2	0	0	2	1.0
国庆节	2	0	0	2	1.0
国庆	2	0	0	2	1.0
国务	2	0	0	2	1.0
回复	0	0	2	2	1.0
四年	0	2	0	2	1.0
四季度	0	0	2	2	1.0
四十多	0	0	2	2	1.0
噎	0	2	0	2	1.0
嘻嘻	0	2	0	2	1.0
嘲笑	2	0	0	2	1.0
嗨	2	0	0	2	1.0
喷出	2	0	0	2	1.0
啊啊啊	2	0	0	2	1.0
唱歌	2	0	0	2	1.0
唠	2	0	0	2	1.0
哭声	2	0	0	2	1.0
哪有什么	2	0	0	2	1.0
哪一条	0	2	0	2	1.0
哒	0	2	0	2	1.0
呼吸道	0	2	0	2	1.0
味道	2	0	0	2	1.0
味十足	2	0	0	2	1.0
呈现	2	0	0	2	1.0
呀呀	2	0	0	2	1.0
听听	0	2	0	2	1.0
否定	2	0	0	2	1.0
后代	0	2	0	2	1.0
后上	0	2	0	2	1.0
同胞	0	2	0	2	1.0
同房	0	0	2	2	1.0
同伙	2	0	0	2	1.0
吉利	0	2	0	2	1.0
合法性	0	0	2	2	1.0
合格证	0	2	0	2	1.0
各项政策	0	0	2	2	1.0
各项	0	0	2	2	1.0
各路	0	0	2	2	1.0
各类	2	0	0	2	1.0
叫做	0	2	0	2	1.0
口中	0	2	0	2	1.0
受损	0	2	0	2	1.0
发放	0	0	2	2	1.0
反问	2	0	0	2	1.0
反华	2	0	0	2	1.0
反动派	2	0	0	2	1.0
反动	2	0	0	2	1.0
及其	0	0	2	2	1.0
去年同期	0	0	2	2	1.0
去向	0	2	0	2	1.0
原生	0	2	0	2	1.0
原创	0	2	0	2	1.0
卫星	2	0	0	2	1.0
卫	0	0	2	2	1.0
卡片	0	0	2	2	1.0
协调	2	0	0	2	1.0
协会	0	2	0	2	1.0
半月	2	0	0	2	1.0
半句话	0	2	0	2	1.0
半句	0	2	0	2	1.0
千多年	0	2	0	2	1.0
十几岁	0	2	0	2	1.0
十	2	0	0	2	1.0
北方	2	0	0	2	1.0
化硫	0	2	0	2	1.0
勾结	2	0	0	2	1.0
励志	2	0	0	2	1.0
努	2	0	0	2	1.0
助	2	0	0	2	1.0
加盟	0	0	2	2	1.0
制裁	0	0	2	2	1.0
制定者	0	2	0	2	1.0
制作	0	0	2	2	1.0
到场	2	0	0	2	1.0
到位	0	2	0	2	1.0
初衷	2	0	0	2	1.0
刊	0	0	2	2	1.0
分娩	0	0	2	2	1.0
刀具	0	2	0	2	1.0
出资	0	2	0	2	1.0
出货量	0	0	2	2	1.0
出炉	0	0	2	2	1.0
出国	0	2	0	2	1.0
出厂	0	2	0	2	1.0
凸显	0	2	0	2	1.0
几起	2	0	0	2	1.0
几点	2	0	0	2	1.0
几日	0	2	0	2	1.0
几岁	0	2	0	2	1.0
减负	0	2	0	2	1.0
减排	0	2	0	2	1.0
凌驾	0	2	0	2	1.0
净化	0	2	0	2	1.0
冻死	0	2	0	2	1.0
况且	0	0	2	2	1.0
决策者	0	2	0	2	1.0
决	0	2	0	2	1.0
冯	2	0	0	2	1.0
军人	2	0	0	2	1.0
再见	0	2	0	2	1.0
内涵	2	0	0	2	1.0
内政	2	0	0	2	1.0
内人	0	0	2	2	1.0
兼顾	0	0	2	2	1.0
其人	2	0	0	2	1.0
共度	0	2	0	2	1.0
六小龄童	2	0	0	2	1.0
六小	2	0	0	2	1.0
公鸡	0	2	0	2	1.0
公民自由	0	2	0	2	1.0
公务员	0	2	0	2	1.0
公务	0	2	0	2	1.0
八个	2	0	0	2	1.0
全责	2	0	0	2	1.0
全程	2	0	0	2	1.0
兔	2	0	0	2	1.0
光芒	0	2	0	2	1.0
光标	0	2	0	2	1.0
先行	0	2	0	2	1.0
先是	0	2	0	2	1.0
充满	2	0	0	2	1.0
充	0	2	0	2	1.0
停工	2	0	0	2	1.0
停停	2	0	0	2	1.0
做饭	0	2	0	2	1.0
做工	2	0	0	2	1.0
值不值	0	0	2	2	1.0
借用	0	2	0	2	1.0
借机	0	0	2	2	1.0
信誉	0	2	0	2	1.0
保姆	0	2	0	2	1.0
俄联邦	2	0	0	2	1.0
俄罗斯国防部	2	0	0	2	1.0
促进	0	2	0	2	1.0
便利	0	2	0	2	1.0
供	2	0	0	2	1.0
佩服	2	0	0	2	1.0
你好	2	0	0	2	1.0
作死	0	2	0	2	1.0
作文	2	0	0	2	1.0
作业	0	0	2	2	1.0
何乐而不为	0	2	0	2	1.0
体谅	0	0	2	2	1.0
体积	2	0	0	2	1.0
体检	2	0	0	2	1.0
住宅	0	2	0	2	1.0
低能	0	2	0	2	1.0
低收入者	0	2	0	2	1.0
低头	0	0	2	2	1.0
传统美德	2	0	0	2	1.0
传到	0	0	2	2	1.0
优点	0	2	0	2	1.0
众多	0	0	2	2	1.0
伐	0	2	0	2	1.0
份子	0	0	2	2	1.0
价格比	0	2	0	2	1.0
仲	2	0	0	2	1.0
以旧换新	2	0	0	2	1.0
代管	0	2	0	2	1.0
代	0	2	0	2	1.0
他妈的	0	2	0	2	1.0
从我做起	0	2	0	2	1.0
从前	2	0	0	2	1.0
从今	0	2	0	2	1.0
介入	0	2	0	2	1.0
人贩	0	2	0	2	1.0
人性化	0	2	0	2	1.0
人口基数	0	2	0	2	1.0
亲眼	2	0	0	2	1.0
亮眼	0	0	2	2	1.0
京	2	0	0	2	1.0
产后	2	0	0	2	1.0
交法	0	2	0	2	1.0
五毛	0	2	0	2	1.0
五岁	2	0	0	2	1.0
互联网	0	2	0	2	1.0
云	0	0	2	2	1.0
二氧化硫	0	2	0	2	1.0
二氧化	0	2	0	2	1.0
二氧	0	2	0	2	1.0
事理	2	0	0	2	1.0
事务	2	0	0	2	1.0
争取	2	0	0	2	1.0
书香	2	0	0	2	1.0
乡里	2	0	0	2	1.0
也罢	0	2	0	2	1.0
九零	0	2	0	2	1.0
九点	0	2	0	2	1.0
九年	0	2	0	2	1.0
乐观	2	0	0	2	1.0
乐乐	0	2	0	2	1.0
乎	0	0	2	2	1.0
举国欢庆	2	0	0	2	1.0
举国	2	0	0	2	1.0
主演	2	0	0	2	1.0
主因	0	2	0	2	1.0
主力军	0	2	0	2	1.0
主人	0	2	0	2	1.0
为民	0	2	0	2	1.0
为主	0	2	0	2	1.0
临时	0	2	0	2	1.0
丰年	2	0	0	2	1.0
中文	0	2	0	2	1.0
中学生	0	2	0	2	1.0
中国政府	0	2	0	2	1.0
中低收入者	0	2	0	2	1.0
中低收入	0	2	0	2	1.0
中不溜	0	2	0	2	1.0
个性	0	2	0	2	1.0
个别	0	2	0	2	1.0
两胎	2	0	0	2	1.0
两点	0	0	2	2	1.0
两样	0	2	0	2	1.0
两成	0	0	2	2	1.0
两张	2	0	0	2	1.0
两地	2	0	0	2	1.0
两周	2	0	0	2	1.0
两千多年	0	2	0	2	1.0
两千多	0	2	0	2	1.0
业内人士	0	0	2	2	1.0
业内	0	0	2	2	1.0
业主	0	0	2	2	1.0
丙申	2	0	0	2	1.0
世人	2	0	0	2	1.0
与其	2	0	0	2	1.0
不见得	0	2	0	2	1.0
不灵	0	0	2	2	1.0
不治	0	2	0	2	1.0
不时	0	2	0	2	1.0
不折不扣	2	0	0	2	1.0
不折	2	0	0	2	1.0
不成	2	0	0	2	1.0
不妨	2	0	0	2	1.0
不大	2	0	0	2	1.0
不堪	2	0	0	2	1.0
不在乎	0	2	0	2	1.0
不光	0	2	0	2	1.0
不便	0	2	0	2	1.0
不乐	0	0	2	2	1.0
下课	2	0	0	2	1.0
下期	0	0	2	2	1.0
下半年	0	0	2	2	1.0
下半	0	0	2	2	1.0
上架	0	0	2	2	1.0
上来	0	0	2	2	1.0
上报	0	0	2	2	1.0
上房	2	0	0	2	1.0
上当	2	0	0	2	1.0
上岗	0	2	0	2	1.0
三百年	0	2	0	2	1.0
三千多	0	2	0	2	1.0
三十多	2	0	0	2	1.0
万平方公里	0	2	0	2	1.0
万平方	0	2	0	2	1.0
万台	0	0	2	2	1.0
七十	0	0	2	2	1.0
七	0	2	0	2	1.0
一颗	0	2	0	2	1.0
一面	2	0	0	2	1.0
一辙	0	2	0	2	1.0
一等	2	0	0	2	1.0
一眼	0	0	2	2	1.0
一点点	0	2	0	2	1.0
一支	0	2	0	2	1.0
一抹	0	2	0	2	1.0
一手	0	2	0	2	1.0
一大批	0	0	2	2	1.0
一切都是	0	2	0	2	1.0
一体	0	2	0	2	1.0
一伙	2	0	0	2	1.0
一个多月	2	0	0	2	1.0
xx	0	2	0	2	1.0
uniq	2	0	0	2	1.0
touchid	0	0	2	2	1.0
spring	2	0	0	2	1.0
show	2	0	0	2	1.0
sb	0	2	0	2	1.0
rbc	0	0	2	2	1.0
qq	2	0	0	2	1.0
q	2	0	0	2	1.0
pk	2	0	0	2	1.0
pay	0	0	2	2	1.0
nice	2	0	0	2	1.0
new	0	2	0	2	1.0
mini	0	0	2	2	1.0
markets	0	0	2	2	1.0
ls	2	0	0	2	1.0
kg	0	0	2	2	1.0
ip6	0	2	0	2	1.0
capital	0	0	2	2	1.0
bb	2	0	0	2	1.0
龟	0	1	0	1	1.0
龚	1	0	0	1	1.0
龙潭	0	1	0	1	1.0
龙岩	1	0	0	1	1.0
龙头老大	0	1	0	1	1.0
龙头	0	1	0	1	1.0
龙城	0	0	1	1	1.0
龙凤胎	0	1	0	1	1.0
龙凤	0	1	0	1	1.0
鼻黏膜	0	1	0	1	1.0
鼻屎	0	1	0	1	1.0
鼓起勇气	0	1	0	1	1.0
鼓起	0	1	0	1	1.0
鼓吹	0	1	0	1	1.0
鼓动	0	0	1	1	1.0
鼎力支持	1	0	0	1	1.0
鼎力	1	0	0	1	1.0
鼎	1	0	0	1	1.0
默默地	1	0	0	1	1.0
默念	0	0	1	1	1.0
黑风	1	0	0	1	1.0
黑诊所	0	0	1	1	1.0
黑裙	1	0	0	1	1.0
黑色	1	0	0	1	1.0
黑脸	0	1	0	1	1.0
黑皮	1	0	0	1	1.0
黑点	0	1	0	1	1.0
黑海地区	0	0	1	1	1.0
黑海	0	0	1	1	1.0
黏膜	0	1	0	1	1.0
黏	0	1	0	1	1.0
黄色	0	0	1	1	1.0
黄粱美梦	1	0	0	1	1.0
黄粱	1	0	0	1	1.0
黄牛	1	0	0	1	1.0
黄灯	0	0	1	1	1.0
黄河	0	0	1	1	1.0
麻花	1	0	0	1	1.0
麻	1	0	0	1	1.0
鹏城	0	1	0	1	1.0
鸿	0	0	1	1	1.0
鸽子	0	1	0	1	1.0
鸽	1	0	0	1	1.0
鸦片	0	1	0	1	1.0
鸣笛	1	0	0	1	1.0
鸡鸭	1	0	0	1	1.0
鸡鸡	1	0	0	1	1.0
鸡肉	1	0	0	1	1.0
鸡皮疙瘩	1	0	0	1	1.0
鸡皮	1	0	0	1	1.0
鸡汤	0	0	1	1	1.0
鸡毛	0	1	0	1	1.0
鲹	1	0	0	1	1.0
鲸	0	1	0	1	1.0
鲜肉	0	0	1	1	1.0
鲍	1	0	0	1	1.0
魔鬼	0	0	1	1	1.0
魔力	1	0	0	1	1.0
魔	1	0	0	1	1.0
魏	0	0	1	1	1.0
魅	0	0	1	1	1.0
魄力	0	0	1	1	1.0
魁祸	1	0	0	1	1.0
鬼子	0	1	0	1	1.0
高领	0	0	1	1	1.0
高达	1	0	0	1	1.0
高跷	1	0	0	1	1.0
高级别	1	0	0	1	1.0
高级	1	0	0	1	1.0
高点	1	0	0	1	1.0
高潮	1	0	0	1	1.0
高温	0	1	0	1	1.0
高楼	0	0	1	1	1.0
高校	1	0	0	1	1.0
高架桥	1	0	0	1	1.0
高明	1	0	0	1	1.0
高招	0	1	0	1	1.0
高房价	0	1	0	1	1.0
高强度	1	0	0	1	1.0
高强	1	0	0	1	1.0
高度评价	1	0	0	1	1.0
高度	1	0	0	1	1.0
高层	0	1	0	1	1.0
高官	0	1	0	1	1.0
高喊	0	1	0	1	1.0
高原	1	0	0	1	1.0
高出	0	1	0	1	1.0
高傲	0	0	1	1	1.0
高低	0	1	0	1	1.0
高中毕业	0	1	0	1	1.0
高三	0	1	0	1	1.0
骨干	1	0	0	1	1.0
骨子里	0	1	0	1	1.0
骨子	0	1	0	1	1.0
骟	0	1	0	1	1.0
骚扰	0	1	0	1	1.0
骗骗	0	1	0	1	1.0
骗钱	0	1	0	1	1.0
骗取	0	0	1	1	1.0
骗人	0	0	1	1	1.0
骑马	0	1	0	1	1.0
骑车人	0	0	1	1	1.0
骑单车	1	0	0	1	1.0
验货	0	0	1	1	1.0
验证码	0	0	1	1	1.0
验证	0	0	1	1	1.0
骆驼	1	0	0	1	1.0
骄	1	0	0	1	1.0
骂街	0	1	0	1	1.0
骂声	0	1	0	1	1.0
骂名	0	1	0	1	1.0
骁	0	1	0	1	1.0
驾驭	0	1	0	1	1.0
驾校	0	1	0	1	1.0
驾乘	0	1	0	1	1.0
驼	1	0	0	1	1.0
驻华大使	1	0	0	1	1.0
驻华	1	0	0	1	1.0
驻军	1	0	0	1	1.0
驻	0	1	0	1	1.0
驶	0	1	0	1	1.0
驴	0	1	0	1	1.0
驱逐舰	0	1	0	1	1.0
驱赶	1	0	0	1	1.0
驱动	0	0	1	1	1.0
马马虎虎	1	0	0	1	1.0
马达	1	0	0	1	1.0
马路上	1	0	0	1	1.0
马蜂窝	1	0	0	1	1.0
马蜂	1	0	0	1	1.0
马虎	1	0	0	1	1.0
马桶	1	0	0	1	1.0
马拉雅	0	1	0	1	1.0
马拉	0	1	0	1	1.0
马勒	0	1	0	1	1.0
香烟	0	1	0	1	1.0
香炉	0	0	1	1	1.0
首领	0	0	1	1	1.0
首部	0	1	0	1	1.0
首批	0	1	0	1	1.0
首当其冲	0	0	1	1	1.0
首当	0	0	1	1	1.0
首度	1	0	0	1	1.0
首届	0	1	0	1	1.0
首尔	0	1	0	1	1.0
馋	0	1	0	1	1.0
馆	1	0	0	1	1.0
饽饽	1	0	0	1	1.0
饼干	0	0	1	1	1.0
饶有兴趣	1	0	0	1	1.0
饶有	1	0	0	1	1.0
饱满	1	0	0	1	1.0
饱和	1	0	0	1	1.0
饮食	0	1	0	1	1.0
饮店	0	1	0	1	1.0
饭馆	0	1	0	1	1.0
饭局	1	0	0	1	1.0
饭后	1	0	0	1	1.0
餐饮店	0	1	0	1	1.0
食品药品	0	1	0	1	1.0
食品安全	0	1	0	1	1.0
飞龙	0	0	1	1	1.0
飞车	1	0	0	1	1.0
飞弹	1	0	0	1	1.0
飙车	1	0	0	1	1.0
飘荡	1	0	0	1	1.0
飘	1	0	0	1	1.0
风风火火	1	0	0	1	1.0
风风	1	0	0	1	1.0
风靡	0	0	1	1	1.0
风雨	0	0	1	1	1.0
风生水	0	1	0	1	1.0
风火	1	0	0	1	1.0
风流人物	0	0	1	1	1.0
风流	0	0	1	1	1.0
风水	1	0	0	1	1.0
风格	0	1	0	1	1.0
风景	0	1	0	1	1.0
风情	1	0	0	1	1.0
风度	1	0	0	1	1.0
风尚	0	0	1	1	1.0
风向标	1	0	0	1	1.0
风向	1	0	0	1	1.0
风俗习惯	0	0	1	1	1.0
风不	0	0	1	1	1.0
颠覆	1	0	0	1	1.0
颠复	0	1	0	1	1.0
颠	0	1	0	1	1.0
额定	0	0	1	1	1.0
题材	0	0	1	1	1.0
颗粒物	0	1	0	1	1.0
颗	1	0	0	1	1.0
频道	0	1	0	1	1.0
频率	0	0	1	1	1.0
频	0	0	1	1	1.0
颐	0	1	0	1	1.0
颍	0	0	1	1	1.0
领证	0	1	0	1	1.0
领略	0	0	1	1	1.0
领导班子	0	1	0	1	1.0
领土问题	0	1	0	1	1.0
领到	1	0	0	1	1.0
预祝	1	0	0	1	1.0
预料	0	1	0	1	1.0
预想	1	0	0	1	1.0
颂歌	1	0	0	1	1.0
颁奖	1	0	0	1	1.0
颁发	1	0	0	1	1.0
顾虑	1	0	0	1	1.0
顾不得	1	0	0	1	1.0
顽皮	1	0	0	1	1.0
顺顺利利	0	0	1	1	1.0
顺顺	0	0	1	1	1.0
顺路	1	0	0	1	1.0
顺眼	1	0	0	1	1.0
顺畅	0	0	1	1	1.0
顺带	0	1	0	1	1.0
顺口	0	0	1	1	1.0
顺	1	0	0	1	1.0
项庄舞剑	1	0	0	1	1.0
项庄	1	0	0	1	1.0
顶层	0	0	1	1	1.0
页面	0	1	0	1	1.0
页	0	1	0	1	1.0
音频	0	1	0	1	1.0
音符	1	0	0	1	1.0
音标	0	1	0	1	1.0
鞭炮厂	1	0	0	1	1.0
鞠躬	0	1	0	1	1.0
鞑靼	0	1	0	1	1.0
靴子	0	0	1	1	1.0
靴	1	0	0	1	1.0
革命性	0	1	0	1	1.0
革命	0	1	0	1	1.0
革	0	1	0	1	1.0
面试	0	1	0	1	1.0
面粉	0	0	1	1	1.0
面板	0	0	1	1	1.0
面子	0	1	0	1	1.0
面包车	0	0	1	1	1.0
面包	0	0	1	1	1.0
靠近	0	0	1	1	1.0
靠着	0	0	1	1	1.0
靠拢	0	1	0	1	1.0
非驴非马	0	1	0	1	1.0
非议	0	0	1	1	1.0
非标	1	0	0	1	1.0
非常规	0	1	0	1	1.0
非但	1	0	0	1	1.0
非人	1	0	0	1	1.0
静观其变	0	0	1	1	1.0
静观	0	0	1	1	1.0
静	1	0	0	1	1.0
靖	0	1	0	1	1.0
青龙满族自治县	1	0	0	1	1.0
青龙	1	0	0	1	1.0
青青	1	0	0	1	1.0
青海	0	1	0	1	1.0
青壮年	0	1	0	1	1.0
青光眼	1	0	0	1	1.0
青光	1	0	0	1	1.0
霹雳	0	1	0	1	1.0
霸气	0	0	1	1	1.0
霸权主义	1	0	0	1	1.0
霸	1	0	0	1	1.0
露露脸	1	0	0	1	1.0
露露	1	0	0	1	1.0
露脸	1	0	0	1	1.0
霉气	1	0	0	1	1.0
震耳欲聋	1	0	0	1	1.0
震耳	1	0	0	1	1.0
震天	1	0	0	1	1.0
震	0	1	0	1	1.0
需谨慎	0	1	0	1	1.0
需用	0	1	0	1	1.0
雾霭	0	0	1	1	1.0
雷霆	0	1	0	1	1.0
雷达	0	1	0	1	1.0
雷	1	0	0	1	1.0
零零	1	0	0	1	1.0
零点	1	0	0	1	1.0
零星	1	0	0	1	1.0
零头	1	0	0	1	1.0
零售点	0	0	1	1	1.0
零售商	0	1	0	1	1.0
雪天	1	0	0	1	1.0
雪城	0	0	1	1	1.0
雪兆丰年	1	0	0	1	1.0
雪儿	1	0	0	1	1.0
雨雪	0	1	0	1	1.0
雨水	0	0	1	1	1.0
雨棚	1	0	0	1	1.0
雨天	0	1	0	1	1.0
雌	0	1	0	1	1.0
雇员	1	0	0	1	1.0
雇	0	1	0	1	1.0
集市	0	1	0	1	1.0
集	0	0	1	1	1.0
难闻	0	1	0	1	1.0
难道真	1	0	0	1	1.0
难辨	0	1	0	1	1.0
难说	0	1	0	1	1.0
难看	1	0	0	1	1.0
难熬	0	0	1	1	1.0
难忘	1	0	0	1	1.0
难堪	0	1	0	1	1.0
难听	1	0	0	1	1.0
难保	1	0	0	1	1.0
难为	0	1	0	1	1.0
难上加难	0	1	0	1	1.0
隔岸观火	1	0	0	1	1.0
隔岸	1	0	0	1	1.0
隔壁	0	0	1	1	1.0
隔三差五	0	0	1	1	1.0
隔	1	0	0	1	1.0
隐瞒	0	1	0	1	1.0
随风而去	1	0	0	1	1.0
随风	1	0	0	1	1.0
随身带	0	1	0	1	1.0
随身	0	1	0	1	1.0
随机	0	0	1	1	1.0
随手	1	0	0	1	1.0
随地吐痰	0	0	1	1	1.0
随地	0	0	1	1	1.0
随口	0	0	1	1	1.0
随	1	0	0	1	1.0
隋代	0	0	1	1	1.0
隆美尔	1	0	0	1	1.0
陷进	0	1	0	1	1.0
陷	0	1	0	1	1.0
陪葬	0	1	0	1	1.0
险象环生	1	0	0	1	1.0
险象	1	0	0	1	1.0
险	0	0	1	1	1.0
除邪	1	0	0	1	1.0
除此之外	0	0	1	1	1.0
除此	0	0	1	1	1.0
除尘	1	0	0	1	1.0
除夕之夜	1	0	0	1	1.0
除名	0	1	0	1	1.0
院长	1	0	0	1	1.0
院里	0	1	0	1	1.0
院子	0	0	1	1	1.0
院	1	0	0	1	1.0
陕西省	0	1	0	1	1.0
限量版	1	0	0	1	1.0
限性	0	0	1	1	1.0
限价	0	1	0	1	1.0
降频	0	1	0	1	1.0
降温	0	1	0	1	1.0
陌生人	0	0	1	1	1.0
陆战队	0	1	0	1	1.0
陆战	0	1	0	1	1.0
附带	1	0	0	1	1.0
附	0	1	0	1	1.0
阿里巴巴	1	0	0	1	1.0
阿里	1	0	0	1	1.0
阿訇	0	1	0	1	1.0
阿米	1	0	0	1	1.0
阿弥陀佛	0	0	1	1	1.0
阿弥陀	0	0	1	1	1.0
阿富汉	0	0	1	1	1.0
阿嚏	1	0	0	1	1.0
阻止不了	0	1	0	1	1.0
阻力	0	1	0	1	1.0
阶梯	1	0	0	1	1.0
阵地	1	0	0	1	1.0
阵势	1	0	0	1	1.0
阴霾	0	1	0	1	1.0
阴阴的	1	0	0	1	1.0
阴阴	1	0	0	1	1.0
阴谋	1	0	0	1	1.0
阴历	1	0	0	1	1.0
阳阳	1	0	0	1	1.0
阳神	0	1	0	1	1.0
阳朔	0	1	0	1	1.0
防老	1	0	0	1	1.0
防空	0	0	1	1	1.0
防护性	0	0	1	1	1.0
队员	0	0	1	1	1.0
队	1	0	0	1	1.0
阜阳	0	0	1	1	1.0
阖家幸福	1	0	0	1	1.0
阐述	1	0	0	1	1.0
阅兵	1	0	0	1	1.0
闻	0	0	1	1	1.0
闹腾	1	0	0	1	1.0
闹心	0	1	0	1	1.0
闹事	0	0	1	1	1.0
闷闷不乐	0	0	1	1	1.0
闷闷	0	0	1	1	1.0
闷头	0	1	0	1	1.0
闷声	0	1	0	1	1.0
闷	0	1	0	1	1.0
闲着	0	0	1	1	1.0
闯荡	0	0	1	1	1.0
问罪	0	1	0	1	1.0
问答	1	0	0	1	1.0
问好	0	1	0	1	1.0
问卷	0	0	1	1	1.0
问候	1	0	0	1	1.0
闭口	0	1	0	1	1.0
闭一只眼	1	0	0	1	1.0
闭	1	0	0	1	1.0
闪闪发光	1	0	0	1	1.0
闪电	0	1	0	1	1.0
闪现	0	0	1	1	1.0
闪亮	1	0	0	1	1.0
门铃	0	1	0	1	1.0
门诊部	0	1	0	1	1.0
门诊	0	1	0	1	1.0
门板	1	0	0	1	1.0
门店	0	1	0	1	1.0
门前	0	1	0	1	1.0
门下	0	1	0	1	1.0
长青	1	0	0	1	1.0
长远	1	0	0	1	1.0
长达	0	1	0	1	1.0
长跑	1	0	0	1	1.0
长耳朵	0	0	1	1	1.0
长篇小说	1	0	0	1	1.0
长篇	1	0	0	1	1.0
长生	1	0	0	1	1.0
长片	0	1	0	1	1.0
长期存在	0	1	0	1	1.0
长年累月	0	0	1	1	1.0
长官	1	0	0	1	1.0
镭射	0	0	1	1	1.0
镇定	1	0	0	1	1.0
镇压	1	0	0	1	1.0
镇内	1	0	0	1	1.0
键盘输入	1	0	0	1	1.0
锦绣	0	1	0	1	1.0
锦	1	0	0	1	1.0
锤子	0	0	1	1	1.0
锋利	1	0	0	1	1.0
锁定	0	1	0	1	1.0
锁	1	0	0	1	1.0
销毁	0	1	0	1	1.0
销售量	0	0	1	1	1.0
销售点	0	0	1	1	1.0
链条	0	1	0	1	1.0
链子	0	1	0	1	1.0
铺张浪费	0	1	0	1	1.0
铺张	0	1	0	1	1.0
银装	1	0	0	1	1.0
银行信贷	1	0	0	1	1.0
银色	1	0	0	1	1.0
银耳	1	0	0	1	1.0
银子	1	0	0	1	1.0
银	0	0	1	1	1.0
铲除	0	1	0	1	1.0
铲	1	0	0	1	1.0
铛	1	0	0	1	1.0
铅	0	0	1	1	1.0
铃声	0	0	1	1	1.0
铁鸟	0	0	1	1	1.0
铁骑	1	0	0	1	1.0
铁血网	1	0	0	1	1.0
铁血	1	0	0	1	1.0
铁甲	0	0	1	1	1.0
铁板一块	0	0	1	1	1.0
铁板	0	0	1	1	1.0
铁幕	0	1	0	1	1.0
铁公鸡	0	1	0	1	1.0
铁了心	0	0	1	1	1.0
铁	1	0	0	1	1.0
钻石	0	1	0	1	1.0
钻出来	1	0	0	1	1.0
钻出	1	0	0	1	1.0
钱财	1	0	0	1	1.0
钢筋水泥	0	1	0	1	1.0
钢筋	0	1	0	1	1.0
钢材	0	0	1	1	1.0
钟汉良	0	0	1	1	1.0
钟声	1	0	0	1	1.0
钞票	0	0	1	1	1.0
钓誉	1	0	0	1	1.0
针	0	1	0	1	1.0
錤	0	0	1	1	1.0
金边	1	0	0	1	1.0
金融体制	1	0	0	1	1.0
金融	1	0	0	1	1.0
金花	1	0	0	1	1.0
金猴	1	0	0	1	1.0
金山	1	0	0	1	1.0
金属	1	0	0	1	1.0
金子	0	0	1	1	1.0
金主	1	0	0	1	1.0
量化	0	0	1	1	1.0
量减少	0	1	0	1	1.0
野心	0	1	0	1	1.0
野外	0	1	0	1	1.0
野兽	0	1	0	1	1.0
重量	0	1	0	1	1.0
重装系统	0	1	0	1	1.0
重装	0	1	0	1	1.0
重磅	0	0	1	1	1.0
重男轻女	0	0	1	1	1.0
重生	0	0	1	1	1.0
重灾区	1	0	0	1	1.0
重灾	1	0	0	1	1.0
重温	1	0	0	1	1.0
重拾	0	0	1	1	1.0
重拳	1	0	0	1	1.0
重感冒	1	0	0	1	1.0
重启	0	1	0	1	1.0
重合	0	0	1	1	1.0
重制	0	1	0	1	1.0
重出江湖	0	1	0	1	1.0
重出	0	1	0	1	1.0
重典	1	0	0	1	1.0
重伤	0	0	1	1	1.0
重任	1	0	0	1	1.0
里边	0	1	0	1	1.0
里米	0	1	0	1	1.0
里程	0	0	1	1	1.0
里姆林	1	0	0	1	1.0
里姆	1	0	0	1	1.0
里亚尔	1	0	0	1	1.0
释疑	0	0	1	1	1.0
释手	1	0	0	1	1.0
采购	1	0	0	1	1.0
采取措施	0	1	0	1	1.0
采取任何	1	0	0	1	1.0
醒脑	0	1	0	1	1.0
醒来	0	0	1	1	1.0
醒悟	0	1	0	1	1.0
醉酒	0	0	1	1	1.0
醉人	1	0	0	1	1.0
酸酸甜甜	1	0	0	1	1.0
酸酸	1	0	0	1	1.0
酸蓄电池	0	0	1	1	1.0
酸甜	1	0	0	1	1.0
酸	0	1	0	1	1.0
酷爱	1	0	0	1	1.0
酱油	1	0	0	1	1.0
酱汤	1	0	0	1	1.0
酒窝	0	1	0	1	1.0
酒杯	0	1	0	1	1.0
配钥匙	0	1	0	1	1.0
配送费	0	1	0	1	1.0
配套措施	0	1	0	1	1.0
配型	0	0	1	1	1.0
配图	0	0	1	1	1.0
配件	0	0	1	1	1.0
酌情	0	1	0	1	1.0
都还没	1	0	0	1	1.0
郴州	0	0	1	1	1.0
部署	0	1	0	1	1.0
部手机	0	1	0	1	1.0
部属	0	1	0	1	1.0
部份	0	1	0	1	1.0
部下	1	0	0	1	1.0
郑重宣布	0	1	0	1	1.0
郑重	0	1	0	1	1.0
郊区	0	1	0	1	1.0
郁	0	0	1	1	1.0
邵阳	1	0	0	1	1.0
邯郸	0	1	0	1	1.0
邮报	1	0	0	1	1.0
邮局	1	0	0	1	1.0
邪教	1	0	0	1	1.0
邪恶	1	0	0	1	1.0
那里	0	1	0	1	1.0
那达慕	1	0	0	1	1.0
那时	0	1	0	1	1.0
那大	0	0	1	1	1.0
那儿	0	0	1	1	1.0
那伙子	1	0	0	1	1.0
那伙	1	0	0	1	1.0
那一刻	0	0	1	1	1.0
邓小平	0	1	0	1	1.0
邑	1	0	0	1	1.0
避让	0	1	0	1	1.0
避孕套	0	1	0	1	1.0
避孕	0	1	0	1	1.0
遵纪守法	1	0	0	1	1.0
遵纪	1	0	0	1	1.0
遵循	0	1	0	1	1.0
遮雨棚	1	0	0	1	1.0
遮雨	1	0	0	1	1.0
遮羞布	0	1	0	1	1.0
遮羞	0	1	0	1	1.0
遮不住	0	0	1	1	1.0
遭难	0	0	1	1	1.0
遭到	0	1	0	1	1.0
遥远	1	0	0	1	1.0
遗留问题	0	1	0	1	1.0
遗留	0	1	0	1	1.0
遗失	1	0	0	1	1.0
遗传	0	1	0	1	1.0
遗产	1	0	0	1	1.0
道里区	0	1	0	1	1.0
道歉	0	1	0	1	1.0
道家	1	0	0	1	1.0
道具	0	1	0	1	1.0
道义	0	1	0	1	1.0
遏制	1	0	0	1	1.0
遇袭	0	1	0	1	1.0
遂	0	0	1	1	1.0
逼死	0	1	0	1	1.0
逼人	0	0	1	1	1.0
逸	0	0	1	1	1.0
逢年过节	0	0	1	1	1.0
逢	0	1	0	1	1.0
造谣	0	1	0	1	1.0
造福	1	0	0	1	1.0
造影	0	0	1	1	1.0
造出来	1	0	0	1	1.0
造出	1	0	0	1	1.0
造人	1	0	0	1	1.0
速率	0	1	0	1	1.0
速战速决	1	0	0	1	1.0
速战	1	0	0	1	1.0
速决	1	0	0	1	1.0
速	0	0	1	1	1.0
逝去	1	0	0	1	1.0
逛	0	0	1	1	1.0
通讯社	1	0	0	1	1.0
通行	0	0	1	1	1.0
通胀	0	1	0	1	1.0
通病	0	1	0	1	1.0
通明	1	0	0	1	1.0
通报	0	1	0	1	1.0
通常	0	0	1	1	1.0
通城	1	0	0	1	1.0
通人	0	1	0	1	1.0
逗我	0	1	0	1	1.0
逗人	1	0	0	1	1.0
逐步	0	1	0	1	1.0
逐客令	0	1	0	1	1.0
逐客	0	1	0	1	1.0
逐出	0	0	1	1	1.0
透彻	0	0	1	1	1.0
透	0	0	1	1	1.0
逊	1	0	0	1	1.0
选购	0	0	1	1	1.0
选取	0	0	1	1	1.0
逆向行驶	1	0	0	1	1.0
逆向	1	0	0	1	1.0
逆势	1	0	0	1	1.0
逃避	0	0	1	1	1.0
逃税	0	0	1	1	1.0
逃犯	0	1	0	1	1.0
逃往	1	0	0	1	1.0
逃回	1	0	0	1	1.0
逃	0	1	0	1	1.0
适龄	1	0	0	1	1.0
适宜	0	1	0	1	1.0
适婚年龄	1	0	0	1	1.0
适婚	1	0	0	1	1.0
适可而止	1	0	0	1	1.0
送达	0	1	0	1	1.0
送货	0	0	1	1	1.0
送出	0	0	1	1	1.0
退货	0	1	0	1	1.0
退出	1	0	0	1	1.0
退休年龄	0	1	0	1	1.0
退一步	1	0	0	1	1.0
追问	1	0	0	1	1.0
追求	0	0	1	1	1.0
追杀	0	1	0	1	1.0
追捕	1	0	0	1	1.0
追堵	0	1	0	1	1.0
迷茫	1	0	0	1	1.0
迷你版	0	1	0	1	1.0
迷人	0	0	1	1	1.0
迷	0	0	1	1	1.0
迫切需要	0	1	0	1	1.0
迪沃斯	0	1	0	1	1.0
迥异	1	0	0	1	1.0
迟钝	0	1	0	1	1.0
连锁	0	0	1	1	1.0
连累	0	1	0	1	1.0
连环画	1	0	0	1	1.0
连接	0	1	0	1	1.0
连夜	0	1	0	1	1.0
连城	1	0	0	1	1.0
违规行为	0	1	0	1	1.0
违法犯罪	1	0	0	1	1.0
违法乱纪	0	1	0	1	1.0
违反规定	1	0	0	1	1.0
违	1	0	0	1	1.0
远方	0	1	0	1	1.0
远嫁	1	0	0	1	1.0
远大于	0	1	0	1	1.0
远大	0	1	0	1	1.0
远东地区	0	1	0	1	1.0
进行谈判	0	1	0	1	1.0
进来	0	0	1	1	1.0
进攻	1	0	0	1	1.0
进城	0	1	0	1	1.0
进出口	0	0	1	1	1.0
进出	0	0	1	1	1.0
进修	0	1	0	1	1.0
进产房	1	0	0	1	1.0
这辆	0	0	1	1	1.0
这股	1	0	0	1	1.0
这笔	0	1	0	1	1.0
这段话	0	1	0	1	1.0
这段	0	1	0	1	1.0
这本	1	0	0	1	1.0
这时候	0	0	1	1	1.0
这家	0	1	0	1	1.0
这周	0	0	1	1	1.0
这俩	0	1	0	1	1.0
这件	1	0	0	1	1.0
这些年来	0	0	1	1	1.0
这么点儿	1	0	0	1	1.0
这么回事	0	1	0	1	1.0
这么久	1	0	0	1	1.0
这下子	1	0	0	1	1.0
还过得去	1	0	0	1	1.0
还过	1	0	0	1	1.0
还算	0	1	0	1	1.0
还清	1	0	0	1	1.0
返家	1	0	0	1	1.0
返回	0	0	1	1	1.0
近日来	1	0	0	1	1.0
近千人	0	1	0	1	1.0
近几个月	0	0	1	1	1.0
近些年	1	0	0	1	1.0
近些	1	0	0	1	1.0
运送	0	0	1	1	1.0
运走	0	1	0	1	1.0
运费	0	0	1	1	1.0
运河	1	0	0	1	1.0
运往	0	1	0	1	1.0
运势	0	0	1	1	1.0
运到	0	0	1	1	1.0
迎面	1	0	0	1	1.0
迎刃而解	0	1	0	1	1.0
迈德	0	0	1	1	1.0
迈尔斯	1	0	0	1	1.0
迈尔	1	0	0	1	1.0
过路	1	0	0	1	1.0
过街老鼠	1	0	0	1	1.0
过街	1	0	0	1	1.0
过瘾	0	0	1	1	1.0
过生日	1	0	0	1	1.0
过渡	0	1	0	1	1.0
过桥	0	0	1	1	1.0
过期作废	0	0	1	1	1.0
过时	0	1	0	1	1.0
过得去	1	0	0	1	1.0
过小年	0	1	0	1	1.0
过完	0	1	0	1	1.0
过头	0	1	0	1	1.0
过半	1	0	0	1	1.0
过剩	0	0	1	1	1.0
过出	0	0	1	1	1.0
过冬	1	0	0	1	1.0
过世	0	0	1	1	1.0
迅	1	0	0	1	1.0
迁移	1	0	0	1	1.0
达标	1	0	0	1	1.0
达成协议	0	1	0	1	1.0
达尔	0	1	0	1	1.0
辽宁省	0	1	0	1	1.0
边疆	0	0	1	1	1.0
边界地区	1	0	0	1	1.0
边玩	0	0	1	1	1.0
边境线	1	0	0	1	1.0
边境县	0	0	1	1	1.0
辱骂	1	0	0	1	1.0
辨别	0	1	0	1	1.0
辞旧岁	0	1	0	1	1.0
辞	1	0	0	1	1.0
辛酸	0	0	1	1	1.0
辛格	0	1	0	1	1.0
辛劳	1	0	0	1	1.0
辛	0	0	1	1	1.0
输精管	0	1	0	1	1.0
输精	0	1	0	1	1.0
输卵管	0	0	1	1	1.0
输卵	0	0	1	1	1.0
输出功率	0	0	1	1	1.0
辐射	1	0	0	1	1.0
辉煌	0	1	0	1	1.0
辉	0	0	1	1	1.0
辈分	0	1	0	1	1.0
较量	0	0	1	1	1.0
较之	0	0	1	1	1.0
载重	0	0	1	1	1.0
载舟	0	1	0	1	1.0
载物	1	0	0	1	1.0
载人	1	0	0	1	1.0
轻重	1	0	0	1	1.0
轻轻松松	0	0	1	1	1.0
轻轨	0	0	1	1	1.0
轻言	0	1	0	1	1.0
轻松松	0	0	1	1	1.0
轻描淡写	1	0	0	1	1.0
轻微	0	1	0	1	1.0
轻举妄动	1	0	0	1	1.0
轰轰烈烈	1	0	0	1	1.0
轰轰	1	0	0	1	1.0
轮回	1	0	0	1	1.0
转过	1	0	0	1	1.0
转转	1	0	0	1	1.0
转瞬	1	0	0	1	1.0
转手	1	0	0	1	1.0
转悠	1	0	0	1	1.0
转嫁给	0	1	0	1	1.0
转嫁	0	1	0	1	1.0
转头	0	1	0	1	1.0
转基因	0	1	0	1	1.0
转发给	0	1	0	1	1.0
转到	0	0	1	1	1.0
转下去	0	1	0	1	1.0
转下	0	1	0	1	1.0
轩然大波	0	0	1	1	1.0
轨	0	0	1	1	1.0
轧死	1	0	0	1	1.0
车队	0	0	1	1	1.0
车长	0	0	1	1	1.0
车迷	1	0	0	1	1.0
车行	0	1	0	1	1.0
车流	0	0	1	1	1.0
车底	0	1	0	1	1.0
车库	0	1	0	1	1.0
车展	1	0	0	1	1.0
身高	0	0	1	1	1.0
身经	1	0	0	1	1.0
身怀	1	0	0	1	1.0
身心	0	0	1	1	1.0
身影	0	1	0	1	1.0
身后	1	0	0	1	1.0
身体力行	0	1	0	1	1.0
身为	1	0	0	1	1.0
躁动	1	0	0	1	1.0
蹲	0	1	0	1	1.0
蹭	0	0	1	1	1.0
蹦蹦跳跳	0	0	1	1	1.0
蹦蹦跳	0	0	1	1	1.0
蹦蹦	0	0	1	1	1.0
蹦跳	0	0	1	1	1.0
蹦出	1	0	0	1	1.0
踩高跷	1	0	0	1	1.0
踏实	0	1	0	1	1.0
踏上	0	1	0	1	1.0
跳跃	1	0	0	1	1.0
跳舞	0	0	1	1	1.0
跳槽	0	1	0	1	1.0
路通	1	0	0	1	1.0
路途遥远	1	0	0	1	1.0
路途	1	0	0	1	1.0
路过	0	1	0	1	1.0
路路通	1	0	0	1	1.0
路易斯	0	0	1	1	1.0
路易	0	0	1	1	1.0
跟随	0	0	1	1	1.0
跟贴	1	0	0	1	1.0
跟我来	1	0	0	1	1.0
跟得上	1	0	0	1	1.0
跟得	1	0	0	1	1.0
跟帖	0	0	1	1	1.0
距	0	0	1	1	1.0
跑跳	1	0	0	1	1.0
跑跑跳跳	1	0	0	1	1.0
跑跑	1	0	0	1	1.0
跌	0	1	0	1	1.0
趴	0	0	1	1	1.0
足轻	1	0	0	1	1.0
足足	0	1	0	1	1.0
足球场	0	0	1	1	1.0
足球	0	0	1	1	1.0
趣味	1	0	0	1	1.0
越要	0	1	0	1	1.0
越来越低	0	1	0	1	1.0
越感	1	0	0	1	1.0
越南	0	0	1	1	1.0
超重	0	1	0	1	1.0
超载	0	1	0	1	1.0
超越	0	1	0	1	1.0
超市	1	0	0	1	1.0
超出	1	0	0	1	1.0
趁火打劫	0	1	0	1	1.0
趁	0	0	1	1	1.0
起航	1	0	0	1	1.0
起至	1	0	0	1	1.0
起火	0	0	1	1	1.0
起源于	1	0	0	1	1.0
起源	1	0	0	1	1.0
起死回生	0	1	0	1	1.0
起步价	0	1	0	1	1.0
起家	1	0	0	1	1.0
起价	0	0	1	1	1.0
起义	0	1	0	1	1.0
赶超	1	0	0	1	1.0
赶来	1	0	0	1	1.0
赶快	1	0	0	1	1.0
赶往	1	0	0	1	1.0
赶尽杀绝	0	1	0	1	1.0
赶场	1	0	0	1	1.0
赶不上	1	0	0	1	1.0
赶下台	1	0	0	1	1.0
赶下	1	0	0	1	1.0
赴美	1	0	0	1	1.0
走进	1	0	0	1	1.0
走过	1	0	0	1	1.0
走路	1	0	0	1	1.0
走访	0	0	1	1	1.0
走稳	1	0	0	1	1.0
走掉	1	0	0	1	1.0
走廊	0	0	1	1	1.0
走回头路	0	1	0	1	1.0
走回头	0	1	0	1	1.0
走回	0	1	0	1	1.0
走到	0	1	0	1	1.0
走入	0	0	1	1	1.0
走低	0	0	1	1	1.0
走亲访友	1	0	0	1	1.0
走下坡路	1	0	0	1	1.0
走下坡	1	0	0	1	1.0
走下	1	0	0	1	1.0
走上	0	1	0	1	1.0
赫然	0	0	1	1	1.0
赫拉	0	0	1	1	1.0
赤裸裸	0	1	0	1	1.0
赤裸	0	1	0	1	1.0
赢得	1	0	0	1	1.0
赡养父母	0	1	0	1	1.0
赠送	0	1	0	1	1.0
赞美	0	0	1	1	1.0
赞扬	0	1	0	1	1.0
赞助	1	0	0	1	1.0
赛龙舟	1	0	0	1	1.0
赛龙	1	0	0	1	1.0
赔不是	0	1	0	1	1.0
赔	0	1	0	1	1.0
赏金	0	1	0	1	1.0
赏	1	0	0	1	1.0
资源分配	0	0	1	1	1.0
资本主义	0	0	1	1	1.0
贾	0	1	0	1	1.0
贺年	1	0	0	1	1.0
贺岁片	0	0	1	1	1.0
贺岁	0	0	1	1	1.0
费心	1	0	0	1	1.0
费劲	1	0	0	1	1.0
贸易	1	0	0	1	1.0
贵阳	0	0	1	1	1.0
贵重	0	0	1	1	1.0
贵州	0	1	0	1	1.0
贵子	0	0	1	1	1.0
贴近生活	1	0	0	1	1.0
贴近	1	0	0	1	1.0
贴纸	0	1	0	1	1.0
贴着	0	0	1	1	1.0
贴图	0	1	0	1	1.0
贱民	0	1	0	1	1.0
贱	0	1	0	1	1.0
购物	1	0	0	1	1.0
购房	0	1	0	1	1.0
购买欲	0	0	1	1	1.0
贫贱夫妻	0	1	0	1	1.0
贫贱	0	1	0	1	1.0
贫瘠	1	0	0	1	1.0
贫富差距	0	1	0	1	1.0
贫富	0	1	0	1	1.0
贫乏	1	0	0	1	1.0
贫	0	1	0	1	1.0
贪污	1	0	0	1	1.0
贪官污吏	0	1	0	1	1.0
贪	0	1	0	1	1.0
贩卖	1	0	0	1	1.0
质问	0	1	0	1	1.0
质监局	0	0	1	1	1.0
质监	0	0	1	1	1.0
货价	0	1	0	1	1.0
败笔	0	1	0	1	1.0
败	1	0	0	1	1.0
责人	0	1	0	1	1.0
责	1	0	0	1	1.0
财运	1	0	0	1	1.0
财经网	0	1	0	1	1.0
财经新闻	0	0	1	1	1.0
财物	0	0	1	1	1.0
财源滚滚	1	0	0	1	1.0
财源	1	0	0	1	1.0
财气	1	0	0	1	1.0
财产权利	0	1	0	1	1.0
财产损失	0	0	1	1	1.0
财	0	0	1	1	1.0
贡	1	0	0	1	1.0
负责人	0	1	0	1	1.0
负荷	1	0	0	1	1.0
负翁	1	0	0	1	1.0
贞洁	0	1	0	1	1.0
贝	1	0	0	1	1.0
豫北	1	0	0	1	1.0
豪情	1	0	0	1	1.0
豪	0	1	0	1	1.0
象	0	1	0	1	1.0
豚	0	1	0	1	1.0
豆豆	1	0	0	1	1.0
豆包	1	0	0	1	1.0
谴责	0	1	0	1	1.0
谭	1	0	0	1	1.0
谬论	1	0	0	1	1.0
谩骂	1	0	0	1	1.0
谨防	0	1	0	1	1.0
谣言	0	1	0	1	1.0
谢谢你们	1	0	0	1	1.0
谢瓦尔德纳泽	0	1	0	1	1.0
谢瓦尔德纳	0	1	0	1	1.0
谢	0	0	1	1	1.0
谋财害命	0	0	1	1	1.0
谋财	0	0	1	1	1.0
谈资	0	1	0	1	1.0
谈笑风生	0	1	0	1	1.0
谈笑	0	1	0	1	1.0
谈朋友	0	0	1	1	1.0
谈恋爱	0	0	1	1	1.0
谈判	0	1	0	1	1.0
谈何	1	0	0	1	1.0
调运	0	1	0	1	1.0
调解员	0	1	0	1	1.0
调理	1	0	0	1	1.0
调和	1	0	0	1	1.0
调味剂	1	0	0	1	1.0
调味	1	0	0	1	1.0
调兵山	0	1	0	1	1.0
调兵	0	1	0	1	1.0
调停	0	1	0	1	1.0
调低	0	1	0	1	1.0
谁错	0	1	0	1	1.0
谁知	0	1	0	1	1.0
谁家	1	0	0	1	1.0
课程	0	0	1	1	1.0
课外	0	1	0	1	1.0
课堂	1	0	0	1	1.0
课后	1	0	0	1	1.0
读物	0	1	0	1	1.0
读到	0	0	1	1	1.0
诺夫	1	0	0	1	1.0
诸葛	1	0	0	1	1.0
请客	0	0	1	1	1.0
说起	0	0	1	1	1.0
说说话	1	0	0	1	1.0
说破	0	0	1	1	1.0
说瞎话	0	1	0	1	1.0
说服	1	0	0	1	1.0
说教	1	0	0	1	1.0
说得好	0	1	0	1	1.0
说句话	0	0	1	1	1.0
说句实话	0	1	0	1	1.0
说到做到	0	0	1	1	1.0
说不得	0	1	0	1	1.0
说一说	0	1	0	1	1.0
误触	0	1	0	1	1.0
误	0	1	0	1	1.0
语音	0	1	0	1	1.0
语无伦次	1	0	0	1	1.0
语录	0	0	1	1	1.0
语	0	1	0	1	1.0
该车	0	0	1	1	1.0
该是	0	1	0	1	1.0
该国	1	0	0	1	1.0
诞生	0	1	0	1	1.0
话费	0	0	1	1	1.0
话机	0	0	1	1	1.0
诚恳	0	0	1	1	1.0
诚	1	0	0	1	1.0
诗神	1	0	0	1	1.0
诗	1	0	0	1	1.0
试衣间	0	0	1	1	1.0
试衣	0	0	1	1	1.0
试纸	1	0	0	1	1.0
试用	0	0	1	1	1.0
试玩	0	1	0	1	1.0
试点	0	1	0	1	1.0
词	0	0	1	1	1.0
诊所	0	0	1	1	1.0
诈骗	1	0	0	1	1.0
诅咒	1	0	0	1	1.0
评理	0	1	0	1	1.0
证券	0	0	1	1	1.0
访友	1	0	0	1	1.0
访	0	0	1	1	1.0
设计师	0	1	0	1	1.0
设立	0	0	1	1	1.0
设有	0	0	1	1	1.0
讽刺	1	0	0	1	1.0
讽	0	0	1	1	1.0
论点	0	1	0	1	1.0
论持久战	0	0	1	1	1.0
论事	0	0	1	1	1.0
许愿	1	0	0	1	1.0
许州	1	0	0	1	1.0
许可证书	0	0	1	1	1.0
讲话	1	0	0	1	1.0
讲故事	1	0	0	1	1.0
讲座	0	1	0	1	1.0
讲出	1	0	0	1	1.0
讲义	0	0	1	1	1.0
记忆里	0	0	1	1	1.0
记录本	0	1	0	1	1.0
记住	0	0	1	1	1.0
记不住	0	0	1	1	1.0
记	0	0	1	1	1.0
讯	0	1	0	1	1.0
议论文	0	0	1	1	1.0
议会	0	0	1	1	1.0
训练	1	0	0	1	1.0
训	0	0	1	1	1.0
让给	0	1	0	1	1.0
让座	1	0	0	1	1.0
让出	0	0	1	1	1.0
讨生活	0	1	0	1	1.0
讨到	1	0	0	1	1.0
讨	0	1	0	1	1.0
认错	1	0	0	1	1.0
认定	1	0	0	1	1.0
认可	1	0	0	1	1.0
认亲	0	0	1	1	1.0
认不出来	0	0	1	1	1.0
认不出	0	0	1	1	1.0
订单式	1	0	0	1	1.0
订	0	1	0	1	1.0
计谋	0	1	0	1	1.0
计生委	1	0	0	1	1.0
计生办	0	1	0	1	1.0
计时	1	0	0	1	1.0
计学	1	0	0	1	1.0
计	0	1	0	1	1.0
警醒	0	1	0	1	1.0
警报声	0	0	1	1	1.0
警报	0	0	1	1	1.0
警官	1	0	0	1	1.0
誓死捍卫	0	1	0	1	1.0
誓死	0	1	0	1	1.0
誉为	1	0	0	1	1.0
言语	0	0	1	1	1.0
言论	1	0	0	1	1.0
言下之意	1	0	0	1	1.0
触及	1	0	0	1	1.0
触动	0	0	1	1	1.0
解除	1	0	0	1	1.0
解答	0	0	1	1	1.0
解放	1	0	0	1	1.0
解惑	0	0	1	1	1.0
解决不了	0	1	0	1	1.0
角落里	0	0	1	1	1.0
角色	1	0	0	1	1.0
角旗	1	0	0	1	1.0
角度看	0	0	1	1	1.0
觉着	0	1	0	1	1.0
视而不见	1	0	0	1	1.0
视网膜	1	0	0	1	1.0
视网	1	0	0	1	1.0
视同	0	1	0	1	1.0
规章制度	0	0	1	1	1.0
规律	0	1	0	1	1.0
观火	1	0	0	1	1.0
观察员	1	0	0	1	1.0
观世音	0	1	0	1	1.0
见证	0	1	0	1	1.0
见缝就钻	1	0	0	1	1.0
见成效	0	1	0	1	1.0
覆舟	0	1	0	1	1.0
要花费	0	1	0	1	1.0
要紧	1	0	0	1	1.0
要强	1	0	0	1	1.0
要图	1	0	0	1	1.0
要命	0	1	0	1	1.0
要件	0	1	0	1	1.0
要从严	0	0	1	1	1.0
要义	1	0	0	1	1.0
要不是	1	0	0	1	1.0
西门町	1	0	0	1	1.0
西门	1	0	0	1	1.0
西边	0	1	0	1	1.0
西装	1	0	0	1	1.0
西藏	1	0	0	1	1.0
西班牙	1	0	0	1	1.0
西环路	1	0	0	1	1.0
西游记	0	1	0	1	1.0
西欧	0	0	1	1	1.0
西柏坡	0	1	0	1	1.0
西域	0	0	1	1	1.0
西单	1	0	0	1	1.0
西北风	0	0	1	1	1.0
西北方	1	0	0	1	1.0
西北地区	1	0	0	1	1.0
西兰	0	1	0	1	1.0
西侧	0	1	0	1	1.0
西亚	1	0	0	1	1.0
褶	0	1	0	1	1.0
褪	0	1	0	1	1.0
裹足不前	0	1	0	1	1.0
裹足	0	1	0	1	1.0
裹	1	0	0	1	1.0
裸	0	0	1	1	1.0
裴	0	1	0	1	1.0
装进	0	0	1	1	1.0
装置	0	0	1	1	1.0
装盒	0	0	1	1	1.0
装潢	0	0	1	1	1.0
装模作样	1	0	0	1	1.0
装备	1	0	0	1	1.0
装到	0	1	0	1	1.0
装入	0	1	0	1	1.0
被誉为	1	0	0	1	1.0
被禁	0	1	0	1	1.0
被盗	0	0	1	1	1.0
被打乱	0	0	1	1	1.0
被忽视	0	1	0	1	1.0
被压迫	0	1	0	1	1.0
袜子	1	0	0	1	1.0
袜	1	0	0	1	1.0
袋子	1	0	0	1	1.0
衷心祝愿	1	0	0	1	1.0
衰落	0	1	0	1	1.0
衰老	0	0	1	1	1.0
衰弱	1	0	0	1	1.0
表述	1	0	0	1	1.0
表达方式	1	0	0	1	1.0
表象	0	1	0	1	1.0
表示感谢	1	0	0	1	1.0
表扬	0	1	0	1	1.0
表弟	1	0	0	1	1.0
表带	0	1	0	1	1.0
表姐	0	0	1	1	1.0
表妹	1	0	0	1	1.0
补贴	0	0	1	1	1.0
补助	0	1	0	1	1.0
补习	1	0	0	1	1.0
衣裳	0	1	0	1	1.0
衢州	0	1	0	1	1.0
衢	0	1	0	1	1.0
街道办	0	0	1	1	1.0
街头巷尾	0	1	0	1	1.0
衔接	0	1	0	1	1.0
衍生	0	0	1	1	1.0
行驶证	1	0	0	1	1.0
行路人	0	1	0	1	1.0
行政长官	1	0	0	1	1.0
行径	0	1	0	1	1.0
行列	0	1	0	1	1.0
行使	0	1	0	1	1.0
行之有效	0	0	1	1	1.0
行不行	0	0	1	1	1.0
血雨	0	1	0	1	1.0
血腥	1	0	0	1	1.0
血脉相连	1	0	0	1	1.0
血脉	1	0	0	1	1.0
血统	0	1	0	1	1.0
血糖	1	0	0	1	1.0
血球	1	0	0	1	1.0
血液	0	1	0	1	1.0
血洗	0	1	0	1	1.0
蠢事	1	0	0	1	1.0
蠢	1	0	0	1	1.0
螺丝	1	0	0	1	1.0
融入	1	0	0	1	1.0
螃蟹	1	0	0	1	1.0
蜡烛	1	0	0	1	1.0
蜗牛	0	0	1	1	1.0
蜂窝	1	0	0	1	1.0
蛾子	0	1	0	1	1.0
蛙	1	0	0	1	1.0
蛋糕店	0	0	1	1	1.0
蚕食	0	0	1	1	1.0
蚂蚁	0	0	1	1	1.0
虽	0	0	1	1	1.0
虞舜	1	0	0	1	1.0
虚荣	0	1	0	1	1.0
虚脱	1	0	0	1	1.0
虚岁	0	1	0	1	1.0
虚假	0	1	0	1	1.0
虚伪	1	0	0	1	1.0
虐杀	1	0	0	1	1.0
虐恋	0	0	1	1	1.0
虎虎	1	0	0	1	1.0
蘑菇云	1	0	0	1	1.0
蘑菇	1	0	0	1	1.0
藏	1	0	0	1	1.0
薰	0	0	1	1	1.0
薄	1	0	0	1	1.0
蔷薇	0	0	1	1	1.0
蔡	0	0	1	1	1.0
蔚蓝	0	1	0	1	1.0
蓝色	1	0	0	1	1.0
蓝绿	0	0	1	1	1.0
蓝牙	0	0	1	1	1.0
蓝光	1	0	0	1	1.0
蓄意	1	0	0	1	1.0
蒸	1	0	0	1	1.0
蒙哥马利	1	0	0	1	1.0
蒙哥	1	0	0	1	1.0
蒙古族	1	0	0	1	1.0
蒙古人	0	1	0	1	1.0
蒙	0	1	0	1	1.0
蒂固	1	0	0	1	1.0
葱	1	0	0	1	1.0
著称	1	0	0	1	1.0
落花流水	0	0	1	1	1.0
落花	0	0	1	1	1.0
落脚点	0	1	0	1	1.0
落脚	0	1	0	1	1.0
落户	0	1	0	1	1.0
落下来	0	1	0	1	1.0
落下	0	1	0	1	1.0
萨哈林	0	0	1	1	1.0
萨哈	0	0	1	1	1.0
萨	1	0	0	1	1.0
萧山	1	0	0	1	1.0
萦绕在	0	0	1	1	1.0
萦绕	0	0	1	1	1.0
营造	0	1	0	1	1.0
营生	1	0	0	1	1.0
营商	0	0	1	1	1.0
营利性	0	1	0	1	1.0
营利	0	1	0	1	1.0
营养	1	0	0	1	1.0
营	0	1	0	1	1.0
萍乡市	0	0	1	1	1.0
萍乡	0	0	1	1	1.0
菲	0	0	1	1	1.0
菩萨	0	1	0	1	1.0
菏泽	1	0	0	1	1.0
菌	0	1	0	1	1.0
菊花	1	0	0	1	1.0
菊	0	1	0	1	1.0
获利	0	1	0	1	1.0
获	0	0	1	1	1.0
莲藕	1	0	0	1	1.0
莱西	0	1	0	1	1.0
莫非	1	0	0	1	1.0
莫过于此	0	0	1	1	1.0
莫让	0	1	0	1	1.0
莫言	1	0	0	1	1.0
莫忘	1	0	0	1	1.0
莫名其妙	1	0	0	1	1.0
莫名	1	0	0	1	1.0
莉	0	0	1	1	1.0
荷兰	0	0	1	1	1.0
药物	1	0	0	1	1.0
药品	0	1	0	1	1.0
荧光棒	1	0	0	1	1.0
荧光	1	0	0	1	1.0
荣华	1	0	0	1	1.0
草莓	1	0	0	1	1.0
草民	0	1	0	1	1.0
草案	0	1	0	1	1.0
草原	1	0	0	1	1.0
草	0	0	1	1	1.0
茶馆	0	1	0	1	1.0
茶水	1	0	0	1	1.0
茶庄	0	1	0	1	1.0
茫茫	0	0	1	1	1.0
范畴	0	0	1	1	1.0
茂名	0	1	0	1	1.0
茁壮成长	0	0	1	1	1.0
茁壮	0	0	1	1	1.0
英镑	0	0	1	1	1.0
英勇斗争	1	0	0	1	1.0
英军	1	0	0	1	1.0
苦难	0	0	1	1	1.0
苦肉计	1	0	0	1	1.0
苦日子	0	0	1	1	1.0
苦哈哈	0	0	1	1	1.0
苦劝	0	1	0	1	1.0
苦主	1	0	0	1	1.0
若干年	0	1	0	1	1.0
若干	0	1	0	1	1.0
苟	0	1	0	1	1.0
苗	0	1	0	1	1.0
苏维埃共和国	0	1	0	1	1.0
苏维埃	0	1	0	1	1.0
苏区	1	0	0	1	1.0
苏俄	0	1	0	1	1.0
花销	0	1	0	1	1.0
花絮	1	0	0	1	1.0
花石	1	0	0	1	1.0
花生酱	1	0	0	1	1.0
花王	1	0	0	1	1.0
花灯	0	0	1	1	1.0
花栗鼠	1	0	0	1	1.0
花朵	0	0	1	1	1.0
花城	0	0	1	1	1.0
花园	1	0	0	1	1.0
花卷	1	0	0	1	1.0
芯	1	0	0	1	1.0
芝士	0	0	1	1	1.0
芜菁	1	0	0	1	1.0
芒	0	0	1	1	1.0
节食	0	1	0	1	1.0
节约型	0	1	0	1	1.0
节日期间	1	0	0	1	1.0
节奏快	1	0	0	1	1.0
节前	1	0	0	1	1.0
艾哈迈德	0	0	1	1	1.0
艾哈迈	0	0	1	1	1.0
艳	1	0	0	1	1.0
色调	1	0	0	1	1.0
艰辛	1	0	0	1	1.0
良辰	0	0	1	1	1.0
舰	1	0	0	1	1.0
般	0	1	0	1	1.0
航空公司	0	1	0	1	1.0
航	0	1	0	1	1.0
舞狮队	1	0	0	1	1.0
舞台	0	0	1	1	1.0
舞剑	1	0	0	1	1.0
舒畅	1	0	0	1	1.0
舒坦	1	0	0	1	1.0
舍本逐末	1	0	0	1	1.0
舍友	1	0	0	1	1.0
舍不得	1	0	0	1	1.0
舆论导向	0	1	0	1	1.0
舆情	0	0	1	1	1.0
致电	0	1	0	1	1.0
致命	0	1	0	1	1.0
致伤	0	1	0	1	1.0
臭味相投	0	1	0	1	1.0
臭味	0	1	0	1	1.0
自费	0	1	0	1	1.0
自负	0	0	1	1	1.0
自语	1	0	0	1	1.0
自言自语	1	0	0	1	1.0
自觉自愿	0	1	0	1	1.0
自艾	0	1	0	1	1.0
自称	0	0	1	1	1.0
自私自利	1	0	0	1	1.0
自私	1	0	0	1	1.0
自禁	0	0	1	1	1.0
自知	0	1	0	1	1.0
自由选择	0	1	0	1	1.0
自治县	1	0	0	1	1.0
自杀	0	0	1	1	1.0
自有	1	0	0	1	1.0
自愿者	0	1	0	1	1.0
自愈	0	1	0	1	1.0
自律	1	0	0	1	1.0
自家	1	0	0	1	1.0
自如	0	0	1	1	1.0
自古	1	0	0	1	1.0
自取	0	1	0	1	1.0
自发	0	1	0	1	1.0
自卫队	0	0	1	1	1.0
自动	0	1	0	1	1.0
自制	0	0	1	1	1.0
自利	1	0	0	1	1.0
自作自受	1	0	0	1	1.0
自作	1	0	0	1	1.0
自以为是	0	1	0	1	1.0
自以	0	1	0	1	1.0
自为	1	0	0	1	1.0
自个儿	0	1	0	1	1.0
自个	0	1	0	1	1.0
膨胀	0	1	0	1	1.0
膝下	1	0	0	1	1.0
膜	1	0	0	1	1.0
腿部	1	0	0	1	1.0
腾出	0	1	0	1	1.0
腻	0	0	1	1	1.0
腹痛	1	0	0	1	1.0
腹中	1	0	0	1	1.0
腰酸背疼	1	0	0	1	1.0
腰酸	1	0	0	1	1.0
腥风血雨	0	1	0	1	1.0
腐败无能	0	1	0	1	1.0
腐烂	1	0	0	1	1.0
腐	1	0	0	1	1.0
腊八	0	0	1	1	1.0
脸皮	0	1	0	1	1.0
脱身	0	1	0	1	1.0
脱离	0	1	0	1	1.0
脱口秀	1	0	0	1	1.0
脱口	1	0	0	1	1.0
脚踏车	1	0	0	1	1.0
脚跟	1	0	0	1	1.0
脚步	1	0	0	1	1.0
脚上	0	0	1	1	1.0
脑门	0	1	0	1	1.0
脑筋	1	0	0	1	1.0
脑海	0	0	1	1	1.0
脑子里	1	0	0	1	1.0
脐带血	0	0	1	1	1.0
能比	1	0	0	1	1.0
能干	1	0	0	1	1.0
能及	0	1	0	1	1.0
能力差	0	0	1	1	1.0
胡子	0	0	1	1	1.0
胡同	1	0	0	1	1.0
胡	0	0	1	1	1.0
胖子	1	0	0	1	1.0
胖	1	0	0	1	1.0
胎死腹中	1	0	0	1	1.0
胎心	0	1	0	1	1.0
胎儿	1	0	0	1	1.0
背着	0	1	0	1	1.0
胆小	0	1	0	1	1.0
胆	0	1	0	1	1.0
胃肠道	0	0	1	1	1.0
胃肠	0	0	1	1	1.0
胃口	0	0	1	1	1.0
肿	1	0	0	1	1.0
肺结核	0	1	0	1	1.0
肺	0	1	0	1	1.0
育人	0	0	1	1	1.0
肮脏	0	1	0	1	1.0
肤浅	0	1	0	1	1.0
肢解	0	1	0	1	1.0
股	0	0	1	1	1.0
肠道	0	0	1	1	1.0
肠粉	0	0	1	1	1.0
肚脐	0	0	1	1	1.0
肚子疼	0	0	1	1	1.0
肚	1	0	0	1	1.0
肖	1	0	0	1	1.0
肌肤	0	0	1	1	1.0
肌瘤	1	0	0	1	1.0
肌	0	0	1	1	1.0
肉中刺	1	0	0	1	1.0
肆虐	0	0	1	1	1.0
聚龙	0	0	1	1	1.0
聚散	0	0	1	1	1.0
聚在一起	0	1	0	1	1.0
聚众	0	0	1	1	1.0
联络	1	0	0	1	1.0
联播	0	0	1	1	1.0
联席会议	0	0	1	1	1.0
联席会	0	0	1	1	1.0
联席	0	0	1	1	1.0
联合国安理会	0	1	0	1	1.0
聒噪	0	1	0	1	1.0
职位	0	0	1	1	1.0
职业女性	0	1	0	1	1.0
聊起	0	0	1	1	1.0
聆听	0	0	1	1	1.0
耿直	1	0	0	1	1.0
耻	0	1	0	1	1.0
耳机	0	0	1	1	1.0
耗	0	1	0	1	1.0
耕读	1	0	0	1	1.0
耐用度	0	0	1	1	1.0
耐不住	0	1	0	1	1.0
耍赖	1	0	0	1	1.0
耍花样	0	1	0	1	1.0
耍	1	0	0	1	1.0
而论	1	0	0	1	1.0
而为	0	0	1	1	1.0
考驾照	0	0	1	1	1.0
考过	1	0	0	1	1.0
考证	0	1	0	1	1.0
考虑一下	0	0	1	1	1.0
考研	0	0	1	1	1.0
考生	0	0	1	1	1.0
考点	1	0	0	1	1.0
考察	1	0	0	1	1.0
考上	0	0	1	1	1.0
老鼠	1	0	0	1	1.0
老金	0	1	0	1	1.0
老规矩	0	0	1	1	1.0
老街	1	0	0	1	1.0
老知青	1	0	0	1	1.0
老王	1	0	0	1	1.0
老照片	1	0	0	1	1.0
老母鸡	1	0	0	1	1.0
老母	1	0	0	1	1.0
老早	0	1	0	1	1.0
老总	0	1	0	1	1.0
老张	1	0	0	1	1.0
老弟	1	0	0	1	1.0
老年人	0	1	0	1	1.0
老年	0	1	0	1	1.0
老巢	1	0	0	1	1.0
老头儿	0	1	0	1	1.0
老大徒伤	0	0	1	1	1.0
老处女	0	1	0	1	1.0
老周	1	0	0	1	1.0
老同学	1	0	0	1	1.0
老兄	0	0	1	1	1.0
老人家	0	1	0	1	1.0
老下	1	0	0	1	1.0
老一代	1	0	0	1	1.0
翼翼	0	0	1	1	1.0
翻身	0	0	1	1	1.0
翻版	1	0	0	1	1.0
翻墙	0	1	0	1	1.0
翻到	1	0	0	1	1.0
羹	1	0	0	1	1.0
群发	1	0	0	1	1.0
羔羊	0	1	0	1	1.0
美誉	0	1	0	1	1.0
美猴王	1	0	0	1	1.0
美满	1	0	0	1	1.0
美梦	1	0	0	1	1.0
美景	1	0	0	1	1.0
美尔	1	0	0	1	1.0
美妙	0	1	0	1	1.0
美国驻华大使馆	1	0	0	1	1.0
美国防部	0	0	1	1	1.0
美国防	0	0	1	1	1.0
美国政府	1	0	0	1	1.0
美国会	1	0	0	1	1.0
美味佳肴	1	0	0	1	1.0
美利坚	0	1	0	1	1.0
美利	0	1	0	1	1.0
署长	0	0	1	1	1.0
署	0	0	1	1	1.0
置于脑后	0	1	0	1	1.0
置于	0	1	0	1	1.0
罪魁祸首	1	0	0	1	1.0
罪魁	1	0	0	1	1.0
罪过	1	0	0	1	1.0
罪犯	1	0	0	1	1.0
罪孽	0	1	0	1	1.0
罪	0	1	0	1	1.0
网膜	1	0	0	1	1.0
网罗	1	0	0	1	1.0
网络图	0	1	0	1	1.0
网开一面	1	0	0	1	1.0
缺货	0	1	0	1	1.0
缺憾	1	0	0	1	1.0
缺心眼	1	0	0	1	1.0
缺德事	0	0	1	1	1.0
缺德	0	0	1	1	1.0
缺口	0	1	0	1	1.0
缺人	0	1	0	1	1.0
缴费	0	1	0	1	1.0
缴获	1	0	0	1	1.0
缩衣节食	0	1	0	1	1.0
缩短	0	1	0	1	1.0
缩成一团	0	0	1	1	1.0
缩成	0	0	1	1	1.0
缩减	0	0	1	1	1.0
缩	0	1	0	1	1.0
缤纷	1	0	0	1	1.0
缠绕	0	1	0	1	1.0
编队	1	0	0	1	1.0
编辑	0	0	1	1	1.0
编制	1	0	0	1	1.0
缔约国	0	1	0	1	1.0
缔约	0	1	0	1	1.0
缓冲期	0	0	1	1	1.0
缓冲	0	0	1	1	1.0
缓	1	0	0	1	1.0
缉	0	1	0	1	1.0
绿绿	1	0	0	1	1.0
绿帽子	1	0	0	1	1.0
绿帽	1	0	0	1	1.0
绽放	1	0	0	1	1.0
综合症	0	0	1	1	1.0
综合体	0	0	1	1	1.0
绸缪	0	0	1	1	1.0
维耶	1	0	0	1	1.0
维维	1	0	0	1	1.0
维持	1	0	0	1	1.0
维护正义	1	0	0	1	1.0
维护和平	1	0	0	1	1.0
维度	0	0	1	1	1.0
维埃	0	1	0	1	1.0
维和	0	0	1	1	1.0
绳子	0	1	0	1	1.0
绳	0	1	0	1	1.0
续	0	1	0	1	1.0
继而	0	0	1	1	1.0
绥芬河	0	0	1	1	1.0
统计局	1	0	0	1	1.0
统计	1	0	0	1	1.0
统统	0	1	0	1	1.0
统治者	0	1	0	1	1.0
统一标准	0	1	0	1	1.0
绞死	1	0	0	1	1.0
绞杀	1	0	0	1	1.0
绝配	1	0	0	1	1.0
绝经	0	0	1	1	1.0
绝症	0	0	1	1	1.0
绝活	1	0	0	1	1.0
绝望	0	1	0	1	1.0
绝大多数	1	0	0	1	1.0
绝后	1	0	0	1	1.0
绝伦	1	0	0	1	1.0
绝人	1	0	0	1	1.0
绝不能	1	0	0	1	1.0
绝	0	1	0	1	1.0
络绎不绝	1	0	0	1	1.0
络绎	1	0	0	1	1.0
绚烂	0	1	0	1	1.0
绕道	1	0	0	1	1.0
结队	1	0	0	1	1.0
结舌	1	0	0	1	1.0
结结实实	0	0	1	1	1.0
结结	0	0	1	1	1.0
结盟	0	1	0	1	1.0
结核	0	1	0	1	1.0
结果显示	1	0	0	1	1.0
结构	1	0	0	1	1.0
结晶	1	0	0	1	1.0
结扎	0	1	0	1	1.0
结彩	1	0	0	1	1.0
结实	0	0	1	1	1.0
结婚年龄	0	1	0	1	1.0
结下	0	1	0	1	1.0
绑架	0	1	0	1	1.0
绑	0	1	0	1	1.0
经销商	0	0	1	1	1.0
经销	0	0	1	1	1.0
经贸大学	1	0	0	1	1.0
经贸	1	0	0	1	1.0
经警	0	0	1	1	1.0
经纪人	0	1	0	1	1.0
经纪	0	1	0	1	1.0
经管	0	1	0	1	1.0
经济负担	1	0	0	1	1.0
经济网	0	1	0	1	1.0
经济特区	0	1	0	1	1.0
经济学	0	0	1	1	1.0
经商	0	1	0	1	1.0
经受	0	0	1	1	1.0
经典之作	0	1	0	1	1.0
绊脚	1	0	0	1	1.0
终生	0	0	1	1	1.0
终极	0	1	0	1	1.0
织女	1	0	0	1	1.0
细腻	1	0	0	1	1.0
细心	0	0	1	1	1.0
细则	1	0	0	1	1.0
绅士	1	0	0	1	1.0
组建	0	1	0	1	1.0
组件	0	0	1	1	1.0
练	0	0	1	1	1.0
线路	0	1	0	1	1.0
线	0	0	1	1	1.0
纽约	0	0	1	1	1.0
纸牌	0	0	1	1	1.0
纸屑	0	1	0	1	1.0
纸尿裤	1	0	0	1	1.0
纷纷表示	0	1	0	1	1.0
纵队	1	0	0	1	1.0
纵火	0	1	0	1	1.0
纵欲	0	0	1	1	1.0
纵横	0	1	0	1	1.0
纳粹	1	0	0	1	1.0
纳入	0	1	0	1	1.0
纯正	1	0	0	1	1.0
纯文字	0	0	1	1	1.0
纪录片	0	1	0	1	1.0
约旦	0	0	1	1	1.0
约合	0	0	1	1	1.0
红红火火	1	0	0	1	1.0
红红	1	0	0	1	1.0
红星	0	1	0	1	1.0
纠集	1	0	0	1	1.0
纠葛	1	0	0	1	1.0
纠纷	0	1	0	1	1.0
繁衍	0	1	0	1	1.0
繁荣	0	0	1	1	1.0
繁缛	1	0	0	1	1.0
繁多	1	0	0	1	1.0
繁华	1	0	0	1	1.0
累得	1	0	0	1	1.0
紫色	0	0	1	1	1.0
紫竹	0	0	1	1	1.0
紫丁香	1	0	0	1	1.0
紧迫性	0	0	1	1	1.0
紧迫	0	0	1	1	1.0
紧跟形势	0	0	1	1	1.0
紧跟	0	0	1	1	1.0
紧张	0	1	0	1	1.0
紧密	1	0	0	1	1.0
索性	1	0	0	1	1.0
素餐	1	0	0	1	1.0
素质教育	1	0	0	1	1.0
系统升级	0	0	1	1	1.0
系数	0	1	0	1	1.0
糟粕	0	1	0	1	1.0
糜烂	1	0	0	1	1.0
糊涂	1	0	0	1	1.0
糊口	0	1	0	1	1.0
精选	1	0	0	1	1.0
精神污染	0	1	0	1	1.0
精神文明	0	1	0	1	1.0
精液	0	0	1	1	1.0
精心	1	0	0	1	1.0
精彩绝伦	1	0	0	1	1.0
精巧	0	1	0	1	1.0
精子	1	0	0	1	1.0
精光	0	0	1	1	1.0
粮草先行	0	1	0	1	1.0
粮草	0	1	0	1	1.0
粮油	0	0	1	1	1.0
粘	0	0	1	1	1.0
粗	0	0	1	1	1.0
粒子	0	1	0	1	1.0
粉面	1	0	0	1	1.0
类型	0	0	1	1	1.0
米糠	1	0	0	1	1.0
米粉	1	0	0	1	1.0
米奇	1	0	0	1	1.0
米亚	0	1	0	1	1.0
籍	1	0	0	1	1.0
篇文章	0	1	0	1	1.0
篇	1	0	0	1	1.0
管理权	0	1	0	1	1.0
管理局	1	0	0	1	1.0
管教	1	0	0	1	1.0
管控	0	1	0	1	1.0
管好	0	0	1	1	1.0
算进去	0	1	0	1	1.0
算进	0	1	0	1	1.0
算计	0	1	0	1	1.0
算盘	1	0	0	1	1.0
算了	0	1	0	1	1.0
算不算	1	0	0	1	1.0
算下来	0	1	0	1	1.0
算下	0	1	0	1	1.0
简称	0	0	1	1	1.0
简易	0	1	0	1	1.0
签字	0	1	0	1	1.0
签名	0	1	0	1	1.0
筹	0	0	1	1	1.0
筷子	0	0	1	1	1.0
筱	0	1	0	1	1.0
筛查	0	0	1	1	1.0
策源地	0	1	0	1	1.0
答问	0	1	0	1	1.0
答案	1	0	0	1	1.0
等同于	1	0	0	1	1.0
等不及	1	0	0	1	1.0
笼罩着	1	0	0	1	1.0
笼罩	1	0	0	1	1.0
第四胎	0	0	1	1	1.0
第四等	0	0	1	1	1.0
第四届	1	0	0	1	1.0
第六	0	1	0	1	1.0
第五纵队	1	0	0	1	1.0
第五	1	0	0	1	1.0
第二次世界大战	0	0	1	1	1.0
第二次世	0	0	1	1	1.0
第二只	0	0	1	1	1.0
第三胎	1	0	0	1	1.0
第三期	1	0	0	1	1.0
第三周	0	0	1	1	1.0
第三个	0	0	1	1	1.0
第一集	0	0	1	1	1.0
第一期	1	0	0	1	1.0
第一声	0	1	0	1	1.0
第一句	1	0	0	1	1.0
第一件	0	1	0	1	1.0
笫	0	1	0	1	1.0
符拉迪沃斯托克	0	1	0	1	1.0
符拉迪	0	1	0	1	1.0
笑脸	1	0	0	1	1.0
笑死人	1	0	0	1	1.0
竿子	0	0	1	1	1.0
竹板	1	0	0	1	1.0
端机	0	0	1	1	1.0
童年	1	0	0	1	1.0
章	1	0	0	1	1.0
竟是	0	0	1	1	1.0
竟	0	1	0	1	1.0
竞猜	0	1	0	1	1.0
竞折腰	0	0	1	1	1.0
竞争力	1	0	0	1	1.0
站稳脚跟	1	0	0	1	1.0
站稳	1	0	0	1	1.0
立面	0	1	0	1	1.0
立法者	0	1	0	1	1.0
立案	0	1	0	1	1.0
立场	0	1	0	1	1.0
窦文涛	0	0	1	1	1.0
窦	0	1	0	1	1.0
窝	0	1	0	1	1.0
窗口	0	1	0	1	1.0
窃案	0	0	1	1	1.0
窃取	0	0	1	1	1.0
突突突	1	0	0	1	1.0
突突	1	0	0	1	1.0
突显	0	0	1	1	1.0
突变	0	1	0	1	1.0
穿用	1	0	0	1	1.0
穿帮	1	0	0	1	1.0
空隙	0	1	0	1	1.0
空腹	0	0	1	1	1.0
空白	1	0	0	1	1.0
空气清新	0	1	0	1	1.0
空文	1	0	0	1	1.0
空前绝后	1	0	0	1	1.0
空前	1	0	0	1	1.0
空出	0	1	0	1	1.0
空中	0	0	1	1	1.0
穆斯塔法	1	0	0	1	1.0
穆	1	0	0	1	1.0
稿费	1	0	0	1	1.0
稿	0	0	1	1	1.0
稻草	0	1	0	1	1.0
稳稳	0	0	1	1	1.0
稳扎稳打	1	0	0	1	1.0
稳扎	1	0	0	1	1.0
稳定性	1	0	0	1	1.0
稳准狠	0	1	0	1	1.0
稳	0	1	0	1	1.0
税	0	1	0	1	1.0
稍稍	0	0	1	1	1.0
稍	1	0	0	1	1.0
稀饭	1	0	0	1	1.0
稀少	0	1	0	1	1.0
移民	0	0	1	1	1.0
移交	1	0	0	1	1.0
移	0	1	0	1	1.0
称快	0	0	1	1	1.0
称呼	0	0	1	1	1.0
称号	1	0	0	1	1.0
称之为	0	1	0	1	1.0
积	1	0	0	1	1.0
秦皇岛市	1	0	0	1	1.0
租车	0	1	0	1	1.0
租	0	0	1	1	1.0
秘书	1	0	0	1	1.0
秒钟	0	0	1	1	1.0
科	1	0	0	1	1.0
秃子	1	0	0	1	1.0
私立	0	1	0	1	1.0
私有制	0	1	0	1	1.0
私有	0	1	0	1	1.0
私心	0	1	0	1	1.0
私囊	0	1	0	1	1.0
秀美	1	0	0	1	1.0
秀气	1	0	0	1	1.0
离间	1	0	0	1	1.0
离线	0	0	1	1	1.0
离析	1	0	0	1	1.0
离家近	1	0	0	1	1.0
离婚率	0	1	0	1	1.0
禹州	1	0	0	1	1.0
福龙	1	0	0	1	1.0
福音	1	0	0	1	1.0
福祉	1	0	0	1	1.0
福田区	1	0	0	1	1.0
福州市	0	1	0	1	1.0
禁锢	0	1	0	1	1.0
禁绝	0	1	0	1	1.0
禁放令	1	0	0	1	1.0
禁完	0	1	0	1	1.0
祸首	1	0	0	1	1.0
祸	1	0	0	1	1.0
祭神	1	0	0	1	1.0
祭祀	0	1	0	1	1.0
祭拜	1	0	0	1	1.0
祭扫	0	1	0	1	1.0
祭奠	0	1	0	1	1.0
祭	1	0	0	1	1.0
票	1	0	0	1	1.0
祥瑞	1	0	0	1	1.0
祥云	0	0	1	1	1.0
祥	1	0	0	1	1.0
神马	1	0	0	1	1.0
神采奕奕	1	0	0	1	1.0
神采	1	0	0	1	1.0
神经病	0	0	1	1	1.0
神经	0	0	1	1	1.0
神秘	1	0	0	1	1.0
神明	1	0	0	1	1.0
神学院	0	0	1	1	1.0
神学家	0	1	0	1	1.0
神圣不可	0	1	0	1	1.0
神圣	0	1	0	1	1.0
神似	1	0	0	1	1.0
祝福语	1	0	0	1	1.0
祝您	0	1	0	1	1.0
祈福	1	0	0	1	1.0
祈求	0	1	0	1	1.0
祈	1	0	0	1	1.0
社群	1	0	0	1	1.0
社火	1	0	0	1	1.0
社戏	1	0	0	1	1.0
社工	0	1	0	1	1.0
社会主义	0	1	0	1	1.0
社交	0	0	1	1	1.0
社	0	1	0	1	1.0
礼拜	0	0	1	1	1.0
礼品	0	1	0	1	1.0
礼俗	1	0	0	1	1.0
示意	1	0	0	1	1.0
示弱	0	1	0	1	1.0
磨叽	0	0	1	1	1.0
磨	1	0	0	1	1.0
磕头	1	0	0	1	1.0
磕	0	1	0	1	1.0
磐	1	0	0	1	1.0
磊磊	0	0	1	1	1.0
磊	0	0	1	1	1.0
碰到	0	0	1	1	1.0
碰上	1	0	0	1	1.0
碧海	0	0	1	1	1.0
碜	0	1	0	1	1.0
碎语	0	1	0	1	1.0
碎了心	0	1	0	1	1.0
碍事	1	0	0	1	1.0
确无	0	1	0	1	1.0
确切	1	0	0	1	1.0
确保安全	1	0	0	1	1.0
硬道理	0	1	0	1	1.0
硬盘	1	0	0	1	1.0
硬生生	1	0	0	1	1.0
硬汉	0	1	0	1	1.0
硬度	0	0	1	1	1.0
硬	1	0	0	1	1.0
硫磺	0	1	0	1	1.0
硝烟弥漫	0	0	1	1	1.0
硝烟	0	0	1	1	1.0
硅胶	0	0	1	1	1.0
破碎	0	1	0	1	1.0
破口大骂	1	0	0	1	1.0
破口	1	0	0	1	1.0
破例	0	1	0	1	1.0
砲	0	1	0	1	1.0
砝码	0	0	1	1	1.0
研究所	0	1	0	1	1.0
研究会	0	1	0	1	1.0
研发	0	1	0	1	1.0
砍头	1	0	0	1	1.0
码头	0	0	1	1	1.0
石油价格	0	1	0	1	1.0
石榴	1	0	0	1	1.0
石化	1	0	0	1	1.0
短途	0	0	1	1	1.0
短缺	1	0	0	1	1.0
短篇小说	1	0	0	1	1.0
短篇	1	0	0	1	1.0
短短	0	0	1	1	1.0
短片	0	0	1	1	1.0
短消息	0	1	0	1	1.0
短波	1	0	0	1	1.0
短期内	0	1	0	1	1.0
短时期	0	1	0	1	1.0
知青	1	0	0	1	1.0
知足	1	0	0	1	1.0
知多少	1	0	0	1	1.0
知名人士	0	1	0	1	1.0
知名	0	1	0	1	1.0
知不知道	0	0	1	1	1.0
矣	0	0	1	1	1.0
矛盾激化	0	1	0	1	1.0
瞬间	0	0	1	1	1.0
瞪	1	0	0	1	1.0
瞠目结舌	1	0	0	1	1.0
瞠目	1	0	0	1	1.0
瞎话	0	1	0	1	1.0
瞎眼	1	0	0	1	1.0
瞎搞	0	1	0	1	1.0
瞎折腾	0	0	1	1	1.0
睿智	0	0	1	1	1.0
睽睽	0	1	0	1	1.0
睡美人	1	0	0	1	1.0
睁眼	0	1	0	1	1.0
睁开眼睛	0	1	0	1	1.0
睁开眼	0	1	0	1	1.0
睁开	0	1	0	1	1.0
睁一只眼	1	0	0	1	1.0
睁	1	0	0	1	1.0
着实	0	1	0	1	1.0
眼见为实	1	0	0	1	1.0
眼见	1	0	0	1	1.0
眼罩	0	1	0	1	1.0
眼皮	0	1	0	1	1.0
眼球	0	0	1	1	1.0
眼珠子	1	0	0	1	1.0
眼珠	1	0	0	1	1.0
眼压	1	0	0	1	1.0
眼不见	0	1	0	1	1.0
眯眼	0	1	0	1	1.0
眯眯眼	0	1	0	1	1.0
眨眼	1	0	0	1	1.0
真要	1	0	0	1	1.0
真累	0	1	0	1	1.0
真理	0	1	0	1	1.0
真是太	0	0	1	1	1.0
真想念	1	0	0	1	1.0
真性情	0	0	1	1	1.0
真性	0	0	1	1	1.0
真对	0	1	0	1	1.0
真好玩	0	1	0	1	1.0
真好	0	1	0	1	1.0
真受不了	0	0	1	1	1.0
真切感	0	1	0	1	1.0
真切	0	1	0	1	1.0
真假难辨	0	1	0	1	1.0
真假	0	1	0	1	1.0
真主党	0	1	0	1	1.0
真不知道	1	0	0	1	1.0
真不容易	1	0	0	1	1.0
看穿	0	1	0	1	1.0
看病	0	1	0	1	1.0
看点	0	0	1	1	1.0
看清楚	1	0	0	1	1.0
看清	1	0	0	1	1.0
看淡	0	0	1	1	1.0
看得见	0	1	0	1	1.0
看客	1	0	0	1	1.0
看中	1	0	0	1	1.0
看不见	1	0	0	1	1.0
看不得	0	0	1	1	1.0
看不下去	1	0	0	1	1.0
省委	1	0	0	1	1.0
省城	0	0	1	1	1.0
省内	1	0	0	1	1.0
相逢	0	1	0	1	1.0
相连	1	0	0	1	1.0
相近	1	0	0	1	1.0
相聚	1	0	0	1	1.0
相继	0	1	0	1	1.0
相片	1	0	0	1	1.0
相投	0	1	0	1	1.0
相悖	0	0	1	1	1.0
相夫教子	0	1	0	1	1.0
相夫	0	1	0	1	1.0
相处	0	0	1	1	1.0
相像	0	0	1	1	1.0
相似	0	0	1	1	1.0
相亲相爱	1	0	0	1	1.0
相互间	0	0	1	1	1.0
相争	0	0	1	1	1.0
相	0	0	1	1	1.0
直行	1	0	0	1	1.0
直营店	0	0	1	1	1.0
直营	0	0	1	1	1.0
直线	0	1	0	1	1.0
直播	0	0	1	1	1.0
直指	0	1	0	1	1.0
直到现在	0	0	1	1	1.0
盲	0	1	0	1	1.0
目前为止	1	0	0	1	1.0
盟国	1	0	0	1	1.0
盛开	1	0	0	1	1.0
盛	0	0	1	1	1.0
盗窃案	0	0	1	1	1.0
盗窃	0	0	1	1	1.0
盗匪	0	0	1	1	1.0
盖戳	1	0	0	1	1.0
监视	0	1	0	1	1.0
监管部门	0	1	0	1	1.0
监管部	0	1	0	1	1.0
监管局	0	0	1	1	1.0
监禁	1	0	0	1	1.0
监测点	0	1	0	1	1.0
监控	0	1	0	1	1.0
监事会	1	0	0	1	1.0
监事	1	0	0	1	1.0
监	0	1	0	1	1.0
盐官	1	0	0	1	1.0
盐城	0	0	1	1	1.0
盐	0	1	0	1	1.0
益	0	0	1	1	1.0
盈利	0	0	1	1	1.0
盆地	0	1	0	1	1.0
百遍	0	1	0	1	1.0
百越	0	1	0	1	1.0
百米	1	0	0	1	1.0
百态	0	0	1	1	1.0
百家	1	0	0	1	1.0
百姓生活	0	0	1	1	1.0
百多年	0	1	0	1	1.0
百元	0	0	1	1	1.0
百事	0	1	0	1	1.0
白骨精	1	0	0	1	1.0
白骨	1	0	0	1	1.0
白衣	1	0	0	1	1.0
白菜	1	0	0	1	1.0
白胡子	0	0	1	1	1.0
白旗	0	1	0	1	1.0
白事	1	0	0	1	1.0
登山	1	0	0	1	1.0
登场	1	0	0	1	1.0
癸巳	1	0	0	1	1.0
癖	0	0	1	1	1.0
瘴气	0	1	0	1	1.0
瘫	0	0	1	1	1.0
瘦	1	0	0	1	1.0
瘢痕	1	0	0	1	1.0
痛骂	0	1	0	1	1.0
痛经	0	1	0	1	1.0
痛痒	1	0	0	1	1.0
痛楚	1	0	0	1	1.0
痛快	0	0	1	1	1.0
痛心	0	1	0	1	1.0
痛处	1	0	0	1	1.0
痘痘	1	0	0	1	1.0
症结	0	1	0	1	1.0
症	0	1	0	1	1.0
病猫	1	0	0	1	1.0
病狂	0	1	0	1	1.0
病房	1	0	0	1	1.0
病患者	0	0	1	1	1.0
病患	0	0	1	1	1.0
病急	0	0	1	1	1.0
病态	0	1	0	1	1.0
病因	0	1	0	1	1.0
病人	0	1	0	1	1.0
疾	1	0	0	1	1.0
疲劳	0	0	1	1	1.0
疲于	1	0	0	1	1.0
疲乏	1	0	0	1	1.0
疯狗	0	1	0	1	1.0
疑点	0	1	0	1	1.0
疏导	0	1	0	1	1.0
疏于	0	1	0	1	1.0
疆	1	0	0	1	1.0
番邦	0	0	1	1	1.0
番	0	1	0	1	1.0
略有	0	0	1	1	1.0
留给	0	1	0	1	1.0
畏惧	1	0	0	1	1.0
界定	0	0	1	1	1.0
界	1	0	0	1	1.0
畅所欲言	0	0	1	1	1.0
畅	1	0	0	1	1.0
男方	0	0	1	1	1.0
男性	0	1	0	1	1.0
男孩子	1	0	0	1	1.0
男士	1	0	0	1	1.0
男团	1	0	0	1	1.0
男友	0	0	1	1	1.0
电路	1	0	0	1	1.0
电灯泡	0	0	1	1	1.0
电灯	0	0	1	1	1.0
电源	0	1	0	1	1.0
电流	0	1	0	1	1.0
电报	0	0	1	1	1.0
电影界	0	0	1	1	1.0
电子警察	1	0	0	1	1.0
电子版	1	0	0	1	1.0
电台	1	0	0	1	1.0
电压	0	0	1	1	1.0
电动汽车	0	1	0	1	1.0
电动机	0	0	1	1	1.0
申遗	1	0	0	1	1.0
甲	0	0	1	1	1.0
由此而来	0	0	1	1	1.0
由此	0	0	1	1	1.0
由来已久	1	0	0	1	1.0
由不得	1	0	0	1	1.0
田间	0	1	0	1	1.0
甭说	0	1	0	1	1.0
甭管	1	0	0	1	1.0
甬	1	0	0	1	1.0
用者	0	1	0	1	1.0
用来用去	0	1	0	1	1.0
用户群	0	0	1	1	1.0
用尽	0	0	1	1	1.0
用去	0	1	0	1	1.0
用力	0	1	0	1	1.0
用不完	0	1	0	1	1.0
生贵子	0	0	1	1	1.0
生理需求	0	1	0	1	1.0
生理	0	1	0	1	1.0
生物链	0	0	1	1	1.0
生点	0	1	0	1	1.0
生源	0	1	0	1	1.0
生活富裕	1	0	0	1	1.0
生水	0	1	0	1	1.0
生死未卜	0	1	0	1	1.0
生死	0	1	0	1	1.0
生日礼物	1	0	0	1	1.0
生怕	0	0	1	1	1.0
生态系统	0	0	1	1	1.0
生态系	0	0	1	1	1.0
生姜	1	0	0	1	1.0
生命财产	0	1	0	1	1.0
生命安全	1	0	0	1	1.0
生命危险	0	1	0	1	1.0
生前	1	0	0	1	1.0
生出	1	0	0	1	1.0
生养	0	0	1	1	1.0
生人	0	0	1	1	1.0
生产成本	0	1	0	1	1.0
生下	0	0	1	1	1.0
甜食	0	0	1	1	1.0
甜甜	1	0	0	1	1.0
甚或	0	0	1	1	1.0
甘美	0	0	1	1	1.0
甘地	0	1	0	1	1.0
甘	0	1	0	1	1.0
瓶装	0	1	0	1	1.0
瓶	1	0	0	1	1.0
瓦尔德纳	0	1	0	1	1.0
瓦尔德	0	1	0	1	1.0
瓦尔	0	1	0	1	1.0
瓦伦西亚	1	0	0	1	1.0
瓦伦西	1	0	0	1	1.0
瑞雪兆丰年	1	0	0	1	1.0
瑞雪兆	1	0	0	1	1.0
瑕	1	0	0	1	1.0
琴	0	0	1	1	1.0
琮	1	0	0	1	1.0
琢磨	1	0	0	1	1.0
理赔	0	0	1	1	1.0
理论	1	0	0	1	1.0
理应	1	0	0	1	1.0
理学	0	0	1	1	1.0
理合	0	0	1	1	1.0
理事会	1	0	0	1	1.0
理	0	0	1	1	1.0
球场	0	0	1	1	1.0
班车	0	0	1	1	1.0
班级	0	0	1	1	1.0
班子	0	1	0	1	1.0
珠海	1	0	0	1	1.0
珠子	1	0	0	1	1.0
珍贵	1	0	0	1	1.0
珍珠	1	0	0	1	1.0
现货	0	0	1	1	1.0
现行政策	0	1	0	1	1.0
现成	0	1	0	1	1.0
现场报道	0	0	1	1	1.0
现出	1	0	0	1	1.0
现况	1	0	0	1	1.0
现代文明	0	1	0	1	1.0
现代文	0	1	0	1	1.0
环路	1	0	0	1	1.0
环节	0	1	0	1	1.0
环线	0	1	0	1	1.0
环生	1	0	0	1	1.0
环球时报	0	1	0	1	1.0
环球	0	1	0	1	1.0
环境质量	0	0	1	1	1.0
环境监测	0	0	1	1	1.0
环境保护局	0	0	1	1	1.0
环保网	0	1	0	1	1.0
玫瑰色	0	1	0	1	1.0
玩闹	1	0	0	1	1.0
玩耍	1	0	0	1	1.0
玩火	1	0	0	1	1.0
玩游戏	1	0	0	1	1.0
玩游	1	0	0	1	1.0
玩伴	1	0	0	1	1.0
王者	1	0	0	1	1.0
王爷	1	0	0	1	1.0
王子	0	1	0	1	1.0
王女士	0	1	0	1	1.0
王大夫	0	1	0	1	1.0
率先	0	1	0	1	1.0
猴王	1	0	0	1	1.0
献身	0	0	1	1	1.0
献上	1	0	0	1	1.0
献	1	0	0	1	1.0
猫腻	0	1	0	1	1.0
猪脑子	0	1	0	1	1.0
猪脑	0	1	0	1	1.0
猪油	0	1	0	1	1.0
猪仔	0	1	0	1	1.0
猜猜	1	0	0	1	1.0
猜想	0	1	0	1	1.0
猛击	1	0	0	1	1.0
猛兽	0	0	1	1	1.0
猛	1	0	0	1	1.0
猖獗	1	0	0	1	1.0
猖狂	1	0	0	1	1.0
狼藉	0	0	1	1	1.0
狮子会	0	1	0	1	1.0
狭路相逢	0	1	0	1	1.0
狭路	0	1	0	1	1.0
独钟	0	1	0	1	1.0
独裁者	0	1	0	1	1.0
独立性	1	0	0	1	1.0
独生子女证	0	1	0	1	1.0
独断	0	1	0	1	1.0
独家	0	0	1	1	1.0
独子	0	0	1	1	1.0
独善其身	0	0	1	1	1.0
独善	0	0	1	1	1.0
独占	1	0	0	1	1.0
狡辩	0	1	0	1	1.0
狡猾	1	0	0	1	1.0
狗贼	1	0	0	1	1.0
狗血	1	0	0	1	1.0
狗肉	0	1	0	1	1.0
狗狗	1	0	0	1	1.0
狗屎	0	0	1	1	1.0
狗咬狗	0	1	0	1	1.0
狄	0	1	0	1	1.0
狂轰滥炸	0	1	0	1	1.0
状	1	0	0	1	1.0
犯罪活动	1	0	0	1	1.0
犯人	0	0	1	1	1.0
犬	0	1	0	1	1.0
牺牲品	0	1	0	1	1.0
特辑	1	0	0	1	1.0
特设	0	1	0	1	1.0
特种兵	0	1	0	1	1.0
特斯拉	1	0	0	1	1.0
特斯	1	0	0	1	1.0
特效	0	0	1	1	1.0
特意	0	0	1	1	1.0
特征	1	0	0	1	1.0
特工	0	0	1	1	1.0
特勒	0	1	0	1	1.0
牵挂	1	0	0	1	1.0
牵扯	0	0	1	1	1.0
牵动	0	1	0	1	1.0
牵出去	1	0	0	1	1.0
牵出	1	0	0	1	1.0
牵	1	0	0	1	1.0
牲口	0	0	1	1	1.0
物美	0	0	1	1	1.0
物种	0	0	1	1	1.0
物极必反	1	0	0	1	1.0
物品	0	1	0	1	1.0
物件	1	0	0	1	1.0
物业	0	1	0	1	1.0
牢	0	1	0	1	1.0
牡丹江	0	0	1	1	1.0
牡丹	0	0	1	1	1.0
牛郎织女	1	0	0	1	1.0
牛车	0	1	0	1	1.0
牛气	1	0	0	1	1.0
牛奶	1	0	0	1	1.0
爷们儿	1	0	0	1	1.0
爷们	1	0	0	1	1.0
父母亲	1	0	0	1	1.0
父亲节	1	0	0	1	1.0
爱祖国	0	1	0	1	1.0
爱犬	0	0	1	1	1.0
爱才	1	0	0	1	1.0
爱戴	1	0	0	1	1.0
爱心	1	0	0	1	1.0
爱幼	1	0	0	1	1.0
爱好和平	1	0	0	1	1.0
爱哭	1	0	0	1	1.0
爱人	1	0	0	1	1.0
爱乐维	1	0	0	1	1.0
爱乐	1	0	0	1	1.0
爱不释手	1	0	0	1	1.0
爱不释	1	0	0	1	1.0
爱不爱	1	0	0	1	1.0
爬山	1	0	0	1	1.0
爆满	0	1	0	1	1.0
爆棚	0	0	1	1	1.0
爆出	0	0	1	1	1.0
燎原	0	1	0	1	1.0
熬过	1	0	0	1	1.0
熬	0	0	1	1	1.0
熟饭	1	0	0	1	1.0
熟人	1	0	0	1	1.0
熄	0	1	0	1	1.0
煽情	1	0	0	1	1.0
煽动	1	0	0	1	1.0
照料	1	0	0	1	1.0
照搬	0	1	0	1	1.0
照应	1	0	0	1	1.0
照常	0	1	0	1	1.0
煤场	0	0	1	1	1.0
煤仓	0	1	0	1	1.0
煞有其事	1	0	0	1	1.0
焦点访谈	0	0	1	1	1.0
焦	1	0	0	1	1.0
焕发	0	0	1	1	1.0
烹	0	0	1	1	1.0
热门话题	0	1	0	1	1.0
热销	0	0	1	1	1.0
热络	0	0	1	1	1.0
热爱祖国	0	1	0	1	1.0
热烈响应	0	1	0	1	1.0
热情	0	1	0	1	1.0
热度	0	1	0	1	1.0
烧煤	1	0	0	1	1.0
烧死	0	1	0	1	1.0
烧杀抢掠	0	1	0	1	1.0
烧杀	0	1	0	1	1.0
烦躁	0	1	0	1	1.0
烦死人	1	0	0	1	1.0
烦死	1	0	0	1	1.0
烟雾弥漫	0	0	1	1	1.0
烟花节	0	0	1	1	1.0
烟瘴	0	1	0	1	1.0
烟头	0	1	0	1	1.0
烟台	1	0	0	1	1.0
烟	0	1	0	1	1.0
烘	1	0	0	1	1.0
烈烈	1	0	0	1	1.0
烂透	0	1	0	1	1.0
烂泥	0	1	0	1	1.0
点错	1	0	0	1	1.0
点钟	0	1	0	1	1.0
点评	0	1	0	1	1.0
点破	0	1	0	1	1.0
点燃	0	1	0	1	1.0
点灯	1	0	0	1	1.0
点心	1	0	0	1	1.0
点子	0	0	1	1	1.0
点头	1	0	0	1	1.0
炸锅	0	1	0	1	1.0
炮竹	0	1	0	1	1.0
炮灰	0	1	0	1	1.0
炮声隆隆	1	0	0	1	1.0
炮击	1	0	0	1	1.0
炮兵	0	1	0	1	1.0
炮仗	0	0	1	1	1.0
炫耀	0	1	0	1	1.0
炎黄	0	1	0	1	1.0
炎症	1	0	0	1	1.0
灿	1	0	0	1	1.0
灾区	1	0	0	1	1.0
灶王爷	1	0	0	1	1.0
灵活性	1	0	0	1	1.0
灵敏	0	0	1	1	1.0
灵巧	0	0	1	1	1.0
灯火	1	0	0	1	1.0
灯泡	0	0	1	1	1.0
灯	1	0	0	1	1.0
灭绝人性	1	0	0	1	1.0
灭族	1	0	0	1	1.0
灭国	0	0	1	1	1.0
火鸡	1	0	0	1	1.0
火苗	1	0	0	1	1.0
火祭	1	0	0	1	1.0
火热	0	0	1	1	1.0
火烧	1	0	0	1	1.0
火炮	0	1	0	1	1.0
火灾事故	0	1	0	1	1.0
火旺	1	0	0	1	1.0
火上浇油	0	1	0	1	1.0
灌	0	0	1	1	1.0
濮	0	1	0	1	1.0
激进	1	0	0	1	1.0
激情	1	0	0	1	1.0
激发	1	0	0	1	1.0
澳洲	1	0	0	1	1.0
澳	1	0	0	1	1.0
澥	0	1	0	1	1.0
潮红	0	1	0	1	1.0
潮汕	0	0	1	1	1.0
潮州	1	0	0	1	1.0
潜藏着	0	0	1	1	1.0
潜藏	0	0	1	1	1.0
潜意识	0	1	0	1	1.0
潜力	1	0	0	1	1.0
潜入	0	0	1	1	1.0
潜伏	0	0	1	1	1.0
潍坊	0	1	0	1	1.0
漫长	1	0	0	1	1.0
漫漫	1	0	0	1	1.0
漫天	0	1	0	1	1.0
漫	0	1	0	1	1.0
漩涡	0	0	1	1	1.0
漠河	0	0	1	1	1.0
演绎	0	0	1	1	1.0
演唱会	1	0	0	1	1.0
演出	1	0	0	1	1.0
漂游	1	0	0	1	1.0
滴滴	1	0	0	1	1.0
滴水	0	1	0	1	1.0
滩	0	1	0	1	1.0
滨	1	0	0	1	1.0
滥用	0	1	0	1	1.0
滥杀无辜	0	1	0	1	1.0
滥杀	0	1	0	1	1.0
满钻石	0	1	0	1	1.0
满足感	1	0	0	1	1.0
满清	0	1	0	1	1.0
满月酒	1	0	0	1	1.0
满族	1	0	0	1	1.0
满怀豪情	1	0	0	1	1.0
满心欢喜	0	0	1	1	1.0
满心	0	0	1	1	1.0
满州国	0	1	0	1	1.0
满州	0	1	0	1	1.0
满屋	1	0	0	1	1.0
满天	0	0	1	1	1.0
满城风雨	0	0	1	1	1.0
满嘴	1	0	0	1	1.0
滞留	0	0	1	1	1.0
滚出来	1	0	0	1	1.0
滚出	1	0	0	1	1.0
滚	1	0	0	1	1.0
滔天	0	1	0	1	1.0
滑雪	1	0	0	1	1.0
滑板车	0	0	1	1	1.0
滑板	0	0	1	1	1.0
滑	0	0	1	1	1.0
滋滋	0	1	0	1	1.0
滋味	0	0	1	1	1.0
滋养	1	0	0	1	1.0
滋事	1	0	0	1	1.0
溜溜	1	0	0	1	1.0
源自	1	0	0	1	1.0
源地	0	1	0	1	1.0
湿气	0	0	1	1	1.0
湾	1	0	0	1	1.0
湛江	1	0	0	1	1.0
湘江	1	0	0	1	1.0
湖州	0	1	0	1	1.0
湖	0	0	1	1	1.0
游走	0	0	1	1	1.0
游记	0	1	0	1	1.0
游玩	1	0	0	1	1.0
游子	1	0	0	1	1.0
港版	0	0	1	1	1.0
港币	0	0	1	1	1.0
港城	0	0	1	1	1.0
港台腔	0	0	1	1	1.0
港台	0	0	1	1	1.0
温馨	1	0	0	1	1.0
温雅	0	1	0	1	1.0
温柔	0	0	1	1	1.0
温情	1	0	0	1	1.0
温度	0	0	1	1	1.0
温	0	0	1	1	1.0
渠道	1	0	0	1	1.0
渔翁得利	1	0	0	1	1.0
渔翁	1	0	0	1	1.0
渐进	1	0	0	1	1.0
渐渐	1	0	0	1	1.0
渉	1	0	0	1	1.0
清风明月	1	0	0	1	1.0
清风	1	0	0	1	1.0
清除	1	0	0	1	1.0
清醒	0	1	0	1	1.0
清运	0	0	1	1	1.0
清真寺	0	0	1	1	1.0
清真	0	0	1	1	1.0
清白	0	1	0	1	1.0
清溪	0	1	0	1	1.0
清汤寡水	0	1	0	1	1.0
清汤	0	1	0	1	1.0
清政府	0	1	0	1	1.0
清华大学	0	1	0	1	1.0
清净	0	1	0	1	1.0
添置	1	0	0	1	1.0
添加	1	0	0	1	1.0
添丁	0	1	0	1	1.0
淸	0	1	0	1	1.0
混血	1	0	0	1	1.0
混蛋	1	0	0	1	1.0
深谙	1	0	0	1	1.0
深深地	0	0	1	1	1.0
深得我心	1	0	0	1	1.0
深夜	1	0	0	1	1.0
深圳特区	1	0	0	1	1.0
深圳湾	0	0	1	1	1.0
深圳大学	0	0	1	1	1.0
深呼吸	0	0	1	1	1.0
深呼	0	0	1	1	1.0
深受	0	0	1	1	1.0
深化	0	0	1	1	1.0
深刻	1	0	0	1	1.0
深入人心	0	1	0	1	1.0
深入	0	1	0	1	1.0
深信	0	0	1	1	1.0
淫	1	0	0	1	1.0
淡薄	1	0	0	1	1.0
淡漠	1	0	0	1	1.0
淘气	0	1	0	1	1.0
淘	0	0	1	1	1.0
淑女	0	0	1	1	1.0
淋	0	1	0	1	1.0
涨起	0	1	0	1	1.0
涡	0	1	0	1	1.0
涛声	1	0	0	1	1.0
涌入	0	0	1	1	1.0
涉嫌	1	0	0	1	1.0
消除	1	0	0	1	1.0
消防官兵	0	0	1	1	1.0
消费观	0	1	0	1	1.0
消极	0	1	0	1	1.0
消化	1	0	0	1	1.0
消亡	0	1	0	1	1.0
涅	1	0	0	1	1.0
浸润	1	0	0	1	1.0
海龙	0	1	0	1	1.0
海鲜	1	0	0	1	1.0
海马	1	0	0	1	1.0
海运	0	0	1	1	1.0
海边	0	0	1	1	1.0
海空	1	0	0	1	1.0
海燕	1	0	0	1	1.0
海滨	0	1	0	1	1.0
海涛	1	0	0	1	1.0
海拔	1	0	0	1	1.0
海底	1	0	0	1	1.0
海岸	0	0	1	1	1.0
海宁市	1	0	0	1	1.0
海宁	1	0	0	1	1.0
海外华人	1	0	0	1	1.0
海地	0	0	1	1	1.0
海口市	0	0	1	1	1.0
海口	0	0	1	1	1.0
海关	0	1	0	1	1.0
海事	1	0	0	1	1.0
海之滨	0	0	1	1	1.0
浮动	0	1	0	1	1.0
浪费资源	0	1	0	1	1.0
浪漫	1	0	0	1	1.0
浩特	0	1	0	1	1.0
浩大	1	0	0	1	1.0
浦和	0	1	0	1	1.0
浓烟滚滚	0	0	1	1	1.0
浓烟	0	0	1	1	1.0
浓烈	0	0	1	1	1.0
浑水	0	0	1	1	1.0
浏览量	0	1	0	1	1.0
浏览器	0	0	1	1	1.0
济学	0	0	1	1	1.0
测点	0	1	0	1	1.0
浇灭	0	1	0	1	1.0
浅薄	0	1	0	1	1.0
浅显	1	0	0	1	1.0
流程	0	0	1	1	1.0
流畅性	0	1	0	1	1.0
流流	0	1	0	1	1.0
流泪	0	0	1	1	1.0
流水	0	0	1	1	1.0
流感	0	1	0	1	1.0
流失	0	1	0	1	1.0
流传	1	0	0	1	1.0
流人	0	0	1	1	1.0
派系	1	0	0	1	1.0
派对	0	1	0	1	1.0
派兵	1	0	0	1	1.0
活着	0	1	0	1	1.0
活生生	0	1	0	1	1.0
活生	0	1	0	1	1.0
活现	1	0	0	1	1.0
活性	1	0	0	1	1.0
活宝	1	0	0	1	1.0
活力	0	1	0	1	1.0
活人	0	1	0	1	1.0
洪流	0	1	0	1	1.0
洪水	0	1	0	1	1.0
津市	0	1	0	1	1.0
洞	0	1	0	1	1.0
洛杉矶	1	0	0	1	1.0
洛夫	0	0	1	1	1.0
洗面奶	1	0	0	1	1.0
洗面	1	0	0	1	1.0
洗碗工	0	0	1	1	1.0
洗碗	0	0	1	1	1.0
洗牌	1	0	0	1	1.0
洗洗	0	1	0	1	1.0
洗头	1	0	0	1	1.0
洗地	1	0	0	1	1.0
洗劫	0	0	1	1	1.0
洋溢着	1	0	0	1	1.0
洋溢	1	0	0	1	1.0
洋教	1	0	0	1	1.0
洁癖	0	1	0	1	1.0
洁净	0	1	0	1	1.0
泼水节	0	1	0	1	1.0
泼水	0	1	0	1	1.0
泱泱大国	1	0	0	1	1.0
泱泱	1	0	0	1	1.0
泰安	0	0	1	1	1.0
泪花	1	0	0	1	1.0
泪	0	0	1	1	1.0
注明	0	0	1	1	1.0
注意力	1	0	0	1	1.0
注定	0	0	1	1	1.0
注册	0	0	1	1	1.0
注入	0	1	0	1	1.0
注	1	0	0	1	1.0
波澜	0	0	1	1	1.0
波斯	1	0	0	1	1.0
波及	0	0	1	1	1.0
泛黄	0	1	0	1	1.0
泛	1	0	0	1	1.0
法理学	0	0	1	1	1.0
法理	0	0	1	1	1.0
法政	0	1	0	1	1.0
法师	0	0	1	1	1.0
法定	0	1	0	1	1.0
法学院	0	0	1	1	1.0
法学	0	0	1	1	1.0
法制宣传	0	0	1	1	1.0
泌乳素	1	0	0	1	1.0
泌乳	1	0	0	1	1.0
泉	1	0	0	1	1.0
沿袭	1	0	0	1	1.0
沿海地区	0	0	1	1	1.0
沿海	0	0	1	1	1.0
沿岸	0	0	1	1	1.0
沾	0	0	1	1	1.0
沽名钓誉	1	0	0	1	1.0
沽名	1	0	0	1	1.0
治理环境	0	1	0	1	1.0
治理整顿	1	0	0	1	1.0
治愈	1	0	0	1	1.0
治安员	0	1	0	1	1.0
治安	0	1	0	1	1.0
治学	0	0	1	1	1.0
油腻	0	0	1	1	1.0
油价格	0	1	0	1	1.0
河源	0	0	1	1	1.0
河南省委	1	0	0	1	1.0
河南省	1	0	0	1	1.0
河北省	1	0	0	1	1.0
沮丧	1	0	0	1	1.0
沫	0	1	0	1	1.0
沪	0	0	1	1	1.0
沧海	0	0	1	1	1.0
沦落	0	1	0	1	1.0
沦丧	0	1	0	1	1.0
没钱买	1	0	0	1	1.0
没过多久	0	0	1	1	1.0
没过	0	0	1	1	1.0
没谱	0	1	0	1	1.0
没脸没皮	1	0	0	1	1.0
没脸	1	0	0	1	1.0
没脑子	0	1	0	1	1.0
没给	0	1	0	1	1.0
没空	0	1	0	1	1.0
没理由	0	0	1	1	1.0
没戏	1	0	0	1	1.0
没得	0	0	1	1	1.0
没变	0	1	0	1	1.0
没去	1	0	0	1	1.0
没动静	0	1	0	1	1.0
没动	0	1	0	1	1.0
没到	0	1	0	1	1.0
没出息	1	0	0	1	1.0
没出	1	0	0	1	1.0
没入	0	1	0	1	1.0
没人管	1	0	0	1	1.0
没事儿	0	0	1	1	1.0
没事人	0	0	1	1	1.0
沛	1	0	0	1	1.0
沙皇	0	1	0	1	1.0
沙滩	0	1	0	1	1.0
沙坪坝区	0	0	1	1	1.0
沙坪坝	0	0	1	1	1.0
沙坪	0	0	1	1	1.0
沙俄	0	1	0	1	1.0
沙井	0	0	1	1	1.0
沉浸	1	0	0	1	1.0
沉不住气	1	0	0	1	1.0
沆	0	1	0	1	1.0
沃斯托	0	1	0	1	1.0
沃	1	0	0	1	1.0
汽车业	1	0	0	1	1.0
汽笛	0	0	1	1	1.0
汹汹	0	0	1	1	1.0
汤	0	1	0	1	1.0
污蔑	0	1	0	1	1.0
污物	1	0	0	1	1.0
污垢	1	0	0	1	1.0
污吏	0	1	0	1	1.0
污	0	1	0	1	1.0
江西省	0	0	1	1	1.0
江湖	0	1	0	1	1.0
江宁	1	0	0	1	1.0
江城	0	1	0	1	1.0
江云	0	1	0	1	1.0
江东	0	1	0	1	1.0
汉语	0	0	1	1	1.0
汉字	1	0	0	1	1.0
汉人	1	0	0	1	1.0
汇率	1	0	0	1	1.0
汇报	0	1	0	1	1.0
汇	1	0	0	1	1.0
求知	0	1	0	1	1.0
求生存	0	1	0	1	1.0
求生	0	1	0	1	1.0
求子	1	0	0	1	1.0
永恒	1	0	0	1	1.0
永州	1	0	0	1	1.0
永和镇	0	1	0	1	1.0
永和	0	1	0	1	1.0
永元	1	0	0	1	1.0
水集	0	1	0	1	1.0
水里	0	1	0	1	1.0
水路	0	0	1	1	1.0
水资源	0	1	0	1	1.0
水花	1	0	0	1	1.0
水电	1	0	0	1	1.0
水瓶	1	0	0	1	1.0
水火不容	0	1	0	1	1.0
水火	0	1	0	1	1.0
水漂	0	1	0	1	1.0
水污染	0	1	0	1	1.0
水头	1	0	0	1	1.0
水可载舟	0	1	0	1	1.0
水准	0	0	1	1	1.0
水中毒	1	0	0	1	1.0
水中	1	0	0	1	1.0
氧化碳	0	1	0	1	1.0
氧化氮	0	1	0	1	1.0
气魄	1	0	0	1	1.0
气象部门	0	1	0	1	1.0
气象台	0	1	0	1	1.0
气愤	0	1	0	1	1.0
气宇	0	0	1	1	1.0
气候	0	1	0	1	1.0
民阵	0	1	0	1	1.0
民选总统	1	0	0	1	1.0
民选	1	0	0	1	1.0
民族宗教	1	0	0	1	1.0
民族主义	1	0	0	1	1.0
民政	0	1	0	1	1.0
民愤	0	1	0	1	1.0
民心	0	1	0	1	1.0
民主自由	1	0	0	1	1.0
民主联盟	0	0	1	1	1.0
氏	0	1	0	1	1.0
毫安	1	0	0	1	1.0
毫发	1	0	0	1	1.0
毡帽	0	1	0	1	1.0
毛病	0	1	0	1	1.0
毛泽东	0	0	1	1	1.0
毛估估	0	1	0	1	1.0
毛估	0	1	0	1	1.0
比重	0	0	1	1	1.0
比照	0	1	0	1	1.0
比拟	1	0	0	1	1.0
比得	1	0	0	1	1.0
比国	0	0	1	1	1.0
毓秀	1	0	0	1	1.0
毒素	0	0	1	1	1.0
毒	1	0	0	1	1.0
每隔	1	0	0	1	1.0
每每	0	1	0	1	1.0
每晚	0	1	0	1	1.0
每户	0	1	0	1	1.0
每家每户	0	1	0	1	1.0
每天晚上	1	0	0	1	1.0
每人	0	1	0	1	1.0
母鸡	1	0	0	1	1.0
母狗	1	0	0	1	1.0
母爱	0	0	1	1	1.0
母子	1	0	0	1	1.0
母婴	1	0	0	1	1.0
母女	0	1	0	1	1.0
母	0	1	0	1	1.0
毁约	1	0	0	1	1.0
毁灭	1	0	0	1	1.0
毁坏	0	0	1	1	1.0
残疾人	1	0	0	1	1.0
残疾	1	0	0	1	1.0
残留	1	0	0	1	1.0
残屑	0	0	1	1	1.0
残余	1	0	0	1	1.0
死难	0	1	0	1	1.0
死角	0	1	0	1	1.0
死死的	1	0	0	1	1.0
死死	1	0	0	1	1.0
死棋	0	1	0	1	1.0
死掉	1	0	0	1	1.0
死战	0	1	0	1	1.0
死忠	1	0	0	1	1.0
死心	0	0	1	1	1.0
死伤	0	1	0	1	1.0
死于	1	0	0	1	1.0
死不了	1	0	0	1	1.0
武汉市	1	0	0	1	1.0
武术	1	0	0	1	1.0
武断	0	1	0	1	1.0
武安	1	0	0	1	1.0
武器库	1	0	0	1	1.0
武力	1	0	0	1	1.0
步棋	1	0	0	1	1.0
此项	0	1	0	1	1.0
此种	0	0	1	1	1.0
此前	0	0	1	1	1.0
此人	1	0	0	1	1.0
此一时	0	1	0	1	1.0
正道	0	1	0	1	1.0
正气	0	1	0	1	1.0
正月初五	0	1	0	1	1.0
正当权益	0	1	0	1	1.0
正当性	0	0	1	1	1.0
正式版	0	0	1	1	1.0
正巧	1	0	0	1	1.0
正宗	0	0	1	1	1.0
正如	1	0	0	1	1.0
正太	1	0	0	1	1.0
正合适	1	0	0	1	1.0
正合	1	0	0	1	1.0
正南方	1	0	0	1	1.0
正南	1	0	0	1	1.0
正义性	0	1	0	1	1.0
止咳药	0	1	0	1	1.0
止咳	0	1	0	1	1.0
歌手	1	0	0	1	1.0
歌儿	1	0	0	1	1.0
歌	1	0	0	1	1.0
歇业	0	1	0	1	1.0
歇	0	1	0	1	1.0
款式	1	0	0	1	1.0
欲	1	0	0	1	1.0
欧洲央行	0	0	1	1	1.0
欣闻	0	1	0	1	1.0
欣赏	0	0	1	1	1.0
欣慰	1	0	0	1	1.0
欣	0	0	1	1	1.0
欢聚	1	0	0	1	1.0
欢愉	0	1	0	1	1.0
欢快	1	0	0	1	1.0
欢天喜地	1	0	0	1	1.0
欢喜	0	0	1	1	1.0
欢乐祥和	0	1	0	1	1.0
欢	1	0	0	1	1.0
次次	0	0	1	1	1.0
次于	1	0	0	1	1.0
次世代	0	1	0	1	1.0
欠帐	0	0	1	1	1.0
檀	1	0	0	1	1.0
橙色	0	1	0	1	1.0
橙子	0	1	0	1	1.0
橘子	1	0	0	1	1.0
横行	0	0	1	1	1.0
横空出世	0	1	0	1	1.0
横空	0	1	0	1	1.0
模糊	1	0	0	1	1.0
模样	1	0	0	1	1.0
槟榔	0	1	0	1	1.0
榨	0	1	0	1	1.0
榆中	0	1	0	1	1.0
楼道	0	1	0	1	1.0
楼市	0	1	0	1	1.0
楼上	1	0	0	1	1.0
楠	0	0	1	1	1.0
植物	0	1	0	1	1.0
植树	0	1	0	1	1.0
椅	0	0	1	1	1.0
棱角	1	0	0	1	1.0
棋子	0	0	1	1	1.0
棋	0	1	0	1	1.0
检讨	0	1	0	1	1.0
检	0	0	1	1	1.0
梦醒	0	0	1	1	1.0
梦乡	0	1	0	1	1.0
梅县	1	0	0	1	1.0
桥下	0	0	1	1	1.0
桥	1	0	0	1	1.0
案例	0	0	1	1	1.0
案件	0	0	1	1	1.0
桂圆	0	0	1	1	1.0
格外	1	0	0	1	1.0
根结	0	0	1	1	1.0
根深蒂固	1	0	0	1	1.0
根治	1	0	0	1	1.0
根本性	0	1	0	1	1.0
根本就是	0	1	0	1	1.0
根本原因	0	1	0	1	1.0
根性	0	1	0	1	1.0
根子	0	0	1	1	1.0
根	0	1	0	1	1.0
核武	1	0	0	1	1.0
核打击	0	0	1	1	1.0
核心内容	1	0	0	1	1.0
核实	0	0	1	1	1.0
核大国	1	0	0	1	1.0
校方	0	1	0	1	1.0
校	0	0	1	1	1.0
栗鼠	1	0	0	1	1.0
栗子	1	0	0	1	1.0
树立	0	1	0	1	1.0
树欲静而风不止	0	0	1	1	1.0
树欲静而	0	0	1	1	1.0
树	1	0	0	1	1.0
栏杆	0	0	1	1	1.0
栋	0	1	0	1	1.0
标题	0	0	1	1	1.0
标语	0	1	0	1	1.0
标称	0	0	1	1	1.0
标本兼治	1	0	0	1	1.0
标本	1	0	0	1	1.0
标准规定	0	1	0	1	1.0
标准规	0	1	0	1	1.0
标准版	1	0	0	1	1.0
标价	1	0	0	1	1.0
柬埔寨	1	0	0	1	1.0
查查	0	0	1	1	1.0
查找	0	0	1	1	1.0
查封	0	1	0	1	1.0
查完	0	0	1	1	1.0
查出来	1	0	0	1	1.0
柜子	1	0	0	1	1.0
柜	0	0	1	1	1.0
染指	0	0	1	1	1.0
染	0	1	0	1	1.0
柒	0	1	0	1	1.0
某物	1	0	0	1	1.0
某国	0	1	0	1	1.0
某个	0	0	1	1	1.0
柏	1	0	0	1	1.0
架桥	1	0	0	1	1.0
枫桥	1	0	0	1	1.0
枫	0	0	1	1	1.0
枣	0	1	0	1	1.0
果断	1	0	0	1	1.0
果实	1	0	0	1	1.0
林木	1	0	0	1	1.0
林斯克	0	0	1	1	1.0
林区	0	1	0	1	1.0
极致	0	0	1	1	1.0
极度	0	1	0	1	1.0
极差	1	0	0	1	1.0
极左	0	1	0	1	1.0
极容易	0	1	0	1	1.0
极好	1	0	0	1	1.0
极大	1	0	0	1	1.0
极右	0	1	0	1	1.0
板车	0	0	1	1	1.0
板砖	0	1	0	1	1.0
板子	0	1	0	1	1.0
板儿	1	0	0	1	1.0
板	1	0	0	1	1.0
松树	1	0	0	1	1.0
松松	0	0	1	1	1.0
松弛	1	0	0	1	1.0
杰作	1	0	0	1	1.0
杰伦	0	0	1	1	1.0
杰	1	0	0	1	1.0
杯赛	0	1	0	1	1.0
杯杯	1	0	0	1	1.0
杭州市	0	1	0	1	1.0
杭	1	0	0	1	1.0
来讲	0	1	0	1	1.0
来用	0	1	0	1	1.0
来源不明	0	0	1	1	1.0
来得及	0	0	1	1	1.0
来得	0	0	1	1	1.0
来势汹汹	0	0	1	1	1.0
来势	0	0	1	1	1.0
条款	0	1	0	1	1.0
杜绝	0	0	1	1	1.0
杜	0	0	1	1	1.0
村庄	0	1	0	1	1.0
村干部	0	1	0	1	1.0
杏仁	1	0	0	1	1.0
李老师	0	1	0	1	1.0
李明启	0	1	0	1	1.0
李宇春	1	0	0	1	1.0
李女士	1	0	0	1	1.0
杆子	1	0	0	1	1.0
权贵	0	1	0	1	1.0
权益部	0	0	1	1	1.0
权宜之计	0	1	0	1	1.0
权宜	0	1	0	1	1.0
权威部门	0	0	1	1	1.0
权威	0	0	1	1	1.0
杂鱼	1	0	0	1	1.0
杂谈	0	0	1	1	1.0
杀鸡	1	0	0	1	1.0
杀绝	0	1	0	1	1.0
杀猪	1	0	0	1	1.0
杀手	1	0	0	1	1.0
杀戮	0	1	0	1	1.0
杀害	1	0	0	1	1.0
杀光	0	1	0	1	1.0
杀伤性	0	1	0	1	1.0
杀伤力	1	0	0	1	1.0
机遇	1	0	0	1	1.0
机密	0	1	0	1	1.0
机壳	0	1	0	1	1.0
机场	0	0	1	1	1.0
机器人	0	1	0	1	1.0
机制	0	1	0	1	1.0
朵颐	1	0	0	1	1.0
朵	1	0	0	1	1.0
朱	0	0	1	1	1.0
本质区别	0	1	0	1	1.0
本性	0	1	0	1	1.0
本帖	0	0	1	1	1.0
本市	0	1	0	1	1.0
本地	1	0	0	1	1.0
本命年	1	0	0	1	1.0
本命	1	0	0	1	1.0
本原	0	1	0	1	1.0
本价	1	0	0	1	1.0
本书	0	1	0	1	1.0
本主	0	0	1	1	1.0
末路	0	1	0	1	1.0
未雨绸缪	0	0	1	1	1.0
未闻	0	1	0	1	1.0
未能	0	1	0	1	1.0
未然	1	0	0	1	1.0
未有	1	0	0	1	1.0
未战	1	0	0	1	1.0
未尝	1	0	0	1	1.0
未婚	0	1	0	1	1.0
未卜	0	1	0	1	1.0
未动	0	1	0	1	1.0
未免	0	1	0	1	1.0
木质	1	0	0	1	1.0
木材	0	1	0	1	1.0
木偶	1	0	0	1	1.0
木	0	1	0	1	1.0
期约	0	0	1	1	1.0
期末考试	0	0	1	1	1.0
期末考	0	0	1	1	1.0
期末	0	0	1	1	1.0
期内	0	1	0	1	1.0
期	1	0	0	1	1.0
朝日	0	0	1	1	1.0
望海	0	0	1	1	1.0
望	0	0	1	1	1.0
服役	0	1	0	1	1.0
服务社	0	1	0	1	1.0
服务水平	0	0	1	1	1.0
服务中心	0	1	0	1	1.0
服务业	0	1	0	1	1.0
服	0	1	0	1	1.0
有责	0	1	0	1	1.0
有色	1	0	0	1	1.0
有百害而无一利	0	1	0	1	1.0
有理有节	1	0	0	1	1.0
有理	1	0	0	1	1.0
有机	1	0	0	1	1.0
有望	0	0	1	1	1.0
有方	1	0	0	1	1.0
有意无意	0	0	1	1	1.0
有意思	0	1	0	1	1.0
有心	1	0	0	1	1.0
有得卖	1	0	0	1	1.0
有待	0	1	0	1	1.0
有山有水	0	0	1	1	1.0
有声有色	1	0	0	1	1.0
有声	1	0	0	1	1.0
有史以来	1	0	0	1	1.0
有劲	0	1	0	1	1.0
有利有弊	1	0	0	1	1.0
有余	0	0	1	1	1.0
有了钱	0	0	1	1	1.0
月黑风高	1	0	0	1	1.0
月租金	1	0	0	1	1.0
月租	1	0	0	1	1.0
月亮	1	0	0	1	1.0
最高点	1	0	0	1	1.0
最长	1	0	0	1	1.0
最起码	1	0	0	1	1.0
最贵	1	0	0	1	1.0
最让人	1	0	0	1	1.0
最最	0	1	0	1	1.0
最新进展	0	0	1	1	1.0
最新消息	0	0	1	1	1.0
最快	1	0	0	1	1.0
最差	0	1	0	1	1.0
最少	0	0	1	1	1.0
最小	0	0	1	1	1.0
最初	1	0	0	1	1.0
最出色	1	0	0	1	1.0
最全	1	0	0	1	1.0
最低气温	0	1	0	1	1.0
最亮	1	0	0	1	1.0
替换	1	0	0	1	1.0
曼斯	0	0	1	1	1.0
曼德拉	0	1	0	1	1.0
更累	1	0	0	1	1.0
更有意义	0	1	0	1	1.0
更改	0	0	1	1	1.0
更换	0	0	1	1	1.0
更为严重	0	1	0	1	1.0
曲解	0	1	0	1	1.0
曲折	0	0	1	1	1.0
暴露出	0	1	0	1	1.0
暴行	1	0	0	1	1.0
暴增	0	1	0	1	1.0
暴君	0	1	0	1	1.0
暴发户	0	1	0	1	1.0
暴发	0	1	0	1	1.0
暴利	0	1	0	1	1.0
暗访	0	0	1	1	1.0
暗杀	0	0	1	1	1.0
暗指	1	0	0	1	1.0
暖色调	1	0	0	1	1.0
暖色	1	0	0	1	1.0
暖意	1	0	0	1	1.0
暂扣	0	0	1	1	1.0
暂	1	0	0	1	1.0
智能机	0	1	0	1	1.0
智者	0	1	0	1	1.0
晶片	1	0	0	1	1.0
晴天	0	1	0	1	1.0
景象	0	1	0	1	1.0
景观	1	0	0	1	1.0
景区	1	0	0	1	1.0
景况	0	1	0	1	1.0
景	0	1	0	1	1.0
普通群众	0	1	0	1	1.0
普通人	0	1	0	1	1.0
普查	1	0	0	1	1.0
普度众生	1	0	0	1	1.0
普度	1	0	0	1	1.0
普天同庆	1	0	0	1	1.0
普天同	1	0	0	1	1.0
普天	1	0	0	1	1.0
晚饭	0	0	1	1	1.0
晚点	1	0	0	1	1.0
晚期	1	0	0	1	1.0
晓得	0	1	0	1	1.0
显著	1	0	0	1	1.0
显而易见	0	1	0	1	1.0
显而	0	1	0	1	1.0
显现	0	0	1	1	1.0
显出	0	1	0	1	1.0
昼夜	1	0	0	1	1.0
昼	1	0	0	1	1.0
是非题	0	0	1	1	1.0
是非	0	0	1	1	1.0
昭雪	0	1	0	1	1.0
昭告	0	0	1	1	1.0
昨天下午	0	1	0	1	1.0
昨夜	0	1	0	1	1.0
昨	0	1	0	1	1.0
春笋	0	0	1	1	1.0
映	0	0	1	1	1.0
星空	0	1	0	1	1.0
星期天	0	1	0	1	1.0
星星之火	0	1	0	1	1.0
星子	1	0	0	1	1.0
昕	1	0	0	1	1.0
昔日	0	1	0	1	1.0
易见	0	1	0	1	1.0
易经	1	0	0	1	1.0
易用性	1	0	0	1	1.0
易用	1	0	0	1	1.0
昏睡	1	0	0	1	1.0
明面儿	1	0	0	1	1.0
明面	1	0	0	1	1.0
明确规定	0	0	1	1	1.0
明码标价	1	0	0	1	1.0
明码	1	0	0	1	1.0
明知	0	1	0	1	1.0
明目张胆	1	0	0	1	1.0
明目	1	0	0	1	1.0
明白事理	1	0	0	1	1.0
明珠	1	0	0	1	1.0
明火	0	1	0	1	1.0
明朗化	0	1	0	1	1.0
明朗	0	1	0	1	1.0
明月	1	0	0	1	1.0
明显好转	1	0	0	1	1.0
明显增加	0	0	1	1	1.0
昌平	1	0	0	1	1.0
昆明	1	0	0	1	1.0
昆山	1	0	0	1	1.0
旺	1	0	0	1	1.0
时隔	0	0	1	1	1.0
时长	0	1	0	1	1.0
时装周	0	1	0	1	1.0
时装	0	1	0	1	1.0
时段	0	1	0	1	1.0
时时	1	0	0	1	1.0
时报	0	1	0	1	1.0
时差	1	0	0	1	1.0
时局	0	0	1	1	1.0
时刻	1	0	0	1	1.0
时会	0	1	0	1	1.0
时代性	0	1	0	1	1.0
时事	1	0	0	1	1.0
时不时	0	1	0	1	1.0
旱冰鞋	0	0	1	1	1.0
旱冰	0	0	1	1	1.0
早饭	1	0	0	1	1.0
早读	0	1	0	1	1.0
早知	0	0	1	1	1.0
早生贵子	0	0	1	1	1.0
早生	0	0	1	1	1.0
早班车	0	0	1	1	1.0
早班	0	0	1	1	1.0
早期	1	0	0	1	1.0
早安	0	1	0	1	1.0
早前	1	0	0	1	1.0
旧岁	0	1	0	1	1.0
旧交	0	1	0	1	1.0
日益严重	0	1	0	1	1.0
日益	0	1	0	1	1.0
日来	1	0	0	1	1.0
日志	0	0	1	1	1.0
日后	0	1	0	1	1.0
日内瓦	0	1	0	1	1.0
既然如此	1	0	0	1	1.0
既是	0	1	0	1	1.0
既成事实	1	0	0	1	1.0
既得利益者	0	0	1	1	1.0
既得利益	0	0	1	1	1.0
既得	0	0	1	1	1.0
无非	0	1	0	1	1.0
无谓	0	1	0	1	1.0
无误	0	1	0	1	1.0
无视	0	1	0	1	1.0
无能为力	0	1	0	1	1.0
无耻	0	1	0	1	1.0
无缝	0	1	0	1	1.0
无端	0	1	0	1	1.0
无码	0	0	1	1	1.0
无法比拟	1	0	0	1	1.0
无法弥补	1	0	0	1	1.0
无比	1	0	0	1	1.0
无果	0	1	0	1	1.0
无条件	0	0	1	1	1.0
无望	0	1	0	1	1.0
无数次	0	1	0	1	1.0
无感	0	1	0	1	1.0
无忧	1	0	0	1	1.0
无异	0	1	0	1	1.0
无度	0	0	1	1	1.0
无害	0	0	1	1	1.0
无头	1	0	0	1	1.0
无处	0	0	1	1	1.0
无声	1	0	0	1	1.0
无名	0	1	0	1	1.0
无可争辩	1	0	0	1	1.0
无动于衷	0	1	0	1	1.0
无关痛痒	1	0	0	1	1.0
无休无止	0	0	1	1	1.0
旗舰机	0	1	0	1	1.0
旗帜	0	0	1	1	1.0
旗子	0	1	0	1	1.0
族人	0	1	0	1	1.0
旅舍	0	1	0	1	1.0
旁敲侧击	0	0	1	1	1.0
旁	0	1	0	1	1.0
施行	1	0	0	1	1.0
方言	0	0	1	1	1.0
方方	1	0	0	1	1.0
方圆	1	0	0	1	1.0
方向盘	0	0	1	1	1.0
方便快捷	0	1	0	1	1.0
新鲜血液	0	1	0	1	1.0
新鲜感	0	1	0	1	1.0
新马泰	1	0	0	1	1.0
新风尚	0	0	1	1	1.0
新颖	1	0	0	1	1.0
新闻网	1	0	0	1	1.0
新闻社	0	1	0	1	1.0
新闻媒体	0	1	0	1	1.0
新闻处	0	1	0	1	1.0
新进展	0	0	1	1	1.0
新车	0	0	1	1	1.0
新路	1	0	0	1	1.0
新西兰	0	1	0	1	1.0
新能源	0	1	0	1	1.0
新疆地区	0	1	0	1	1.0
新版	0	0	1	1	1.0
新潮流	0	0	1	1	1.0
新民	0	0	1	1	1.0
新款手机	1	0	0	1	1.0
新格局	1	0	0	1	1.0
新春快乐	0	1	0	1	1.0
新旧交替	0	1	0	1	1.0
新旧	0	1	0	1	1.0
新思维	1	0	0	1	1.0
新安	1	0	0	1	1.0
新学期	0	0	1	1	1.0
新学	0	0	1	1	1.0
新增	1	0	0	1	1.0
新华网	1	0	0	1	1.0
新华	1	0	0	1	1.0
新兴	0	0	1	1	1.0
新亮点	1	0	0	1	1.0
新乡	1	0	0	1	1.0
新举措	1	0	0	1	1.0
新东	1	0	0	1	1.0
新一代	0	1	0	1	1.0
斯托克	0	1	0	1	1.0
斯托	0	1	0	1	1.0
斯大林	0	1	0	1	1.0
斯塔	1	0	0	1	1.0
斯坦福	0	0	1	1	1.0
断章取义	1	0	0	1	1.0
断层	0	1	0	1	1.0
断定	1	0	0	1	1.0
断	1	0	0	1	1.0
斩	0	0	1	1	1.0
斗牛	0	1	0	1	1.0
斑马线	0	0	1	1	1.0
斑马	0	0	1	1	1.0
文艺节目	1	0	0	1	1.0
文艺活动	0	1	0	1	1.0
文稿	1	0	0	1	1.0
文明办	0	1	0	1	1.0
文帝	1	0	0	1	1.0
文学刊物	1	0	0	1	1.0
文学	1	0	0	1	1.0
文字版	1	0	0	1	1.0
文化遗产	1	0	0	1	1.0
文化版	1	0	0	1	1.0
文化氛围	1	0	0	1	1.0
文化差异	1	0	0	1	1.0
文化圈	1	0	0	1	1.0
文体	1	0	0	1	1.0
整顿	1	0	0	1	1.0
整车	0	0	1	1	1.0
整版	1	0	0	1	1.0
整洁	0	1	0	1	1.0
整条	0	0	1	1	1.0
整天	0	0	1	1	1.0
整备	0	0	1	1	1.0
整出	0	1	0	1	1.0
整一个	1	0	0	1	1.0
整一	1	0	0	1	1.0
敲锣打鼓	0	0	1	1	1.0
敲锣	0	0	1	1	1.0
敲诈勒索	1	0	0	1	1.0
敲诈	1	0	0	1	1.0
数码产品	0	0	1	1	1.0
数码	0	0	1	1	1.0
数着	0	1	0	1	1.0
数次	0	1	0	1	1.0
数字	0	1	0	1	1.0
数千万	0	0	1	1	1.0
数千	0	0	1	1	1.0
数值	0	1	0	1	1.0
数万	1	0	0	1	1.0
敬老	0	1	0	1	1.0
敬畏	0	1	0	1	1.0
敬业	0	1	0	1	1.0
敦促	0	0	1	1	1.0
散步	1	0	0	1	1.0
散伙	0	1	0	1	1.0
敢死	0	1	0	1	1.0
敢当	0	0	1	1	1.0
敢作敢当	0	0	1	1	1.0
敢作	0	0	1	1	1.0
敢不敢	0	1	0	1	1.0
教育部	0	1	0	1	1.0
教育法	0	1	0	1	1.0
教育局	1	0	0	1	1.0
教科书	0	1	0	1	1.0
教科	0	1	0	1	1.0
教材	0	1	0	1	1.0
教徒	0	1	0	1	1.0
教室	0	1	0	1	1.0
教子	0	1	0	1	1.0
教士	0	0	1	1	1.0
教务	0	1	0	1	1.0
教体局	0	0	1	1	1.0
教会	1	0	0	1	1.0
教书育人	0	0	1	1	1.0
教书	0	0	1	1	1.0
救活	0	1	0	1	1.0
救星	1	0	0	1	1.0
救人	0	1	0	1	1.0
敏感点	0	1	0	1	1.0
敏感区域	0	1	0	1	1.0
敏感区	0	1	0	1	1.0
敏	1	0	0	1	1.0
敌国	0	1	0	1	1.0
效忠	0	1	0	1	1.0
故土	1	0	0	1	1.0
故作	1	0	0	1	1.0
故乡	1	0	0	1	1.0
政要	0	0	1	1	1.0
政者	0	1	0	1	1.0
政治觉悟	0	1	0	1	1.0
政治局势	1	0	0	1	1.0
政治局	1	0	0	1	1.0
政治学	0	0	1	1	1.0
政教	1	0	0	1	1.0
政府部门	0	1	0	1	1.0
政协委员	0	1	0	1	1.0
政协	0	1	0	1	1.0
政党	1	0	0	1	1.0
政令	0	1	0	1	1.0
放进	0	1	0	1	1.0
放过	1	0	0	1	1.0
放话	1	0	0	1	1.0
放行	0	0	1	1	1.0
放纵	1	0	0	1	1.0
放眼	0	1	0	1	1.0
放生	0	1	0	1	1.0
放爆竹	0	1	0	1	1.0
放得	0	0	1	1	1.0
放归	1	0	0	1	1.0
放好	1	0	0	1	1.0
放在眼里	1	0	0	1	1.0
放上去	1	0	0	1	1.0
放上	1	0	0	1	1.0
攻打	0	0	1	1	1.0
攻城略地	1	0	0	1	1.0
攻城	1	0	0	1	1.0
攻	1	0	0	1	1.0
改装车	1	0	0	1	1.0
改行	0	1	0	1	1.0
改良	1	0	0	1	1.0
改掉	1	0	0	1	1.0
改不了	0	0	1	1	1.0
收钱	0	1	0	1	1.0
收货	1	0	0	1	1.0
收腹	1	0	0	1	1.0
收回	0	1	0	1	1.0
收件	0	1	0	1	1.0
收买	1	0	0	1	1.0
收不到	0	1	0	1	1.0
支撑	0	0	1	1	1.0
支付	0	0	1	1	1.0
攀登	0	1	0	1	1.0
擦身	1	0	0	1	1.0
擦亮眼睛	0	0	1	1	1.0
擦亮	0	0	1	1	1.0
播放	1	0	0	1	1.0
播扬	0	1	0	1	1.0
撩	1	0	0	1	1.0
撤销	1	0	0	1	1.0
撤离	1	0	0	1	1.0
撤完	0	1	0	1	1.0
撤出	1	0	0	1	1.0
撞击	1	0	0	1	1.0
撕票	1	0	0	1	1.0
撒谎	0	0	1	1	1.0
撒拉	1	0	0	1	1.0
撒	1	0	0	1	1.0
撑住	0	0	1	1	1.0
撇清	1	0	0	1	1.0
撂	0	1	0	1	1.0
摸摸	0	0	1	1	1.0
摸了摸	1	0	0	1	1.0
摩洛哥	0	0	1	1	1.0
摩洛	0	0	1	1	1.0
摩擦	1	0	0	1	1.0
摩尔曼斯克	0	0	1	1	1.0
摘	1	0	0	1	1.0
摔下去	1	0	0	1	1.0
摔下	1	0	0	1	1.0
摊贩	0	1	0	1	1.0
摊前	0	0	1	1	1.0
摇身一变	0	1	0	1	1.0
摇身	0	1	0	1	1.0
摇晃	0	1	0	1	1.0
摇摆	1	0	0	1	1.0
摆设	1	0	0	1	1.0
摆开	1	0	0	1	1.0
摄影师	0	0	1	1	1.0
摄取	0	1	0	1	1.0
摄制	0	0	1	1	1.0
携手	0	1	0	1	1.0
携带方便	1	0	0	1	1.0
搭理	0	1	0	1	1.0
搭客	0	0	1	1	1.0
搞错	0	1	0	1	1.0
搞起	1	0	0	1	1.0
搞平衡	0	1	0	1	1.0
搞定	1	0	0	1	1.0
搞完	0	0	1	1	1.0
搞好	1	0	0	1	1.0
搜狗	0	1	0	1	1.0
搜到	0	1	0	1	1.0
搓麻	0	1	0	1	1.0
搅局	0	0	1	1	1.0
搅和	0	1	0	1	1.0
搁置	1	0	0	1	1.0
揽客	1	0	0	1	1.0
揽	0	1	0	1	1.0
援引	0	1	0	1	1.0
援	0	1	0	1	1.0
揭锅	1	0	0	1	1.0
揭晓	0	0	1	1	1.0
握拳	0	0	1	1	1.0
插队	1	0	0	1	1.0
插手	0	0	1	1	1.0
插	0	1	0	1	1.0
提防	1	0	0	1	1.0
提醒您	0	1	0	1	1.0
提速	1	0	0	1	1.0
提神醒脑	0	1	0	1	1.0
提神	0	1	0	1	1.0
提示	0	0	1	1	1.0
提前准备	1	0	0	1	1.0
提价	0	1	0	1	1.0
描述	1	0	0	1	1.0
描淡写	1	0	0	1	1.0
掷	0	1	0	1	1.0
掩盖	1	0	0	1	1.0
推销员	0	0	1	1	1.0
推销	0	0	1	1	1.0
推进	1	0	0	1	1.0
推车	1	0	0	1	1.0
推移	1	0	0	1	1.0
推波助澜	0	1	0	1	1.0
推卸责任	0	1	0	1	1.0
推卸	0	1	0	1	1.0
推动力	1	0	0	1	1.0
推上来	0	0	1	1	1.0
推上	0	0	1	1	1.0
控制权	0	0	1	1	1.0
接过	1	0	0	1	1.0
接财神	1	0	0	1	1.0
接种	0	1	0	1	1.0
接着	1	0	0	1	1.0
接生	1	0	0	1	1.0
接物	0	1	0	1	1.0
接收	0	0	1	1	1.0
接待	0	1	0	1	1.0
接好	1	0	0	1	1.0
接回来	0	0	1	1	1.0
接回	0	0	1	1	1.0
探讨	0	0	1	1	1.0
探索	0	1	0	1	1.0
掘取	0	1	0	1	1.0
掖	1	0	0	1	1.0
排除	0	0	1	1	1.0
排量	1	0	0	1	1.0
排行榜	1	0	0	1	1.0
排行	1	0	0	1	1.0
排查	1	0	0	1	1.0
排斥	0	1	0	1	1.0
排开	0	0	1	1	1.0
排出	1	0	0	1	1.0
排上	1	0	0	1	1.0
掏钱	0	1	0	1	1.0
掏	0	0	1	1	1.0
掉头	1	0	0	1	1.0
授权	0	0	1	1	1.0
授予	1	0	0	1	1.0
据理力争	0	1	0	1	1.0
据理	0	1	0	1	1.0
据守	0	0	1	1	1.0
据估计	0	0	1	1	1.0
捧	1	0	0	1	1.0
换货	0	1	0	1	1.0
换来	1	0	0	1	1.0
换机	0	0	1	1	1.0
换岗	0	0	1	1	1.0
换句话说	0	1	0	1	1.0
换句话	0	1	0	1	1.0
换句	0	1	0	1	1.0
换取	0	1	0	1	1.0
换位	0	1	0	1	1.0
换代	0	1	0	1	1.0
捡	0	1	0	1	1.0
捞回	0	1	0	1	1.0
捞取	0	1	0	1	1.0
捕杀	0	1	0	1	1.0
捕	0	1	0	1	1.0
捏	1	0	0	1	1.0
捂着	0	1	0	1	1.0
捂住	0	0	1	1	1.0
捂	0	0	1	1	1.0
挽回	0	1	0	1	1.0
挺住	0	1	0	1	1.0
挺不错	1	0	0	1	1.0
振动	1	0	0	1	1.0
挨骂	0	0	1	1	1.0
挨过	0	1	0	1	1.0
挨揍	1	0	0	1	1.0
挨宰	0	0	1	1	1.0
挥舞	0	1	0	1	1.0
挥手	0	0	1	1	1.0
挤死	0	1	0	1	1.0
挣点	0	1	0	1	1.0
挣扎	0	0	1	1	1.0
挣得	0	1	0	1	1.0
挡开	1	0	0	1	1.0
挡不住	1	0	0	1	1.0
挡	0	1	0	1	1.0
挖苦	1	0	0	1	1.0
按键	0	1	0	1	1.0
按说	1	0	0	1	1.0
按理说	0	1	0	1	1.0
按理	0	1	0	1	1.0
按时	1	0	0	1	1.0
按住	0	0	1	1	1.0
指手划脚	1	0	0	1	1.0
指引	0	1	0	1	1.0
指导	1	0	0	1	1.0
指向	0	1	0	1	1.0
挂牌	0	1	0	1	1.0
持久战	0	0	1	1	1.0
持久	0	0	1	1	1.0
持	0	1	0	1	1.0
拿来	0	1	0	1	1.0
拿捏	0	0	1	1	1.0
拿不出	0	1	0	1	1.0
拽	0	1	0	1	1.0
拼杀	0	0	1	1	1.0
拼写	1	0	0	1	1.0
拴	0	0	1	1	1.0
拳头	1	0	0	1	1.0
拱手让出	0	0	1	1	1.0
拱手	0	0	1	1	1.0
拭目以待	0	1	0	1	1.0
拭目	0	1	0	1	1.0
拨款	0	1	0	1	1.0
拨开	1	0	0	1	1.0
拦截	0	0	1	1	1.0
拦	1	0	0	1	1.0
拥抱	0	1	0	1	1.0
拥护者	1	0	0	1	1.0
拜访	0	0	1	1	1.0
拜尔	1	0	0	1	1.0
拜天地	1	0	0	1	1.0
招生	1	0	0	1	1.0
招数	0	1	0	1	1.0
招待	0	1	0	1	1.0
招呼	1	0	0	1	1.0
招人	0	1	0	1	1.0
拙	0	0	1	1	1.0
拖延	0	1	0	1	1.0
拖垮	0	1	0	1	1.0
拖	0	1	0	1	1.0
拔萝卜	1	0	0	1	1.0
拔河	1	0	0	1	1.0
拔	0	1	0	1	1.0
拓展	0	0	1	1	1.0
拒	1	0	0	1	1.0
拐点	0	0	1	1	1.0
拐卖儿童	0	1	0	1	1.0
拍电影	0	1	0	1	1.0
拍拍	0	1	0	1	1.0
拍手称快	0	0	1	1	1.0
拍手叫好	0	1	0	1	1.0
拍卖	0	1	0	1	1.0
拍出	0	1	0	1	1.0
拌	1	0	0	1	1.0
拉面	1	0	0	1	1.0
拉车	0	1	0	1	1.0
拉稀	0	0	1	1	1.0
拉票	1	0	0	1	1.0
拉磨	0	1	0	1	1.0
拉登	1	0	0	1	1.0
拉拉	1	0	0	1	1.0
拉开距离	0	1	0	1	1.0
拉开帷幕	0	1	0	1	1.0
拉屎	1	0	0	1	1.0
拉夫罗夫	1	0	0	1	1.0
拉夫	1	0	0	1	1.0
拉大	0	1	0	1	1.0
拇指	0	1	0	1	1.0
拆迁	0	1	0	1	1.0
担责任	1	0	0	1	1.0
担着	0	1	0	1	1.0
担惊受怕	0	1	0	1	1.0
担惊	0	1	0	1	1.0
担当	1	0	0	1	1.0
担子	0	1	0	1	1.0
抿嘴笑	1	0	0	1	1.0
抿嘴	1	0	0	1	1.0
抽血	0	0	1	1	1.0
抽烟	0	1	0	1	1.0
抽样调查	1	0	0	1	1.0
抽样	1	0	0	1	1.0
抽搐	0	0	1	1	1.0
押	1	0	0	1	1.0
抹黑	1	0	0	1	1.0
抵挡不住	1	0	0	1	1.0
抵挡	1	0	0	1	1.0
抵	1	0	0	1	1.0
抱佛脚	0	1	0	1	1.0
披露	1	0	0	1	1.0
披着	0	1	0	1	1.0
报错	1	0	0	1	1.0
报销	0	1	0	1	1.0
报警	1	0	0	1	1.0
报名	1	0	0	1	1.0
报佳音	1	0	0	1	1.0
护照	0	0	1	1	1.0
护工	0	0	1	1	1.0
护士	1	0	0	1	1.0
护人	0	0	1	1	1.0
抢鲜	0	0	1	1	1.0
抢钱	0	1	0	1	1.0
抢走	0	0	1	1	1.0
抢点	0	0	1	1	1.0
抢戏	1	0	0	1	1.0
抢占市场	0	1	0	1	1.0
抛开	0	1	0	1	1.0
抚顺	0	1	0	1	1.0
折腰	0	0	1	1	1.0
折磨	1	0	0	1	1.0
折扣	1	0	0	1	1.0
折射出	0	1	0	1	1.0
折射	0	1	0	1	1.0
折中	0	1	0	1	1.0
抗衰老	0	0	1	1	1.0
抗拒	0	0	1	1	1.0
抗击	1	0	0	1	1.0
抖	0	1	0	1	1.0
投靠	0	0	1	1	1.0
投递	0	1	0	1	1.0
投奔	0	1	0	1	1.0
投医	1	0	0	1	1.0
投保	0	0	1	1	1.0
抓起	0	0	1	1	1.0
抓紧时间	1	0	0	1	1.0
抓紧	1	0	0	1	1.0
抓狂	0	1	0	1	1.0
抓拍	0	1	0	1	1.0
抓手	0	1	0	1	1.0
抓好	0	0	1	1	1.0
抓住机会	1	0	0	1	1.0
抑或	0	1	0	1	1.0
抉择	0	0	1	1	1.0
抄送	0	0	1	1	1.0
技能	0	0	1	1	1.0
技俩	0	1	0	1	1.0
承继	0	1	0	1	1.0
承受	0	0	1	1	1.0
找起	1	0	0	1	1.0
找死	1	0	0	1	1.0
找出	1	0	0	1	1.0
扼制	1	0	0	1	1.0
批判	1	0	0	1	1.0
扶起来	0	1	0	1	1.0
扶起	0	1	0	1	1.0
扶植	0	1	0	1	1.0
扶助	0	1	0	1	1.0
扶	1	0	0	1	1.0
扰乱	1	0	0	1	1.0
扯	0	1	0	1	1.0
扭扭	0	0	1	1	1.0
扬清厉俗	0	1	0	1	1.0
扬州	0	0	1	1	1.0
扬子晚报	0	0	1	1	1.0
扬子	0	0	1	1	1.0
扬声器	1	0	0	1	1.0
扬声	1	0	0	1	1.0
扫清	0	0	1	1	1.0
扫描	1	0	0	1	1.0
扫墓	1	0	0	1	1.0
扫地	0	0	1	1	1.0
扩建	0	1	0	1	1.0
扩展卡	0	1	0	1	1.0
扩	0	1	0	1	1.0
执行力	1	0	0	1	1.0
执着	1	0	0	1	1.0
执政者	0	1	0	1	1.0
执政	0	1	0	1	1.0
执导	1	0	0	1	1.0
扣分	0	1	0	1	1.0
扞	0	1	0	1	1.0
托克	0	1	0	1	1.0
扔掉	0	1	0	1	1.0
打鼓	0	0	1	1	1.0
打非	0	0	1	1	1.0
打针	1	0	0	1	1.0
打车	0	1	0	1	1.0
打耳光	0	1	0	1	1.0
打破	0	0	1	1	1.0
打水漂	0	1	0	1	1.0
打水	0	1	0	1	1.0
打气	0	1	0	1	1.0
打扰	1	0	0	1	1.0
打扮	0	1	0	1	1.0
打战	0	1	0	1	1.0
打成	0	0	1	1	1.0
打工者	0	1	0	1	1.0
打完	0	1	0	1	1.0
打坏	0	1	0	1	1.0
打圆场	0	0	1	1	1.0
打印	0	0	1	1	1.0
打到	0	1	0	1	1.0
打击报复	1	0	0	1	1.0
打出	0	1	0	1	1.0
打乱	0	0	1	1	1.0
打不着	0	0	1	1	1.0
打不开	0	1	0	1	1.0
打上去	0	1	0	1	1.0
打上	0	1	0	1	1.0
扒	0	1	0	1	1.0
扑街	0	1	0	1	1.0
扑灭	0	0	1	1	1.0
扎起	0	0	1	1	1.0
扎实	1	0	0	1	1.0
才刚	1	0	0	1	1.0
手软	1	0	0	1	1.0
手脚冰凉	0	0	1	1	1.0
手脚	0	0	1	1	1.0
手枪	1	0	0	1	1.0
手机网	0	1	0	1	1.0
手机城	1	0	0	1	1.0
手机卡	0	0	1	1	1.0
手术	1	0	0	1	1.0
手无寸铁	0	1	0	1	1.0
手掌	1	0	0	1	1.0
手指	0	0	1	1	1.0
手套	1	0	0	1	1.0
手写	1	0	0	1	1.0
手下	1	0	0	1	1.0
扇	0	1	0	1	1.0
所说	1	0	0	1	1.0
所致	1	0	0	1	1.0
所能	0	1	0	1	1.0
所有者	0	1	0	1	1.0
所指	1	0	0	1	1.0
所在	1	0	0	1	1.0
所剩	1	0	0	1	1.0
所作所为	0	1	0	1	1.0
所作	0	1	0	1	1.0
所为	0	1	0	1	1.0
房地产	0	0	1	1	1.0
房产	0	1	0	1	1.0
户口本	0	1	0	1	1.0
户口	0	1	0	1	1.0
户	1	0	0	1	1.0
戴绿帽子	1	0	0	1	1.0
戴绿帽	1	0	0	1	1.0
戴眼镜	1	0	0	1	1.0
截止	0	1	0	1	1.0
戚戚焉	1	0	0	1	1.0
戚戚	1	0	0	1	1.0
战队	0	1	0	1	1.0
战略伙伴	1	0	0	1	1.0
战斗力	1	0	0	1	1.0
战报	0	1	0	1	1.0
战役	1	0	0	1	1.0
战争状态	1	0	0	1	1.0
我行我素	1	0	0	1	1.0
我行	1	0	0	1	1.0
我中有你	0	1	0	1	1.0
成都市	0	1	0	1	1.0
成都地区	0	1	0	1	1.0
成败	0	0	1	1	1.0
成语	0	0	1	1	1.0
成群结队	1	0	0	1	1.0
成群	1	0	0	1	1.0
成箱	0	1	0	1	1.0
成灾	0	1	0	1	1.0
成果	1	0	0	1	1.0
成本增加	0	1	0	1	1.0
成本价	1	0	0	1	1.0
成方圆	1	0	0	1	1.0
成方	1	0	0	1	1.0
成就感	1	0	0	1	1.0
成就	1	0	0	1	1.0
成堆	0	0	1	1	1.0
成员国	0	1	0	1	1.0
成功率	1	0	0	1	1.0
成像	1	0	0	1	1.0
成倍	0	1	0	1	1.0
成佛	0	0	1	1	1.0
成事	1	0	0	1	1.0
戏曲	1	0	0	1	1.0
戈尔	1	0	0	1	1.0
戈壁	0	1	0	1	1.0
懒猫	0	1	0	1	1.0
懂得	1	0	0	1	1.0
憋着	0	1	0	1	1.0
憋不住	1	0	0	1	1.0
慰问	1	0	0	1	1.0
慨叹	1	0	0	1	1.0
慎	1	0	0	1	1.0
慈爱	1	0	0	1	1.0
慈溪市	0	1	0	1	1.0
慈溪	0	1	0	1	1.0
慈悲为怀	0	1	0	1	1.0
慈悲	0	1	0	1	1.0
慈	0	1	0	1	1.0
愿望	0	0	1	1	1.0
愧对	0	1	0	1	1.0
愤怒	0	1	0	1	1.0
愤世嫉俗	0	1	0	1	1.0
愤世	0	1	0	1	1.0
愤	0	1	0	1	1.0
愣	0	0	1	1	1.0
感言	0	0	1	1	1.0
感触	1	0	0	1	1.0
感觉良好	1	0	0	1	1.0
感知	1	0	0	1	1.0
感染	1	0	0	1	1.0
感叹	0	0	1	1	1.0
感受一下	1	0	0	1	1.0
感化	0	1	0	1	1.0
感到遗憾	1	0	0	1	1.0
愚见	0	0	1	1	1.0
愚民	1	0	0	1	1.0
愚人节	1	0	0	1	1.0
愚人	1	0	0	1	1.0
意欲	0	0	1	1	1.0
意大利	0	0	1	1	1.0
意向	0	1	0	1	1.0
愈发	0	0	1	1	1.0
愁	1	0	0	1	1.0
惹不起	0	1	0	1	1.0
惹	0	1	0	1	1.0
想说爱	0	1	0	1	1.0
想着	0	1	0	1	1.0
想用	1	0	0	1	1.0
想来想去	0	0	1	1	1.0
想来	0	0	1	1	1.0
想想也是	0	1	0	1	1.0
想念	1	0	0	1	1.0
想必	0	1	0	1	1.0
想得到	1	0	0	1	1.0
想当年	1	0	0	1	1.0
想当初	0	1	0	1	1.0
想开	0	1	0	1	1.0
想出	1	0	0	1	1.0
想住	0	0	1	1	1.0
想不通	0	1	0	1	1.0
想不起来	0	0	1	1	1.0
想不起	0	0	1	1	1.0
惯性	0	1	0	1	1.0
惯例	0	1	0	1	1.0
惩治	0	1	0	1	1.0
惨状	0	1	0	1	1.0
惨淡	0	0	1	1	1.0
惠州	0	1	0	1	1.0
惋惜	1	0	0	1	1.0
惊醒	0	1	0	1	1.0
惊艳	1	0	0	1	1.0
惊叹	0	0	1	1	1.0
惊受	0	1	0	1	1.0
惊人	1	0	0	1	1.0
情谊	0	1	0	1	1.0
情节	1	0	0	1	1.0
情有独钟	0	1	0	1	1.0
情感	1	0	0	1	1.0
情急	1	0	0	1	1.0
情侣	0	0	1	1	1.0
情人节	1	0	0	1	1.0
情人	1	0	0	1	1.0
情不自禁	0	0	1	1	1.0
悲观	0	1	0	1	1.0
悲情	1	0	0	1	1.0
悬赏	0	1	0	1	1.0
悬挂	1	0	0	1	1.0
悬念	0	1	0	1	1.0
悬崖	0	0	1	1	1.0
您们	1	0	0	1	1.0
患者	0	0	1	1	1.0
患有	1	0	0	1	1.0
患	0	1	0	1	1.0
悠着点	0	0	1	1	1.0
悠着	0	0	1	1	1.0
悔恨	1	0	0	1	1.0
悍然	1	0	0	1	1.0
悍	0	1	0	1	1.0
悄无声息	1	0	0	1	1.0
恼人	0	1	0	1	1.0
恶狼	1	0	0	1	1.0
恶果	0	1	0	1	1.0
恶政	0	0	1	1	1.0
恶性循环	0	1	0	1	1.0
恶化趋势	0	1	0	1	1.0
恶劣影响	1	0	0	1	1.0
恶	0	1	0	1	1.0
恰恰	0	1	0	1	1.0
恰似	0	0	1	1	1.0
恭祝	1	0	0	1	1.0
恭	0	0	1	1	1.0
恩平	1	0	0	1	1.0
恢复正常	0	1	0	1	1.0
恢复	0	1	0	1	1.0
恐难	0	1	0	1	1.0
恐怖活动	0	1	0	1	1.0
总量	0	1	0	1	1.0
总计	1	0	0	1	1.0
总而言之	1	0	0	1	1.0
总统令	1	0	0	1	1.0
总目	0	1	0	1	1.0
总的来说	0	1	0	1	1.0
总比	1	0	0	1	1.0
总会	1	0	0	1	1.0
总价	0	0	1	1	1.0
怪物	0	1	0	1	1.0
怪圈	0	1	0	1	1.0
怪事	0	1	0	1	1.0
怨	0	0	1	1	1.0
性感女	0	0	1	1	1.0
性感	0	0	1	1	1.0
性情	0	0	1	1	1.0
性别比	0	0	1	1	1.0
性别歧视	0	1	0	1	1.0
急诊	0	1	0	1	1.0
急剧	0	1	0	1	1.0
急促	0	0	1	1	1.0
思议	1	0	0	1	1.0
思想前卫	0	1	0	1	1.0
怕生	1	0	0	1	1.0
怒火	0	1	0	1	1.0
怎	1	0	0	1	1.0
怂恿	0	0	1	1	1.0
态势	1	0	0	1	1.0
态	0	1	0	1	1.0
怀旧	1	0	0	1	1.0
怀化	0	0	1	1	1.0
忽明忽暗	0	1	0	1	1.0
忽明	0	1	0	1	1.0
快马加鞭	0	1	0	1	1.0
快讯	0	1	0	1	1.0
快点	0	1	0	1	1.0
快板儿	1	0	0	1	1.0
快板	1	0	0	1	1.0
快来	0	0	1	1	1.0
忧民	0	1	0	1	1.0
忧国忧民	0	1	0	1	1.0
忧国	0	1	0	1	1.0
忧	0	0	1	1	1.0
忠言	0	1	0	1	1.0
忙活	0	0	1	1	1.0
志强	0	1	0	1	1.0
志在	1	0	0	1	1.0
忍过来	0	0	1	1	1.0
忍过	0	0	1	1	1.0
忍受	0	1	0	1	1.0
忆起	1	0	0	1	1.0
必竟	1	0	0	1	1.0
必有后福	0	0	1	1	1.0
必定会	1	0	0	1	1.0
心里话	0	1	0	1	1.0
心酸	0	1	0	1	1.0
心脏	0	1	0	1	1.0
心知肚明	1	0	0	1	1.0
心知	1	0	0	1	1.0
心眼	1	0	0	1	1.0
心目	0	1	0	1	1.0
心痛	1	0	0	1	1.0
心痒	1	0	0	1	1.0
心病	0	1	0	1	1.0
心甘情愿	0	1	0	1	1.0
心甘	0	1	0	1	1.0
心理专家	0	0	1	1	1.0
心照不宣	0	1	0	1	1.0
心照	0	1	0	1	1.0
心灵	0	0	1	1	1.0
心比天高	1	0	0	1	1.0
心欢	0	0	1	1	1.0
心机	0	0	1	1	1.0
心慌	0	1	0	1	1.0
心想事成	1	0	0	1	1.0
心态	0	1	0	1	1.0
心底	1	0	0	1	1.0
心寒	0	1	0	1	1.0
心头	1	0	0	1	1.0
心声	0	1	0	1	1.0
心向往之	0	1	0	1	1.0
心向	0	1	0	1	1.0
心内	1	0	0	1	1.0
心不烦	0	1	0	1	1.0
德纳	0	1	0	1	1.0
德拉	0	1	0	1	1.0
微言	0	1	0	1	1.0
微薄	0	1	0	1	1.0
微波炉	0	0	1	1	1.0
微波	0	0	1	1	1.0
微微	0	1	0	1	1.0
循规蹈矩	0	1	0	1	1.0
循环往复	0	1	0	1	1.0
循序渐进	1	0	0	1	1.0
循序	1	0	0	1	1.0
循	0	1	0	1	1.0
得道	1	0	0	1	1.0
得救	0	0	1	1	1.0
得人心	1	0	0	1	1.0
徒步	0	1	0	1	1.0
徒	1	0	0	1	1.0
律动	1	0	0	1	1.0
律	0	0	1	1	1.0
很难说	0	1	0	1	1.0
很远	0	0	1	1	1.0
很苦	0	0	1	1	1.0
很狡猾	1	0	0	1	1.0
很烦	1	0	0	1	1.0
很惨	1	0	0	1	1.0
很小	0	1	0	1	1.0
很多很多	1	0	0	1	1.0
很久没	1	0	0	1	1.0
很久很久	0	1	0	1	1.0
待转	1	0	0	1	1.0
待机	1	0	0	1	1.0
待人接物	0	1	0	1	1.0
待人	0	1	0	1	1.0
待产室	1	0	0	1	1.0
径	1	0	0	1	1.0
征集	1	0	0	1	1.0
征程	1	0	0	1	1.0
征求意见	0	0	1	1	1.0
征求	0	0	1	1	1.0
征地	0	0	1	1	1.0
征兆	0	1	0	1	1.0
征	1	0	0	1	1.0
往复	0	1	0	1	1.0
往回	0	0	1	1	1.0
往上	1	0	0	1	1.0
彼得罗	0	0	1	1	1.0
彼得大帝	0	1	0	1	1.0
彼一时	0	1	0	1	1.0
彻底解决	0	1	0	1	1.0
影音	0	1	0	1	1.0
影版	1	0	0	1	1.0
影片	1	0	0	1	1.0
影子	0	0	1	1	1.0
影像	1	0	0	1	1.0
影	0	0	1	1	1.0
彩花	1	0	0	1	1.0
彩票	0	0	1	1	1.0
彩头	1	0	0	1	1.0
彩	1	0	0	1	1.0
当面	0	1	0	1	1.0
当街	0	1	0	1	1.0
当真	0	0	1	1	1.0
当晚	0	1	0	1	1.0
当家做主	0	1	0	1	1.0
当家	0	1	0	1	1.0
当官	0	1	0	1	1.0
当头	1	0	0	1	1.0
当地人	0	1	0	1	1.0
当兵	0	1	0	1	1.0
当先	1	0	0	1	1.0
当做	0	1	0	1	1.0
当代	0	1	0	1	1.0
当中	0	0	1	1	1.0
当下	0	1	0	1	1.0
归还	1	0	0	1	1.0
归罪	1	0	0	1	1.0
归结到	0	0	1	1	1.0
归结	0	0	1	1	1.0
归根结底	0	0	1	1	1.0
归根	0	0	1	1	1.0
归来	1	0	0	1	1.0
归咎于	0	0	1	1	1.0
归于	0	1	0	1	1.0
归	0	1	0	1	1.0
强迫症	0	1	0	1	1.0
强盛	0	1	0	1	1.0
强烈建议	0	0	1	1	1.0
强烈呼吁	1	0	0	1	1.0
强权	0	0	1	1	1.0
强弩之末	0	1	0	1	1.0
强奸	0	1	0	1	1.0
强劲	0	0	1	1	1.0
强加于人	1	0	0	1	1.0
强加于	1	0	0	1	1.0
强加	1	0	0	1	1.0
强制性	0	1	0	1	1.0
弹药	1	0	0	1	1.0
弹	0	1	0	1	1.0
弱肉强食	0	1	0	1	1.0
弱者	0	1	0	1	1.0
弱小	0	1	0	1	1.0
弱国	0	0	1	1	1.0
弥陀	0	0	1	1	1.0
弥补	1	0	0	1	1.0
张臭嘴	1	0	0	1	1.0
张灯结彩	1	0	0	1	1.0
张家	1	0	0	1	1.0
引述	0	1	0	1	1.0
引爆	0	0	1	1	1.0
引火烧身	1	0	0	1	1.0
引火	1	0	0	1	1.0
引信	1	0	0	1	1.0
引人注意	1	0	0	1	1.0
引人关注	0	0	1	1	1.0
弊大于利	1	0	0	1	1.0
弊	0	1	0	1	1.0
弄完	0	0	1	1	1.0
异议	1	0	0	1	1.0
异性恋	0	0	1	1	1.0
异性	0	0	1	1	1.0
异域	1	0	0	1	1.0
异地	1	0	0	1	1.0
开销	1	0	0	1	1.0
开诊	0	1	0	1	1.0
开药	0	0	1	1	1.0
开箱	0	0	1	1	1.0
开窍	0	0	1	1	1.0
开眼	0	1	0	1	1.0
开春	0	0	1	1	1.0
开明	0	1	0	1	1.0
开支	0	1	0	1	1.0
开打	1	0	0	1	1.0
开店	0	0	1	1	1.0
开封	0	0	1	1	1.0
开导	1	0	0	1	1.0
开学	1	0	0	1	1.0
开售	0	1	0	1	1.0
开口	1	0	0	1	1.0
开发商	0	1	0	1	1.0
建材	0	0	1	1	1.0
建交	0	0	1	1	1.0
延误	0	1	0	1	1.0
延绵	1	0	0	1	1.0
延续性	0	1	0	1	1.0
延庆县	1	0	0	1	1.0
延庆	1	0	0	1	1.0
延安	0	1	0	1	1.0
延后	0	1	0	1	1.0
延	0	1	0	1	1.0
廊坊	0	0	1	1	1.0
康健	1	0	0	1	1.0
座	0	1	0	1	1.0
废除	0	1	0	1	1.0
废话	1	0	0	1	1.0
废寝忘食	0	0	1	1	1.0
庞大	0	1	0	1	1.0
庙	1	0	0	1	1.0
店门口	0	1	0	1	1.0
店门	0	1	0	1	1.0
店铺	0	1	0	1	1.0
店家	0	1	0	1	1.0
店员	1	0	0	1	1.0
店主	0	0	1	1	1.0
底细	1	0	0	1	1.0
底线	0	0	1	1	1.0
底子	0	1	0	1	1.0
底	0	0	1	1	1.0
应酬	0	1	0	1	1.0
应运而生	0	0	1	1	1.0
应运	0	0	1	1	1.0
应景	0	1	0	1	1.0
应付	0	0	1	1	1.0
庐山	1	0	0	1	1.0
序幕	1	0	0	1	1.0
床头	0	0	1	1	1.0
床位	0	1	0	1	1.0
床上	1	0	0	1	1.0
广田	1	0	0	1	1.0
广播网	0	0	1	1	1.0
广大群众	0	1	0	1	1.0
广告	0	1	0	1	1.0
幽默	1	0	0	1	1.0
幽幽	0	1	0	1	1.0
幼	1	0	0	1	1.0
幸运	0	0	1	1	1.0
幸福美满	1	0	0	1	1.0
幸	1	0	0	1	1.0
并行	1	0	0	1	1.0
并未	0	1	0	1	1.0
并不知道	1	0	0	1	1.0
并不比	0	0	1	1	1.0
年青人	0	0	1	1	1.0
年青	0	0	1	1	1.0
年限	0	0	1	1	1.0
年轮	1	0	0	1	1.0
年节	1	0	0	1	1.0
年终奖金	1	0	0	1	1.0
年终奖	1	0	0	1	1.0
年终	1	0	0	1	1.0
年收入	0	1	0	1	1.0
年度	0	1	0	1	1.0
年底	1	0	0	1	1.0
年初三	1	0	0	1	1.0
年份	1	0	0	1	1.0
平米	0	0	1	1	1.0
平等待遇	0	1	0	1	1.0
平淡	1	0	0	1	1.0
平板	0	1	0	1	1.0
平息	1	0	0	1	1.0
平心而论	1	0	0	1	1.0
平心	1	0	0	1	1.0
平安夜	1	0	0	1	1.0
平头	0	0	1	1	1.0
平均气温	0	1	0	1	1.0
平反昭雪	0	1	0	1	1.0
平反	0	1	0	1	1.0
干部职工	0	1	0	1	1.0
干道	1	0	0	1	1.0
干爹	0	1	0	1	1.0
干果	1	0	0	1	1.0
干掉	0	1	0	1	1.0
干干净净	0	1	0	1	1.0
干儿子	0	1	0	1	1.0
幌子	1	0	0	1	1.0
常规	0	1	0	1	1.0
常见	1	0	0	1	1.0
常态	0	0	1	1	1.0
常常	1	0	0	1	1.0
帷幕	0	1	0	1	1.0
帮帮	0	1	0	1	1.0
帮主	0	1	0	1	1.0
席卷	1	0	0	1	1.0
带领	1	0	0	1	1.0
带队	0	0	1	1	1.0
带走	1	0	0	1	1.0
带薪	0	1	0	1	1.0
带头	0	1	0	1	1.0
带回家	1	0	0	1	1.0
带回	1	0	0	1	1.0
带上	1	0	0	1	1.0
帝国时代	0	1	0	1	1.0
帝国大厦	0	0	1	1	1.0
帕尔米	1	0	0	1	1.0
帐	0	1	0	1	1.0
希腊	1	0	0	1	1.0
希特勒	0	1	0	1	1.0
希特	0	1	0	1	1.0
希冀	1	0	0	1	1.0
希	0	0	1	1	1.0
师范生	0	1	0	1	1.0
师范	0	1	0	1	1.0
师出无名	0	1	0	1	1.0
师兄	0	1	0	1	1.0
师傅	0	1	0	1	1.0
帆	1	0	0	1	1.0
帅气	1	0	0	1	1.0
布置	1	0	0	1	1.0
布施	1	0	0	1	1.0
布局	0	0	1	1	1.0
布丁	1	0	0	1	1.0
市面上	0	1	0	1	1.0
市面	0	1	0	1	1.0
市道	0	1	0	1	1.0
市局	0	0	1	1	1.0
市容	0	1	0	1	1.0
市委	1	0	0	1	1.0
市场需求	0	0	1	1	1.0
市场监管	0	1	0	1	1.0
币	0	1	0	1	1.0
巿	0	1	0	1	1.0
巾	1	0	0	1	1.0
巴黎和会	0	1	0	1	1.0
巴蜀	1	0	0	1	1.0
巴甫洛夫	0	0	1	1	1.0
巴甫洛	0	0	1	1	1.0
巴巴	1	0	0	1	1.0
巴基斯坦	0	1	0	1	1.0
巴基斯	0	1	0	1	1.0
巴基	0	1	0	1	1.0
巴	1	0	0	1	1.0
巳	1	0	0	1	1.0
已用	1	0	0	1	1.0
已然	0	0	1	1	1.0
已有近	0	0	1	1	1.0
已久	1	0	0	1	1.0
差劲	1	0	0	1	1.0
巩固	0	1	0	1	1.0
巧合	1	0	0	1	1.0
左邻右舍	1	0	0	1	1.0
左邻	1	0	0	1	1.0
左耳	0	0	1	1	1.0
工资待遇	0	1	0	1	1.0
工作量	0	1	0	1	1.0
工作者	0	1	0	1	1.0
工作人员	0	0	1	1	1.0
工人员	0	0	1	1	1.0
工人党	0	1	0	1	1.0
工业污染	1	0	0	1	1.0
巡防	0	0	1	1	1.0
巡演	1	0	0	1	1.0
巡查	1	0	0	1	1.0
巡	1	0	0	1	1.0
州官放火	1	0	0	1	1.0
州官	1	0	0	1	1.0
州	0	0	1	1	1.0
巅峰	1	0	0	1	1.0
崽	1	0	0	1	1.0
崩溃	0	0	1	1	1.0
崩	1	0	0	1	1.0
崔永元	1	0	0	1	1.0
崇拜	0	1	0	1	1.0
岳	0	1	0	1	1.0
岩	0	0	1	1	1.0
岛国	1	0	0	1	1.0
岂	1	0	0	1	1.0
岁首	1	0	0	1	1.0
岁末	1	0	0	1	1.0
岁月	1	0	0	1	1.0
屹立	1	0	0	1	1.0
山西太原	0	0	1	1	1.0
山西	0	0	1	1	1.0
山药	1	0	0	1	1.0
山芋	1	0	0	1	1.0
山羊	0	0	1	1	1.0
山水	1	0	0	1	1.0
山村	1	0	0	1	1.0
山寺	0	0	1	1	1.0
山姆大叔	1	0	0	1	1.0
山大	1	0	0	1	1.0
山呼	1	0	0	1	1.0
山东省	0	1	0	1	1.0
山下	1	0	0	1	1.0
屯兵	0	0	1	1	1.0
履	0	1	0	1	1.0
屡试不爽	1	0	0	1	1.0
屡犯	0	0	1	1	1.0
屡次	1	0	0	1	1.0
屡屡	0	1	0	1	1.0
属实	0	0	1	1	1.0
展览	1	0	0	1	1.0
展示	0	0	1	1	1.0
屌丝	0	1	0	1	1.0
屋前	1	0	0	1	1.0
屋	0	0	1	1	1.0
届	1	0	0	1	1.0
居高不下	0	0	1	1	1.0
居民点	1	0	0	1	1.0
层次	0	1	0	1	1.0
层出不穷	0	1	0	1	1.0
层	0	1	0	1	1.0
屁眼	0	1	0	1	1.0
局限性	0	0	1	1	1.0
局限	0	0	1	1	1.0
局长	0	1	0	1	1.0
局部	0	1	0	1	1.0
尿血	0	1	0	1	1.0
尿片	0	0	1	1	1.0
尿	1	0	0	1	1.0
尾灯	1	0	0	1	1.0
尽量减少	0	1	0	1	1.0
尽责	0	1	0	1	1.0
尽职尽责	0	1	0	1	1.0
尽职	0	1	0	1	1.0
尽可能	1	0	0	1	1.0
尽可	1	0	0	1	1.0
尼克松	0	0	1	1	1.0
尼克	0	0	1	1	1.0
尼	1	0	0	1	1.0
尸体	1	0	0	1	1.0
尸位素餐	1	0	0	1	1.0
尸位	1	0	0	1	1.0
就读	1	0	0	1	1.0
就事论事	0	0	1	1	1.0
就业率	0	1	0	1	1.0
就业指导	1	0	0	1	1.0
尤为	1	0	0	1	1.0
尝试	1	0	0	1	1.0
尝尝	0	0	1	1	1.0
尘封	1	0	0	1	1.0
尖锐	1	0	0	1	1.0
尔斯	1	0	0	1	1.0
尔康	0	0	1	1	1.0
少男	0	1	0	1	1.0
少年儿童	0	0	1	1	1.0
少少	0	1	0	1	1.0
少将	1	0	0	1	1.0
少壮	0	0	1	1	1.0
尐	0	0	1	1	1.0
小黑	0	1	0	1	1.0
小麦	0	1	0	1	1.0
小鸟依人	0	0	1	1	1.0
小鸟	0	0	1	1	1.0
小饼	0	1	0	1	1.0
小镇	0	1	0	1	1.0
小钱	1	0	0	1	1.0
小轿车	0	1	0	1	1.0
小贩	1	0	0	1	1.0
小说吧	0	1	0	1	1.0
小表弟	1	0	0	1	1.0
小萝卜	1	0	0	1	1.0
小苹果	0	0	1	1	1.0
小船	0	0	1	1	1.0
小舅	1	0	0	1	1.0
小脚	1	0	0	1	1.0
小票	0	0	1	1	1.0
小眼	0	1	0	1	1.0
小男孩	0	1	0	1	1.0
小生意	0	0	1	1	1.0
小生	0	0	1	1	1.0
小瓶	0	1	0	1	1.0
小王子	0	1	0	1	1.0
小狗	1	0	0	1	1.0
小牛	0	0	1	1	1.0
小汽车	0	1	0	1	1.0
小手	1	0	0	1	1.0
小心翼翼	0	0	1	1	1.0
小幅	0	0	1	1	1.0
小家具	1	0	0	1	1.0
小家伙	1	0	0	1	1.0
小宝宝	0	1	0	1	1.0
小孩儿	0	1	0	1	1.0
小媳妇	1	0	0	1	1.0
小女生	1	0	0	1	1.0
小女孩	1	0	0	1	1.0
小城	1	0	0	1	1.0
小型	0	1	0	1	1.0
小圆点	0	1	0	1	1.0
小喽啰	0	1	0	1	1.0
小周	0	1	0	1	1.0
小吃	1	0	0	1	1.0
小号	0	0	1	1	1.0
小分队	1	0	0	1	1.0
小分	1	0	0	1	1.0
小兄弟	0	0	1	1	1.0
小伙子	0	1	0	1	1.0
小人国	1	0	0	1	1.0
小于	0	1	0	1	1.0
小二	1	0	0	1	1.0
小事	0	1	0	1	1.0
小丫头	1	0	0	1	1.0
尊贵	1	0	0	1	1.0
尊老爱幼	1	0	0	1	1.0
尊老	1	0	0	1	1.0
尉迟	0	0	1	1	1.0
将领	1	0	0	1	1.0
将近	0	1	0	1	1.0
射出	0	1	0	1	1.0
封面	0	1	0	1	1.0
封锁	1	0	0	1	1.0
封建	0	1	0	1	1.0
封号	0	0	1	1	1.0
封信	1	0	0	1	1.0
封	0	1	0	1	1.0
寿终	0	0	1	1	1.0
导读	0	0	1	1	1.0
导火索	0	0	1	1	1.0
导火	0	0	1	1	1.0
导弹	0	1	0	1	1.0
导向	0	1	0	1	1.0
导	0	0	1	1	1.0
寻衅滋事	1	0	0	1	1.0
寻衅	1	0	0	1	1.0
寻求	1	0	0	1	1.0
寻常	0	0	1	1	1.0
寻	0	0	1	1	1.0
对错	1	0	0	1	1.0
对话	1	0	0	1	1.0
对策	0	1	0	1	1.0
对立面	0	1	0	1	1.0
对方	1	0	0	1	1.0
对抗	1	0	0	1	1.0
寸铁	0	1	0	1	1.0
察觉到	0	0	1	1	1.0
察觉	0	0	1	1	1.0
寒心	0	0	1	1	1.0
寒山寺	0	0	1	1	1.0
寒冷	1	0	0	1	1.0
富阳市	0	1	0	1	1.0
富阳	0	1	0	1	1.0
富裕	1	0	0	1	1.0
富有	1	0	0	1	1.0
富兰克林	0	1	0	1	1.0
富兰克	0	1	0	1	1.0
密码	0	0	1	1	1.0
密度	1	0	0	1	1.0
密布	0	0	1	1	1.0
密山	0	1	0	1	1.0
密云	1	0	0	1	1.0
寄来	1	0	0	1	1.0
宿迁	0	1	0	1	1.0
宿舍楼	0	1	0	1	1.0
宿舍	0	1	0	1	1.0
宾馆	0	0	1	1	1.0
宾客	1	0	0	1	1.0
容错过	1	0	0	1	1.0
容错	1	0	0	1	1.0
容忍	1	0	0	1	1.0
容	0	1	0	1	1.0
家风	1	0	0	1	1.0
家暴	0	1	0	1	1.0
家教	0	0	1	1	1.0
家政	1	0	0	1	1.0
家庭聚会	1	0	0	1	1.0
家庭收入	1	0	0	1	1.0
家常	1	0	0	1	1.0
家学	1	0	0	1	1.0
家境	0	0	1	1	1.0
家园	0	1	0	1	1.0
家务	1	0	0	1	1.0
家具	1	0	0	1	1.0
家住	1	0	0	1	1.0
家产	0	1	0	1	1.0
家事	0	0	1	1	1.0
家中	0	1	0	1	1.0
宵夜	0	1	0	1	1.0
宴请	1	0	0	1	1.0
宴	0	0	1	1	1.0
害死	0	0	1	1	1.0
害命	0	0	1	1	1.0
害	0	1	0	1	1.0
宰相	0	0	1	1	1.0
宫颈	1	0	0	1	1.0
宫	0	1	0	1	1.0
宣战	0	0	1	1	1.0
客观规律	0	1	0	1	1.0
客观	0	1	0	1	1.0
客源	0	0	1	1	1.0
客栈	0	1	0	1	1.0
客服	0	1	0	1	1.0
客属	1	0	0	1	1.0
审核	0	1	0	1	1.0
审查	0	0	1	1	1.0
审慎	1	0	0	1	1.0
宠	1	0	0	1	1.0
实验	0	0	1	1	1.0
实际操作	1	0	0	1	1.0
实际意义	0	1	0	1	1.0
实质性	0	1	0	1	1.0
实质	0	1	0	1	1.0
实证	0	0	1	1	1.0
实用	0	1	0	1	1.0
实枪	0	1	0	1	1.0
实情	0	1	0	1	1.0
实属	0	1	0	1	1.0
实实在在	0	1	0	1	1.0
实实在	0	1	0	1	1.0
实体店	0	1	0	1	1.0
实事	0	1	0	1	1.0
宝马	0	0	1	1	1.0
宝通	0	1	0	1	1.0
宝贵	1	0	0	1	1.0
宝贝疙瘩	1	0	0	1	1.0
宝典	0	0	1	1	1.0
宜	0	1	0	1	1.0
定要	0	1	0	1	1.0
定西	0	1	0	1	1.0
定点医院	0	1	0	1	1.0
定点	0	1	0	1	1.0
定制	0	0	1	1	1.0
定会	1	0	0	1	1.0
定下	1	0	0	1	1.0
官逼民反	0	1	0	1	1.0
官老爷	0	1	0	1	1.0
官方消息	0	1	0	1	1.0
官员	0	1	0	1	1.0
官僚机构	0	1	0	1	1.0
官僚	0	1	0	1	1.0
官位	1	0	0	1	1.0
宗教界	0	1	0	1	1.0
宗子	1	0	0	1	1.0
完败	1	0	0	1	1.0
完胜	1	0	0	1	1.0
完结	1	0	0	1	1.0
完满	0	0	1	1	1.0
完毕	0	1	0	1	1.0
完整版	1	0	0	1	1.0
完成使命	0	1	0	1	1.0
完小	1	0	0	1	1.0
安能	0	1	0	1	1.0
安监局	0	1	0	1	1.0
安理会	0	1	0	1	1.0
安然	1	0	0	1	1.0
安排	0	1	0	1	1.0
安拉	1	0	0	1	1.0
安慰	1	0	0	1	1.0
安息	1	0	0	1	1.0
安心	0	0	1	1	1.0
安徽	1	0	0	1	1.0
安庆	0	1	0	1	1.0
安居乐业	0	1	0	1	1.0
安居	0	1	0	1	1.0
安安静静	0	1	0	1	1.0
安哥	1	0	0	1	1.0
安卡拉	0	0	1	1	1.0
安利	1	0	0	1	1.0
安分	0	0	1	1	1.0
安全隐患	0	1	0	1	1.0
安全系数	0	1	0	1	1.0
安全法	0	1	0	1	1.0
安全性	1	0	0	1	1.0
安全带	0	0	1	1	1.0
安保	0	0	1	1	1.0
安人	1	0	0	1	1.0
守纪	0	1	0	1	1.0
守望	1	0	0	1	1.0
守护	0	1	0	1	1.0
守寡	0	1	0	1	1.0
宁静	0	1	0	1	1.0
宁波市	0	1	0	1	1.0
宁愿	0	1	0	1	1.0
宁可	0	1	0	1	1.0
学长	0	1	0	1	1.0
学费	0	1	0	1	1.0
学说话	1	0	0	1	1.0
学说	1	0	0	1	1.0
学者	1	0	0	1	1.0
学科	0	0	1	1	1.0
学生家长	1	0	0	1	1.0
学生会	0	0	1	1	1.0
学法	0	0	1	1	1.0
学术	0	1	0	1	1.0
学期	0	0	1	1	1.0
学家	0	1	0	1	1.0
学学	1	0	0	1	1.0
学历	0	1	0	1	1.0
学前教育	1	0	0	1	1.0
学前	1	0	0	1	1.0
学刊	1	0	0	1	1.0
学分	1	0	0	1	1.0
孤独寂寞	0	1	0	1	1.0
孤	0	0	1	1	1.0
季	0	1	0	1	1.0
孝顺父母	0	1	0	1	1.0
孝敬老人	0	1	0	1	1.0
孝敬	0	1	0	1	1.0
孝	0	1	0	1	1.0
孙立平	0	0	1	1	1.0
孙悟空	1	0	0	1	1.0
存疑	1	0	0	1	1.0
存活	0	0	1	1	1.0
存储空间	0	0	1	1	1.0
存储容量	0	0	1	1	1.0
孕期	1	0	0	1	1.0
孕晚期	1	0	0	1	1.0
孕早期	1	0	0	1	1.0
子夜	0	1	0	1	1.0
子会	0	1	0	1	1.0
嬷嬷	0	1	0	1	1.0
嬛	0	1	0	1	1.0
嫡子	1	0	0	1	1.0
嫁给	0	1	0	1	1.0
嫁娶	0	1	0	1	1.0
媲美	0	1	0	1	1.0
婷婷	0	1	0	1	1.0
婷	1	0	0	1	1.0
婵	0	1	0	1	1.0
婴幼儿	0	1	0	1	1.0
婴幼	0	1	0	1	1.0
婴	0	0	1	1	1.0
婚期	0	0	1	1	1.0
婚嫁	1	0	0	1	1.0
婚娶	0	1	0	1	1.0
婚姻法	0	1	0	1	1.0
婚前	0	1	0	1	1.0
婚内	0	1	0	1	1.0
婚丧嫁娶	0	1	0	1	1.0
婊子	0	1	0	1	1.0
婊	1	0	0	1	1.0
娱乐活动	1	0	0	1	1.0
娘家	1	0	0	1	1.0
娘	0	1	0	1	1.0
娇小	1	0	0	1	1.0
娄	0	1	0	1	1.0
娃子	0	1	0	1	1.0
娃娃	1	0	0	1	1.0
威风凛凛	0	1	0	1	1.0
威风	0	1	0	1	1.0
威	0	1	0	1	1.0
姿势	0	1	0	1	1.0
姨妈	1	0	0	1	1.0
姨	0	0	1	1	1.0
姥姥家	0	0	1	1	1.0
委员会	0	1	0	1	1.0
委	0	1	0	1	1.0
姓	0	1	0	1	1.0
姑苏	0	0	1	1	1.0
姐妹花	1	0	0	1	1.0
始祖	1	0	0	1	1.0
姆林宫	1	0	0	1	1.0
妻子	1	0	0	1	1.0
妹夫	1	0	0	1	1.0
妳	0	1	0	1	1.0
妮	0	1	0	1	1.0
妥	0	0	1	1	1.0
妖孽	1	0	0	1	1.0
妓	0	1	0	1	1.0
妊娠	1	0	0	1	1.0
妇幼医院	0	0	1	1	1.0
妇幼保健	1	0	0	1	1.0
妇孺	1	0	0	1	1.0
妇女节	1	0	0	1	1.0
妇人之仁	0	0	1	1	1.0
妇产科	0	1	0	1	1.0
妇产	0	1	0	1	1.0
妄想	1	0	0	1	1.0
妄动	1	0	0	1	1.0
妄	0	1	0	1	1.0
如皋市	1	0	0	1	1.0
如皋	1	0	0	1	1.0
如火如荼	0	1	0	1	1.0
如沐春风	1	0	0	1	1.0
如梭	0	1	0	1	1.0
如山	0	0	1	1	1.0
如前	0	1	0	1	1.0
好闻	0	0	1	1	1.0
好酷	0	1	0	1	1.0
好运	1	0	0	1	1.0
好赚	0	1	0	1	1.0
好自为之	1	0	0	1	1.0
好笑	0	1	0	1	1.0
好生	1	0	0	1	1.0
好歹	1	0	0	1	1.0
好极了	0	1	0	1	1.0
好戏	1	0	0	1	1.0
好感	1	0	0	1	1.0
好彩头	1	0	0	1	1.0
好山好水	1	0	0	1	1.0
好孩子	0	0	1	1	1.0
好好儿	1	0	0	1	1.0
好奇	1	0	0	1	1.0
好坏	1	0	0	1	1.0
好喝	1	0	0	1	1.0
好人	0	1	0	1	1.0
好事儿	0	1	0	1	1.0
好了吗	1	0	0	1	1.0
好书	1	0	0	1	1.0
好久没	1	0	0	1	1.0
好下场	0	1	0	1	1.0
奸商	0	0	1	1	1.0
奸	1	0	0	1	1.0
奶	1	0	0	1	1.0
奴隶	1	0	0	1	1.0
奴性	0	1	0	1	1.0
女老师	0	0	1	1	1.0
女童	0	1	0	1	1.0
女神	0	0	1	1	1.0
女权	0	0	1	1	1.0
女方	0	0	1	1	1.0
女子	1	0	0	1	1.0
女娲	1	0	0	1	1.0
女同胞	0	1	0	1	1.0
女司机	1	0	0	1	1.0
女友	1	0	0	1	1.0
女医生	0	1	0	1	1.0
奥迪	0	0	1	1	1.0
奥运	1	0	0	1	1.0
奥斯卡	0	0	1	1	1.0
奢望	1	0	0	1	1.0
套路	0	1	0	1	1.0
套用	1	0	0	1	1.0
套牢	1	0	0	1	1.0
奖章	1	0	0	1	1.0
奖	0	0	1	1	1.0
奕奕	1	0	0	1	1.0
奕	1	0	0	1	1.0
奔驰	0	0	1	1	1.0
奔波	0	1	0	1	1.0
奔小康	0	0	1	1	1.0
奔命	1	0	0	1	1.0
奔	1	0	0	1	1.0
奏	1	0	0	1	1.0
奉还	0	0	1	1	1.0
奉献	1	0	0	1	1.0
奈	1	0	0	1	1.0
夺命	0	0	1	1	1.0
夹缝	0	1	0	1	1.0
夹击	0	0	1	1	1.0
头顶	0	1	0	1	1.0
头路	0	1	0	1	1.0
头晕	1	0	0	1	1.0
头子	0	1	0	1	1.0
头发	0	0	1	1	1.0
头功	0	1	0	1	1.0
头儿	0	1	0	1	1.0
头像	0	0	1	1	1.0
失误	0	1	0	1	1.0
失控	0	1	0	1	1.0
失口	1	0	0	1	1.0
失事	1	0	0	1	1.0
失业	0	1	0	1	1.0
央行	0	0	1	1	1.0
太难受	0	1	0	1	1.0
太阳神	0	1	0	1	1.0
太粗	0	0	1	1	1.0
太烂	1	0	0	1	1.0
太棒	1	0	0	1	1.0
太极拳	1	0	0	1	1.0
太极	1	0	0	1	1.0
太晚	1	0	0	1	1.0
太平	0	1	0	1	1.0
太合	1	0	0	1	1.0
太久	1	0	0	1	1.0
天骄	0	0	1	1	1.0
天雷	0	1	0	1	1.0
天长	0	1	0	1	1.0
天虹	1	0	0	1	1.0
天真	1	0	0	1	1.0
天津路	0	1	0	1	1.0
天津市	0	1	0	1	1.0
天气预报	0	1	0	1	1.0
天暗	0	0	1	1	1.0
天星	1	0	0	1	1.0
天数	0	1	0	1	1.0
天平	0	0	1	1	1.0
天子	1	0	0	1	1.0
天大	0	1	0	1	1.0
天壤之别	1	0	0	1	1.0
天壤	1	0	0	1	1.0
天堂	0	1	0	1	1.0
天同	1	0	0	1	1.0
天内	0	0	1	1	1.0
天佑	1	0	0	1	1.0
天价	0	1	0	1	1.0
天书	0	0	1	1	1.0
天下无难事	1	0	0	1	1.0
天下太平	0	1	0	1	1.0
大黄	0	1	0	1	1.0
大马路	0	1	0	1	1.0
大马	0	1	0	1	1.0
大面积	0	1	0	1	1.0
大面	0	1	0	1	1.0
大雪	0	1	0	1	1.0
大雨天	0	1	0	1	1.0
大集	1	0	0	1	1.0
大难不死	0	0	1	1	1.0
大难	0	0	1	1	1.0
大院	0	1	0	1	1.0
大闺女	0	0	1	1	1.0
大门口	1	0	0	1	1.0
大门	1	0	0	1	1.0
大部份	0	1	0	1	1.0
大连市	0	1	0	1	1.0
大过年	1	0	0	1	1.0
大跌眼镜	1	0	0	1	1.0
大赛	0	1	0	1	1.0
大行其道	0	0	1	1	1.0
大行	0	0	1	1	1.0
大蛇丸	0	0	1	1	1.0
大葱	1	0	0	1	1.0
大菜	1	0	0	1	1.0
大节	1	0	0	1	1.0
大脑	0	1	0	1	1.0
大肚子	1	0	0	1	1.0
大肚	1	0	0	1	1.0
大福	1	0	0	1	1.0
大祸	0	1	0	1	1.0
大神	1	0	0	1	1.0
大碗	0	0	1	1	1.0
大白	0	0	1	1	1.0
大病	0	1	0	1	1.0
大火	0	0	1	1	1.0
大清	0	1	0	1	1.0
大波	0	0	1	1	1.0
大气质量	0	1	0	1	1.0
大楼	0	0	1	1	1.0
大棒	0	1	0	1	1.0
大林	0	1	0	1	1.0
大方	1	0	0	1	1.0
大排量	1	0	0	1	1.0
大把大把	0	1	0	1	1.0
大房子	0	1	0	1	1.0
大房	0	1	0	1	1.0
大戏	1	0	0	1	1.0
大惊小怪	0	0	1	1	1.0
大悟县	1	0	0	1	1.0
大悟	1	0	0	1	1.0
大快朵颐	1	0	0	1	1.0
大忌	0	1	0	1	1.0
大庙	1	0	0	1	1.0
大庆	0	1	0	1	1.0
大年初三	1	0	0	1	1.0
大幅度	0	0	1	1	1.0
大师	0	0	1	1	1.0
大山	1	0	0	1	1.0
大局	1	0	0	1	1.0
大宛	0	0	1	1	1.0
大娘	1	0	0	1	1.0
大姨妈	1	0	0	1	1.0
大姨	1	0	0	1	1.0
大奖	1	0	0	1	1.0
大夫	0	1	0	1	1.0
大大降低	1	0	0	1	1.0
大型	0	1	0	1	1.0
大圣	1	0	0	1	1.0
大团结	0	1	0	1	1.0
大团	0	1	0	1	1.0
大嘴巴	0	0	1	1	1.0
大呼小叫	0	1	0	1	1.0
大同	1	0	0	1	1.0
大叫	0	1	0	1	1.0
大厦	0	0	1	1	1.0
大半夜	0	1	0	1	1.0
大势	0	1	0	1	1.0
大功率	1	0	0	1	1.0
大功告成	0	1	0	1	1.0
大刀阔斧	0	1	0	1	1.0
大刀	0	1	0	1	1.0
大兵	0	1	0	1	1.0
大儿子	1	0	0	1	1.0
大儿	1	0	0	1	1.0
大便	0	1	0	1	1.0
大使馆	1	0	0	1	1.0
大佬	1	0	0	1	1.0
大会	0	1	0	1	1.0
大伙儿	0	0	1	1	1.0
大伙	0	0	1	1	1.0
大众日报	0	0	1	1	1.0
大于利	1	0	0	1	1.0
大乱	1	0	0	1	1.0
大为	0	1	0	1	1.0
大中华	1	0	0	1	1.0
大中	1	0	0	1	1.0
大不如前	0	1	0	1	1.0
大三	1	0	0	1	1.0
够花	0	1	0	1	1.0
够劲	1	0	0	1	1.0
夜空	0	1	0	1	1.0
夜班	0	0	1	1	1.0
夜明珠	1	0	0	1	1.0
夜明	1	0	0	1	1.0
多长时间	1	0	0	1	1.0
多种不同	0	0	1	1	1.0
多福	1	0	0	1	1.0
多着呢	1	0	0	1	1.0
多着	1	0	0	1	1.0
多点	0	0	1	1	1.0
多方面	1	0	0	1	1.0
多摩	1	0	0	1	1.0
多岁	0	1	0	1	1.0
多少岁	1	0	0	1	1.0
多子	1	0	0	1	1.0
多天	0	1	0	1	1.0
多多益善	0	1	0	1	1.0
多多少少	0	1	0	1	1.0
多分钟	0	1	0	1	1.0
多分	0	1	0	1	1.0
多万元	0	0	1	1	1.0
多一些	0	1	0	1	1.0
外面	0	1	0	1	1.0
外部	0	1	0	1	1.0
外观设计	0	1	0	1	1.0
外表	1	0	0	1	1.0
外突	1	0	0	1	1.0
外电报道	0	0	1	1	1.0
外电	0	0	1	1	1.0
外环线	0	1	0	1	1.0
外援	1	0	0	1	1.0
外患	1	0	0	1	1.0
外婆	1	0	0	1	1.0
外壳	0	1	0	1	1.0
外国人	1	0	0	1	1.0
外力	0	0	1	1	1.0
夏至	0	1	0	1	1.0
夏	1	0	0	1	1.0
复位	1	0	0	1	1.0
复仇	0	0	1	1	1.0
备受	0	1	0	1	1.0
处置	0	1	0	1	1.0
处死	0	1	0	1	1.0
处女	0	1	0	1	1.0
处在	0	0	1	1	1.0
处于	0	1	0	1	1.0
壳子	1	0	0	1	1.0
声称	1	0	0	1	1.0
声息	1	0	0	1	1.0
声势	1	0	0	1	1.0
壮年	0	1	0	1	1.0
壮大	0	1	0	1	1.0
壁立千仞	0	0	1	1	1.0
壁立	0	0	1	1	1.0
增长率	1	0	0	1	1.0
增重	1	0	0	1	1.0
增派	1	0	0	1	1.0
增强版	1	0	0	1	1.0
增强	1	0	0	1	1.0
增幅	0	1	0	1	1.0
墙上	0	1	0	1	1.0
墙	1	0	0	1	1.0
境外	1	0	0	1	1.0
塞进	0	1	0	1	1.0
塞车	0	1	0	1	1.0
塔尔	0	0	1	1	1.0
塔伊	1	0	0	1	1.0
塔	1	0	0	1	1.0
塑料	0	0	1	1	1.0
塑形	1	0	0	1	1.0
塑	1	0	0	1	1.0
堵车	0	1	0	1	1.0
堪察加	0	0	1	1	1.0
堪察	0	0	1	1	1.0
堆积如山	0	0	1	1	1.0
堆放	0	0	1	1	1.0
堂皇	0	1	0	1	1.0
基金	1	0	0	1	1.0
基本一致	0	0	1	1	1.0
基斯坦	0	1	0	1	1.0
基斯	0	1	0	1	1.0
基层人民	0	1	0	1	1.0
基层	0	1	0	1	1.0
基尼	0	0	1	1	1.0
基因	0	1	0	1	1.0
基于	1	0	0	1	1.0
域性	0	0	1	1	1.0
城镇化	0	1	0	1	1.0
城镇	0	1	0	1	1.0
城里	1	0	0	1	1.0
城西	0	1	0	1	1.0
城市道路	0	1	0	1	1.0
城市规划	0	0	1	1	1.0
城市管理者	1	0	0	1	1.0
城市污染	0	1	0	1	1.0
城市化	0	0	1	1	1.0
城外	0	0	1	1	1.0
城内	0	1	0	1	1.0
城乡	1	0	0	1	1.0
埋汰	0	0	1	1	1.0
埋单	1	0	0	1	1.0
埃及	1	0	0	1	1.0
垫	1	0	0	1	1.0
垄断	0	1	0	1	1.0
垃圾桶	0	1	0	1	1.0
坪坝	0	0	1	1	1.0
坨	0	1	0	1	1.0
坦白讲	1	0	0	1	1.0
坦白	1	0	0	1	1.0
坤	0	0	1	1	1.0
坡路	1	0	0	1	1.0
坠毁	0	1	0	1	1.0
坠楼	0	1	0	1	1.0
坠	0	0	1	1	1.0
坟山	0	1	0	1	1.0
坝区	0	0	1	1	1.0
坚持下去	0	1	0	1	1.0
坚定	0	1	0	1	1.0
坚信	1	0	0	1	1.0
坑里	1	0	0	1	1.0
坐诊	0	1	0	1	1.0
坐牢	1	0	0	1	1.0
坐火车	0	1	0	1	1.0
坐月子	1	0	0	1	1.0
坐地铁	0	0	1	1	1.0
坐地	0	0	1	1	1.0
坏蛋	1	0	0	1	1.0
坏事	0	0	1	1	1.0
均匀	0	0	1	1	1.0
场面话	0	0	1	1	1.0
地面	1	0	0	1	1.0
地震	0	1	0	1	1.0
地表	0	1	0	1	1.0
地盘	0	0	1	1	1.0
地理位置	0	0	1	1	1.0
地理	0	0	1	1	1.0
地板	1	0	0	1	1.0
地形	0	0	1	1	1.0
地广	1	0	0	1	1.0
地域	0	0	1	1	1.0
地坪	0	1	0	1	1.0
地址	1	0	0	1	1.0
地区性	0	0	1	1	1.0
地动山摇	0	1	0	1	1.0
地动	0	1	0	1	1.0
地儿	0	1	0	1	1.0
地产	0	0	1	1	1.0
地上	0	1	0	1	1.0
圩	0	1	0	1	1.0
在读	1	0	0	1	1.0
在职	0	1	0	1	1.0
在编	1	0	0	1	1.0
在生活中	0	0	1	1	1.0
在案	0	1	0	1	1.0
在我心中	1	0	0	1	1.0
在实践中	0	0	1	1	1.0
在世	0	1	0	1	1.0
圣诞老人	1	0	0	1	1.0
圣诞礼物	0	0	1	1	1.0
圣诞树	1	0	0	1	1.0
圣诞卡	1	0	0	1	1.0
圣诗	1	0	0	1	1.0
圣母	1	0	0	1	1.0
土黄色	0	0	1	1	1.0
土黄	0	0	1	1	1.0
土耳其人	1	0	0	1	1.0
土方	1	0	0	1	1.0
土包子	1	0	0	1	1.0
土包	1	0	0	1	1.0
圈钱	0	1	0	1	1.0
圈围	1	0	0	1	1.0
圆脸	0	0	1	1	1.0
圆点	0	1	0	1	1.0
圆滑	1	0	0	1	1.0
圆润	1	0	0	1	1.0
圆月	1	0	0	1	1.0
圆弧	1	0	0	1	1.0
圆场	0	0	1	1	1.0
图集	1	0	0	1	1.0
图说	1	0	0	1	1.0
图森	1	0	0	1	1.0
图库	0	0	1	1	1.0
国际部	0	1	0	1	1.0
国际事务	1	0	0	1	1.0
国足	0	0	1	1	1.0
国贼	0	1	0	1	1.0
国航	0	1	0	1	1.0
国联军	0	1	0	1	1.0
国联	0	1	0	1	1.0
国策	0	1	0	1	1.0
国王	0	1	0	1	1.0
国歌	1	0	0	1	1.0
国库	0	1	0	1	1.0
国家统计局	1	0	0	1	1.0
国家级	0	1	0	1	1.0
国家有关	0	0	1	1	1.0
国家所有	0	1	0	1	1.0
国安	0	1	0	1	1.0
国大	0	0	1	1	1.0
国境	0	0	1	1	1.0
国土	0	1	0	1	1.0
国务秘书	1	0	0	1	1.0
国务卿	1	0	0	1	1.0
国内新闻	1	0	0	1	1.0
国会	1	0	0	1	1.0
国产品牌	0	1	0	1	1.0
固有	0	0	1	1	1.0
固执	1	0	0	1	1.0
固定资产	1	0	0	1	1.0
围追堵截	0	1	0	1	1.0
围追	0	1	0	1	1.0
围观	0	0	1	1	1.0
围绕	0	1	0	1	1.0
围炉	1	0	0	1	1.0
围桌	1	0	0	1	1.0
围墙	0	1	0	1	1.0
困扰	0	1	0	1	1.0
囧	1	0	0	1	1.0
囤	0	1	0	1	1.0
团队	0	0	1	1	1.0
团年饭	0	1	0	1	1.0
团委	1	0	0	1	1.0
团圆节	1	0	0	1	1.0
团圆夜	1	0	0	1	1.0
团	1	0	0	1	1.0
因果	1	0	0	1	1.0
因噎废食	0	1	0	1	1.0
因人而异	1	0	0	1	1.0
因人	1	0	0	1	1.0
回龙观	0	1	0	1	1.0
回龙	0	1	0	1	1.0
回过头来	0	1	0	1	1.0
回购	0	1	0	1	1.0
回访	0	0	1	1	1.0
回生	0	1	0	1	1.0
回炉	0	0	1	1	1.0
回民	0	1	0	1	1.0
回暖	0	0	1	1	1.0
回族	0	1	0	1	1.0
回敬	1	0	0	1	1.0
回放	1	0	0	1	1.0
回手	1	0	0	1	1.0
回忆起	1	0	0	1	1.0
回家吧	0	1	0	1	1.0
回娘家	1	0	0	1	1.0
回头路	0	1	0	1	1.0
回国	1	0	0	1	1.0
回响	0	0	1	1	1.0
回向	0	1	0	1	1.0
四边	0	1	0	1	1.0
四起	0	0	1	1	1.0
四类	1	0	0	1	1.0
四等	0	0	1	1	1.0
四百	0	1	0	1	1.0
四点	0	1	0	1	1.0
四溅	0	0	1	1	1.0
四海	1	0	0	1	1.0
四朵	1	0	0	1	1.0
四成	0	0	1	1	1.0
四川盆地	0	1	0	1	1.0
四川	0	1	0	1	1.0
四岁	0	0	1	1	1.0
四届	1	0	0	1	1.0
四射	0	0	1	1	1.0
四家	0	0	1	1	1.0
四处	1	0	0	1	1.0
四响	0	0	1	1	1.0
四周	0	1	0	1	1.0
四号线	1	0	0	1	1.0
四号	1	0	0	1	1.0
四叶草	0	0	1	1	1.0
四叶	0	0	1	1	1.0
四口	1	0	0	1	1.0
四十几岁	0	1	0	1	1.0
四分五裂	0	0	1	1	1.0
四分五	0	0	1	1	1.0
四六	1	0	0	1	1.0
嚷嚷	1	0	0	1	1.0
嚷	0	1	0	1	1.0
嚣张	1	0	0	1	1.0
嚎哭	0	1	0	1	1.0
嚎	0	0	1	1	1.0
噶	0	1	0	1	1.0
噜	1	0	0	1	1.0
噗	1	0	0	1	1.0
噌	1	0	0	1	1.0
嘿嘿嘿	0	0	1	1	1.0
嘿嘿	0	0	1	1	1.0
嘿	1	0	0	1	1.0
嘲热	0	0	1	1	1.0
嘟囔	0	0	1	1	1.0
嘟嘟	0	1	0	1	1.0
嘚	0	0	1	1	1.0
嘉陵江	1	0	0	1	1.0
嘉陵	1	0	0	1	1.0
嘉许	1	0	0	1	1.0
嘉宾	0	0	1	1	1.0
嘉兴	0	1	0	1	1.0
嘈	1	0	0	1	1.0
喽啰	0	1	0	1	1.0
喷出来	1	0	0	1	1.0
喝醉酒	0	0	1	1	1.0
喝醉	0	0	1	1	1.0
喝西北风	0	0	1	1	1.0
喝水	1	0	0	1	1.0
喜马拉雅	0	1	0	1	1.0
喜马拉	0	1	0	1	1.0
喜闻乐见	0	1	0	1	1.0
喜闻	0	1	0	1	1.0
喜酒	0	0	1	1	1.0
喜怒哀乐	1	0	0	1	1.0
喜怒	1	0	0	1	1.0
喜剧效果	0	0	1	1	1.0
喜剧	0	0	1	1	1.0
喜事	0	1	0	1	1.0
喘息	0	0	1	1	1.0
喘	0	1	0	1	1.0
喉	0	1	0	1	1.0
喇叭声	0	0	1	1	1.0
善心	1	0	0	1	1.0
善举	0	1	0	1	1.0
喂	1	0	0	1	1.0
啼笑皆非	1	0	0	1	1.0
啼笑	1	0	0	1	1.0
啧啧	0	0	1	1	1.0
啧	0	0	1	1	1.0
啥意思	0	0	1	1	1.0
啥子	0	1	0	1	1.0
啤酒	0	0	1	1	1.0
啊呀呀	1	0	0	1	1.0
啊呀	1	0	0	1	1.0
商铺	0	1	0	1	1.0
商量余地	0	1	0	1	1.0
商户	0	1	0	1	1.0
商家	1	0	0	1	1.0
商定	0	1	0	1	1.0
商圈	1	0	0	1	1.0
商品	0	1	0	1	1.0
商业区	0	1	0	1	1.0
商业化	1	0	0	1	1.0
商	1	0	0	1	1.0
啃	0	0	1	1	1.0
唾	1	0	0	1	1.0
唻	1	0	0	1	1.0
唱反调	0	1	0	1	1.0
唱反	0	1	0	1	1.0
唯美	0	0	1	1	1.0
唯有	1	0	0	1	1.0
唯恐天下	0	0	1	1	1.0
唯恐	0	0	1	1	1.0
唯利是图	0	1	0	1	1.0
售罄	0	0	1	1	1.0
售后	0	1	0	1	1.0
售卖	0	1	0	1	1.0
售出	0	1	0	1	1.0
唤起	0	1	0	1	1.0
唠嗑	1	0	0	1	1.0
唠叨	0	0	1	1	1.0
唐僧	1	0	0	1	1.0
唐一菲	1	0	0	1	1.0
唇齿	1	0	0	1	1.0
哼	0	1	0	1	1.0
哺乳室	0	0	1	1	1.0
哺乳	0	0	1	1	1.0
哲理	1	0	0	1	1.0
哭笑不得	0	1	0	1	1.0
哪边	0	0	1	1	1.0
哪家	1	0	0	1	1.0
哪位	0	1	0	1	1.0
哥哥妹妹	1	0	0	1	1.0
哥们儿	1	0	0	1	1.0
哟	1	0	0	1	1.0
哑巴亏	1	0	0	1	1.0
哑巴	1	0	0	1	1.0
哎呀	1	0	0	1	1.0
响应号召	0	0	1	1	1.0
哉	1	0	0	1	1.0
哈迈德	0	0	1	1	1.0
哈巴狗	1	0	0	1	1.0
哈巴	1	0	0	1	1.0
哈哈笑	1	0	0	1	1.0
哈哈哈哈	1	0	0	1	1.0
哇	1	0	0	1	1.0
哄	0	1	0	1	1.0
品鉴	1	0	0	1	1.0
品牌效应	0	0	1	1	1.0
品味	1	0	0	1	1.0
品出	1	0	0	1	1.0
哀乐	1	0	0	1	1.0
哀	0	1	0	1	1.0
咳嗽	0	1	0	1	1.0
咳	0	0	1	1	1.0
咬牙切齿	0	1	0	1	1.0
咬伤	0	1	0	1	1.0
咬	0	1	0	1	1.0
咩	1	0	0	1	1.0
咖	0	0	1	1	1.0
咕噜	1	0	0	1	1.0
咒	0	1	0	1	1.0
咎由自取	0	1	0	1	1.0
和蔼	1	0	0	1	1.0
咋搞	1	0	0	1	1.0
咋个	0	1	0	1	1.0
咄咄逼人	0	0	1	1	1.0
咄咄怪事	0	1	0	1	1.0
命题	0	0	1	1	1.0
命令	0	1	0	1	1.0
呼声	0	1	0	1	1.0
呼唤	0	0	1	1	1.0
呼和浩特	0	1	0	1	1.0
呼呼	0	0	1	1	1.0
呵护	0	1	0	1	1.0
味蕾	1	0	0	1	1.0
呱呱	1	0	0	1	1.0
周知	1	0	0	1	1.0
周正	0	0	1	1	1.0
周易	1	0	0	1	1.0
周岁	0	0	1	1	1.0
周围环境	0	1	0	1	1.0
周二	0	0	1	1	1.0
周一	0	0	1	1	1.0
呦	1	0	0	1	1.0
呛鼻	0	1	0	1	1.0
呕吐	1	0	0	1	1.0
告白	1	0	0	1	1.0
告状	0	1	0	1	1.0
告成	0	1	0	1	1.0
呈现出	1	0	0	1	1.0
呈	1	0	0	1	1.0
吾国	0	1	0	1	1.0
吹成	0	1	0	1	1.0
吸烟	1	0	0	1	1.0
吸取教训	0	1	0	1	1.0
吸取	0	1	0	1	1.0
吵闹	0	1	0	1	1.0
吵架	1	0	0	1	1.0
吴江	0	1	0	1	1.0
启蒙教育	0	0	1	1	1.0
启蒙	0	0	1	1	1.0
听闻	0	0	1	1	1.0
听证	0	1	0	1	1.0
听筒	0	1	0	1	1.0
听取	0	1	0	1	1.0
听力	0	1	0	1	1.0
听众	0	0	1	1	1.0
含糊	0	1	0	1	1.0
含意	0	0	1	1	1.0
含冤	0	0	1	1	1.0
否决	0	1	0	1	1.0
吓死人	1	0	0	1	1.0
吓坏	0	1	0	1	1.0
吓呆了	1	0	0	1	1.0
吓呆	1	0	0	1	1.0
吓不倒	1	0	0	1	1.0
向来都是	1	0	0	1	1.0
向来	1	0	0	1	1.0
向往	0	1	0	1	1.0
向下	0	0	1	1	1.0
吐痰	0	0	1	1	1.0
吏	0	1	0	1	1.0
后面	1	0	0	1	1.0
后遗症	0	1	0	1	1.0
后遗	0	1	0	1	1.0
后脚	0	1	0	1	1.0
后羿	1	0	0	1	1.0
后置	1	0	0	1	1.0
后福	0	0	1	1	1.0
后生	1	0	0	1	1.0
后尘	0	1	0	1	1.0
后妈	0	0	1	1	1.0
后发制人	0	0	1	1	1.0
后发	0	0	1	1	1.0
后会	0	1	0	1	1.0
后人	0	1	0	1	1.0
名额	0	0	1	1	1.0
名词	1	0	0	1	1.0
名状	1	0	0	1	1.0
名曰	0	1	0	1	1.0
名星	1	0	0	1	1.0
名儿	0	1	0	1	1.0
名人	0	1	0	1	1.0
名不虚传	1	0	0	1	1.0
名下	0	0	1	1	1.0
同贺	0	0	1	1	1.0
同盟国	1	0	0	1	1.0
同犯	1	0	0	1	1.0
同此	0	1	0	1	1.0
同来	1	0	0	1	1.0
同日	0	0	1	1	1.0
同族	1	0	0	1	1.0
同情心	1	0	0	1	1.0
同情	1	0	0	1	1.0
同归于尽	0	1	0	1	1.0
同归	0	1	0	1	1.0
同庆	1	0	0	1	1.0
同年	0	0	1	1	1.0
同学聚会	1	0	0	1	1.0
同堂	1	0	0	1	1.0
同仁	0	1	0	1	1.0
同于	1	0	0	1	1.0
同一个	0	0	1	1	1.0
吊打	1	0	0	1	1.0
吊唁	1	0	0	1	1.0
吉莫	1	0	0	1	1.0
吉林长春	0	0	1	1	1.0
吉林	0	0	1	1	1.0
吉他	1	0	0	1	1.0
合集	0	1	0	1	1.0
合肥	1	0	0	1	1.0
合理性	1	0	0	1	1.0
合理合法	0	0	1	1	1.0
合法政府	0	1	0	1	1.0
合影	1	0	0	1	1.0
合家欢乐	1	0	0	1	1.0
合家欢	1	0	0	1	1.0
合合	0	1	0	1	1.0
合力	0	1	0	1	1.0
合体	0	0	1	1	1.0
各路人马	0	0	1	1	1.0
各行	0	1	0	1	1.0
各色	0	1	0	1	1.0
各自	0	1	0	1	1.0
各级	1	0	0	1	1.0
各派	0	1	0	1	1.0
各样	1	0	0	1	1.0
各有所好	1	0	0	1	1.0
各族人民	0	1	0	1	1.0
各族	0	1	0	1	1.0
各式各样	1	0	0	1	1.0
各式	1	0	0	1	1.0
各家	1	0	0	1	1.0
各学科	0	0	1	1	1.0
各个方面	1	0	0	1	1.0
吃饱	0	0	1	1	1.0
吃螃蟹	1	0	0	1	1.0
吃晚饭	0	0	1	1	1.0
吃惊	1	0	0	1	1.0
吃喝	1	0	0	1	1.0
叹	0	0	1	1	1.0
司法	0	1	0	1	1.0
号码	0	0	1	1	1.0
号牌	1	0	0	1	1.0
号召力	1	0	0	1	1.0
叶草	0	0	1	1	1.0
叶	0	0	1	1	1.0
右边	1	0	0	1	1.0
右侧	0	1	0	1	1.0
台阶	0	0	1	1	1.0
台词	1	0	0	1	1.0
台历	0	0	1	1	1.0
台前	1	0	0	1	1.0
台上	1	0	0	1	1.0
可选	1	0	0	1	1.0
可谓	0	1	0	1	1.0
可言	0	1	0	1	1.0
可能性	0	0	1	1	1.0
可用	0	1	0	1	1.0
可望	0	0	1	1	1.0
可救	0	1	0	1	1.0
可收	0	1	0	1	1.0
可控	0	1	0	1	1.0
可回忆	1	0	0	1	1.0
可信	0	0	1	1	1.0
可乘之机	1	0	0	1	1.0
可乐	1	0	0	1	1.0
可不可以	0	1	0	1	1.0
可不	0	1	0	1	1.0
叮叮	1	0	0	1	1.0
召开	0	0	1	1	1.0
叫苦	1	0	0	1	1.0
叫板	0	0	1	1	1.0
叫屈	0	1	0	1	1.0
叫好	0	1	0	1	1.0
只许州官放火	1	0	0	1	1.0
只能靠	0	1	0	1	1.0
只管	0	0	1	1	1.0
只用	0	1	0	1	1.0
只怕	1	0	0	1	1.0
古风	1	0	0	1	1.0
古诗	0	0	1	1	1.0
古时候	1	0	0	1	1.0
古时	1	0	0	1	1.0
古城	1	0	0	1	1.0
古兰经	0	0	1	1	1.0
古兰	0	0	1	1	1.0
古人	0	1	0	1	1.0
口舌	0	0	1	1	1.0
口水	0	1	0	1	1.0
口吻	1	0	0	1	1.0
口口声声	0	1	0	1	1.0
口口	0	1	0	1	1.0
口令	0	1	0	1	1.0
叠加	1	0	0	1	1.0
叙政府	0	1	0	1	1.0
叙利亚人	0	0	1	1	1.0
变迁	0	0	1	1	1.0
变淡	0	0	1	1	1.0
变本加厉	0	1	0	1	1.0
变本	0	1	0	1	1.0
变更	1	0	0	1	1.0
变差	1	0	0	1	1.0
变奏	0	1	0	1	1.0
变味	0	1	0	1	1.0
变动	0	0	1	1	1.0
变到	1	0	0	1	1.0
变冷	0	0	1	1	1.0
受骗	1	0	0	1	1.0
受让	0	1	0	1	1.0
受罪	0	1	0	1	1.0
受益	0	1	0	1	1.0
受热捧	1	0	0	1	1.0
受热	1	0	0	1	1.0
受惊	0	1	0	1	1.0
受害者	1	0	0	1	1.0
受害	1	0	0	1	1.0
受够了	1	0	0	1	1.0
受够	1	0	0	1	1.0
受制	0	1	0	1	1.0
取缔	0	1	0	1	1.0
取经	0	1	0	1	1.0
取回	0	1	0	1	1.0
取向	0	1	0	1	1.0
取代	0	1	0	1	1.0
取义	1	0	0	1	1.0
叔	0	0	1	1	1.0
发飙	0	0	1	1	1.0
发送	0	0	1	1	1.0
发话	0	0	1	1	1.0
发证	0	1	0	1	1.0
发誓	0	0	1	1	1.0
发言权	0	0	1	1	1.0
发表文章	0	0	1	1	1.0
发给	0	1	0	1	1.0
发短信	0	1	0	1	1.0
发短	0	1	0	1	1.0
发生源	0	1	0	1	1.0
发生争执	0	0	1	1	1.0
发现自己	0	1	0	1	1.0
发泄	1	0	0	1	1.0
发文	1	0	0	1	1.0
发挥作用	1	0	0	1	1.0
发挥	1	0	0	1	1.0
发指	0	1	0	1	1.0
发扬光大	1	0	0	1	1.0
发帖子	0	0	1	1	1.0
发帖	0	0	1	1	1.0
发布厅	1	0	0	1	1.0
发展壮大	0	1	0	1	1.0
发展中国家	0	1	0	1	1.0
发完	0	1	0	1	1.0
发威	1	0	0	1	1.0
发回	1	0	0	1	1.0
发售日	0	1	0	1	1.0
发动战争	0	1	0	1	1.0
发出声音	0	1	0	1	1.0
发几张	0	0	1	1	1.0
发兵	1	0	0	1	1.0
发光	1	0	0	1	1.0
发作	0	1	0	1	1.0
反驳	0	1	0	1	1.0
反顾	1	0	0	1	1.0
反过来	0	1	0	1	1.0
反过	0	1	0	1	1.0
反转	0	0	1	1	1.0
反贼	0	1	0	1	1.0
反调	0	1	0	1	1.0
反潮流	0	0	1	1	1.0
反派	1	0	0	1	1.0
反推	1	0	0	1	1.0
反抗	1	0	0	1	1.0
反手	0	0	1	1	1.0
反恐怖	0	1	0	1	1.0
反应速度	0	0	1	1	1.0
反对票	0	1	0	1	1.0
反噬	0	0	1	1	1.0
反制	1	0	0	1	1.0
反击	1	0	0	1	1.0
反倒	0	1	0	1	1.0
双龙	1	0	0	1	1.0
双重	0	1	0	1	1.0
双行	0	0	1	1	1.0
双职工	1	0	0	1	1.0
双眼皮	0	1	0	1	1.0
双眼	0	1	0	1	1.0
双核	0	1	0	1	1.0
双手	1	0	0	1	1.0
双亲	0	0	1	1	1.0
友情	0	0	1	1	1.0
友好相处	0	0	1	1	1.0
友好	0	0	1	1	1.0
友善	0	1	0	1	1.0
友人	0	1	0	1	1.0
及至	0	0	1	1	1.0
及时处理	0	1	0	1	1.0
又称	1	0	0	1	1.0
参谋长	0	0	1	1	1.0
参谋	0	0	1	1	1.0
参观	0	0	1	1	1.0
参数	1	0	0	1	1.0
参战	1	0	0	1	1.0
参加考试	0	0	1	1	1.0
参与感	1	0	0	1	1.0
县道	1	0	0	1	1.0
县区	1	0	0	1	1.0
去过	1	0	0	1	1.0
去世	0	0	1	1	1.0
厮	1	0	0	1	1.0
厨师	1	0	0	1	1.0
厦门岛	0	0	1	1	1.0
厦	1	0	0	1	1.0
原配	0	0	1	1	1.0
原著	1	0	0	1	1.0
原生态	0	1	0	1	1.0
原汁原味	0	1	0	1	1.0
原汁	0	1	0	1	1.0
原形	0	1	0	1	1.0
原封	0	1	0	1	1.0
原型机	0	0	1	1	1.0
原型	0	0	1	1	1.0
原味	0	1	0	1	1.0
原名	0	0	1	1	1.0
原则性	1	0	0	1	1.0
原则	1	0	0	1	1.0
原住民	0	1	0	1	1.0
厚道	1	0	0	1	1.0
厚脸皮	0	1	0	1	1.0
厚脸	0	1	0	1	1.0
厌恶	0	1	0	1	1.0
压迫	0	1	0	1	1.0
压舱	1	0	0	1	1.0
压榨	0	1	0	1	1.0
压抑	0	1	0	1	1.0
压感	0	1	0	1	1.0
压惊	0	1	0	1	1.0
压低	0	1	0	1	1.0
厉行	0	1	0	1	1.0
历史性	1	0	0	1	1.0
历代	0	1	0	1	1.0
厅	0	0	1	1	1.0
厂矿	1	0	0	1	1.0
厂	0	0	1	1	1.0
卿	0	0	1	1	1.0
卸责任	0	1	0	1	1.0
卸责	0	1	0	1	1.0
卸甲	0	1	0	1	1.0
卷土重来	0	1	0	1	1.0
卵管	0	0	1	1	1.0
却说	0	1	0	1	1.0
即墨	1	0	0	1	1.0
即告	0	0	1	1	1.0
即刻起	0	1	0	1	1.0
即刻	0	1	0	1	1.0
危险性	0	1	0	1	1.0
危及	1	0	0	1	1.0
印证	1	0	0	1	1.0
印第安人	1	0	0	1	1.0
印第安	1	0	0	1	1.0
印	0	1	0	1	1.0
卫队	0	0	1	1	1.0
卫生院	0	0	1	1	1.0
卫生间	0	0	1	1	1.0
卫生部	0	1	0	1	1.0
卫士	1	0	0	1	1.0
卫国战争	1	0	0	1	1.0
卢瑟	0	1	0	1	1.0
卢	0	0	1	1	1.0
卡菲	1	0	0	1	1.0
卡死	0	1	0	1	1.0
卡斯皮	0	0	1	1	1.0
卡斯	0	0	1	1	1.0
卡拉	0	0	1	1	1.0
卡扎菲	0	1	0	1	1.0
卡塔尔	0	0	1	1	1.0
卡塔	0	0	1	1	1.0
卡住	0	1	0	1	1.0
占多数	0	1	0	1	1.0
博鳌	0	0	1	1	1.0
博物馆	0	1	0	1	1.0
博物	0	1	0	1	1.0
博大	1	0	0	1	1.0
博士	0	1	0	1	1.0
博基尼	0	0	1	1	1.0
南非	0	1	0	1	1.0
南部	0	1	0	1	1.0
南通	1	0	0	1	1.0
南路	0	0	1	1	1.0
南萨哈林斯克	0	0	1	1	1.0
南来北往	0	0	1	1	1.0
南来	0	0	1	1	1.0
南昌市	0	1	0	1	1.0
南宁	0	1	0	1	1.0
南区	1	0	0	1	1.0
南侧	0	1	0	1	1.0
南京城	0	1	0	1	1.0
南亚地区	0	0	1	1	1.0
南亚	0	0	1	1	1.0
南	1	0	0	1	1.0
卖钱	0	1	0	1	1.0
卖点	0	0	1	1	1.0
卖掉	0	0	1	1	1.0
卖家	0	0	1	1	1.0
卖场	0	0	1	1	1.0
卖国贼	0	1	0	1	1.0
卖国	0	1	0	1	1.0
卖出	0	0	1	1	1.0
卖光	0	0	1	1	1.0
单调	0	0	1	1	1.0
单行道	0	0	1	1	1.0
单行	0	0	1	1	1.0
单极	1	0	0	1	1.0
单式	1	0	0	1	1.0
单名	0	1	0	1	1.0
单县	1	0	0	1	1.0
单体	0	1	0	1	1.0
单一	1	0	0	1	1.0
协调员	1	0	0	1	1.0
协处理器	0	0	1	1	1.0
协商	0	0	1	1	1.0
华语	0	0	1	1	1.0
华强北	0	1	0	1	1.0
华尔街日报	0	0	1	1	1.0
华尔街	0	0	1	1	1.0
华大使	1	0	0	1	1.0
华夏	1	0	0	1	1.0
华侨	1	0	0	1	1.0
华人华侨	1	0	0	1	1.0
半醒	0	1	0	1	1.0
半睡半醒	0	1	0	1	1.0
半生不熟	0	1	0	1	1.0
半生	0	1	0	1	1.0
半点	0	0	1	1	1.0
半数	0	1	0	1	1.0
半年前	1	0	0	1	1.0
半左右	0	0	1	1	1.0
半岛	0	1	0	1	1.0
半岁	1	0	0	1	1.0
半小时	0	0	1	1	1.0
半天	0	1	0	1	1.0
半儿	0	0	1	1	1.0
半个世纪	1	0	0	1	1.0
午饭	1	0	0	1	1.0
午餐	1	0	0	1	1.0
午夜	1	0	0	1	1.0
午	1	0	0	1	1.0
升迁	0	1	0	1	1.0
升起	1	0	0	1	1.0
升到	0	1	0	1	1.0
千门	1	0	0	1	1.0
千遍	0	1	0	1	1.0
千篇一律	1	0	0	1	1.0
千篇	1	0	0	1	1.0
千百遍	0	1	0	1	1.0
千百年	0	0	1	1	1.0
千家	1	0	0	1	1.0
千头万绪	1	0	0	1	1.0
千头	1	0	0	1	1.0
千块	1	0	0	1	1.0
千万头	0	1	0	1	1.0
十颗	0	1	0	1	1.0
十面	0	1	0	1	1.0
十米	0	0	1	1	1.0
十来天	0	0	1	1	1.0
十来	0	0	1	1	1.0
十月	0	0	1	1	1.0
十年代	0	0	1	1	1.0
十封信	1	0	0	1	1.0
十封	1	0	0	1	1.0
十字路口	0	0	1	1	1.0
十字路	0	0	1	1	1.0
十多岁	0	1	0	1	1.0
十多分钟	0	1	0	1	1.0
十多分	0	1	0	1	1.0
十多个	1	0	0	1	1.0
十多万元	0	0	1	1	1.0
十四	1	0	0	1	1.0
十分钟	1	0	0	1	1.0
十几里	1	0	0	1	1.0
十几天	1	0	0	1	1.0
十几万	0	0	1	1	1.0
十八天	0	0	1	1	1.0
十元	0	0	1	1	1.0
十五年	1	0	0	1	1.0
十五天	0	1	0	1	1.0
十五六岁	1	0	0	1	1.0
十五六	1	0	0	1	1.0
十个月	1	0	0	1	1.0
十三幺	1	0	0	1	1.0
十万元	0	1	0	1	1.0
十一楼	1	0	0	1	1.0
十一月	0	0	1	1	1.0
匿名	0	0	1	1	1.0
医药	0	0	1	1	1.0
医病	1	0	0	1	1.0
医疗保险	1	0	0	1	1.0
医护人员	0	0	1	1	1.0
医护	0	0	1	1	1.0
医患	0	1	0	1	1.0
医	0	1	0	1	1.0
区域性	0	0	1	1	1.0
区别对待	1	0	0	1	1.0
区内	0	1	0	1	1.0
匹夫	1	0	0	1	1.0
匪	1	0	0	1	1.0
北风	0	0	1	1	1.0
北非	1	0	0	1	1.0
北青报	0	0	1	1	1.0
北疆	0	0	1	1	1.0
北地	1	0	0	1	1.0
北国	1	0	0	1	1.0
北京大学法学院	0	0	1	1	1.0
北京大学	0	0	1	1	1.0
北上	0	1	0	1	1.0
化装	0	0	1	1	1.0
化碳	0	1	0	1	1.0
化氮	0	1	0	1	1.0
化工厂	1	0	0	1	1.0
化工	1	0	0	1	1.0
化州	0	1	0	1	1.0
化学物质	0	1	0	1	1.0
化学	0	1	0	1	1.0
化妆品	0	1	0	1	1.0
化妆	0	1	0	1	1.0
匆匆	0	0	1	1	1.0
包车	0	0	1	1	1.0
包装盒	0	0	1	1	1.0
包袱	0	1	0	1	1.0
包庇	1	0	0	1	1.0
包围	0	0	1	1	1.0
勾连	0	1	0	1	1.0
勾当	1	0	0	1	1.0
勤政	0	1	0	1	1.0
勤劳勇敢	1	0	0	1	1.0
勤俭节约	0	1	0	1	1.0
勤俭	0	1	0	1	1.0
勤	1	0	0	1	1.0
勒索	1	0	0	1	1.0
勋	1	0	0	1	1.0
勇斗	1	0	0	1	1.0
勇于	0	1	0	1	1.0
势	0	0	1	1	1.0
劳资	0	1	0	1	1.0
劳动就业	0	1	0	1	1.0
劳作	0	1	0	1	1.0
助纣为虐	0	0	1	1	1.0
助力	0	1	0	1	1.0
动物园	1	0	0	1	1.0
动物	1	0	0	1	1.0
动漫	1	0	0	1	1.0
动武	1	0	0	1	1.0
动机	0	0	1	1	1.0
动态	1	0	0	1	1.0
动员	1	0	0	1	1.0
动动	1	0	0	1	1.0
劣根性	0	1	0	1	1.0
劣根	0	1	0	1	1.0
务必	1	0	0	1	1.0
务工人员	0	0	1	1	1.0
务工	0	0	1	1	1.0
务实	1	0	0	1	1.0
加鞭	0	1	0	1	1.0
加速	0	0	1	1	1.0
加考	0	0	1	1	1.0
加紧	0	1	0	1	1.0
加盟店	0	0	1	1	1.0
加班	1	0	0	1	1.0
加点	0	1	0	1	1.0
加深	1	0	0	1	1.0
加收	0	1	0	1	1.0
加工业	0	0	1	1	1.0
加工	0	0	1	1	1.0
加增	0	1	0	1	1.0
加价	0	0	1	1	1.0
加以解决	0	0	1	1	1.0
加于	1	0	0	1	1.0
功课	1	0	0	1	1.0
功德	0	1	0	1	1.0
功利	1	0	0	1	1.0
办证	0	1	0	1	1.0
办校	0	1	0	1	1.0
办事效率	0	1	0	1	1.0
办事处	1	0	0	1	1.0
劝告	0	1	0	1	1.0
力道	0	0	1	1	1.0
力行	0	1	0	1	1.0
力荐	1	0	0	1	1.0
力所能及	0	1	0	1	1.0
力争	0	1	0	1	1.0
割	0	1	0	1	1.0
副职	0	0	1	1	1.0
副外长	1	0	0	1	1.0
副作用	1	0	0	1	1.0
剪影	1	0	0	1	1.0
剪	1	0	0	1	1.0
剧痛	1	0	0	1	1.0
剧烈	0	1	0	1	1.0
剖宫产	1	0	0	1	1.0
前路	1	0	0	1	1.0
前言	0	0	1	1	1.0
前脚	0	1	0	1	1.0
前沿	0	0	1	1	1.0
前期	0	1	0	1	1.0
前方	0	0	1	1	1.0
前所未有	1	0	0	1	1.0
前所	1	0	0	1	1.0
前往	0	0	1	1	1.0
前奏	0	0	1	1	1.0
前夕	1	0	0	1	1.0
前台	0	1	0	1	1.0
前卫	0	1	0	1	1.0
前几日	0	1	0	1	1.0
前任	1	0	0	1	1.0
前代	0	1	0	1	1.0
前些年	0	1	0	1	1.0
前些	0	1	0	1	1.0
前为	1	0	0	1	1.0
前不久	0	1	0	1	1.0
削弱	0	0	1	1	1.0
削减	0	1	0	1	1.0
刻意	1	0	0	1	1.0
刻	0	1	0	1	1.0
刺耳	1	0	0	1	1.0
刺眼	1	0	0	1	1.0
刺伤	0	1	0	1	1.0
刺	0	1	0	1	1.0
刹时	1	0	0	1	1.0
刹	1	0	0	1	1.0
刷牙	1	0	0	1	1.0
制造矛盾	0	1	0	1	1.0
制造事端	1	0	0	1	1.0
制造业	0	0	1	1	1.0
制衡	1	0	0	1	1.0
制版	0	1	0	1	1.0
制止	1	0	0	1	1.0
制服	1	0	0	1	1.0
制动	0	1	0	1	1.0
制作方法	0	0	1	1	1.0
制作方	0	0	1	1	1.0
到头来	1	0	0	1	1.0
到处跑	1	0	0	1	1.0
刮风下雨	0	1	0	1	1.0
刮风	0	1	0	1	1.0
刮	1	0	0	1	1.0
别理	1	0	0	1	1.0
别样	1	0	0	1	1.0
别有用心	1	0	0	1	1.0
别国	1	0	0	1	1.0
别以为	1	0	0	1	1.0
别个	1	0	0	1	1.0
利空	0	0	1	1	1.0
利益集团	1	0	0	1	1.0
利益者	0	0	1	1	1.0
利益冲突	0	0	1	1	1.0
利民	1	0	0	1	1.0
利是	0	1	0	1	1.0
利弊	0	1	0	1	1.0
利好	0	0	1	1	1.0
利多	0	1	0	1	1.0
利亚人	0	0	1	1	1.0
删	1	0	0	1	1.0
初现	1	0	0	1	1.0
初恋	0	1	0	1	1.0
初心	1	0	0	1	1.0
初四	0	1	0	1	1.0
初十	0	0	1	1	1.0
初六	1	0	0	1	1.0
初体验	1	0	0	1	1.0
初七	1	0	0	1	1.0
创卫	1	0	0	1	1.0
刚过去	1	0	0	1	1.0
刚来	1	0	0	1	1.0
列车	0	1	0	1	1.0
列表	0	1	0	1	1.0
列入	0	0	1	1	1.0
列	1	0	0	1	1.0
刊物	1	0	0	1	1.0
切齿	0	1	0	1	1.0
切身感受	1	0	0	1	1.0
切身	1	0	0	1	1.0
切腹	1	0	0	1	1.0
切断	1	0	0	1	1.0
切掉	0	1	0	1	1.0
切换	0	0	1	1	1.0
切利	0	1	0	1	1.0
切	0	0	1	1	1.0
分队	1	0	0	1	1.0
分钱	1	0	0	1	1.0
分配	0	0	1	1	1.0
分辩	0	1	0	1	1.0
分身乏术	0	0	1	1	1.0
分身	0	0	1	1	1.0
分走	1	0	0	1	1.0
分说	0	1	0	1	1.0
分级	0	1	0	1	1.0
分类	0	1	0	1	1.0
分离	1	0	0	1	1.0
分泌	0	0	1	1	1.0
分明	0	0	1	1	1.0
分开	1	0	0	1	1.0
分崩离析	1	0	0	1	1.0
分局	0	0	1	1	1.0
分场	0	1	0	1	1.0
分合	0	1	0	1	1.0
分化	1	0	0	1	1.0
分分合合	0	1	0	1	1.0
分分	0	1	0	1	1.0
分不清楚	0	1	0	1	1.0
分不清	0	1	0	1	1.0
分不开	1	0	0	1	1.0
刁民	0	1	0	1	1.0
刁	1	0	0	1	1.0
刀笔	0	1	0	1	1.0
刀子	0	1	0	1	1.0
刀口	0	1	0	1	1.0
刀具厂	0	1	0	1	1.0
刀	0	1	0	1	1.0
击毙	1	0	0	1	1.0
击毁	0	1	0	1	1.0
出阵	1	0	0	1	1.0
出门在外	0	1	0	1	1.0
出钱	0	1	0	1	1.0
出自	1	0	0	1	1.0
出租车	0	1	0	1	1.0
出租	0	1	0	1	1.0
出生日期	1	0	0	1	1.0
出版社	1	0	0	1	1.0
出版	1	0	0	1	1.0
出点	0	1	0	1	1.0
出游	0	1	0	1	1.0
出海	1	0	0	1	1.0
出奇	0	0	1	1	1.0
出头	0	0	1	1	1.0
出声	0	1	0	1	1.0
出卖	0	0	1	1	1.0
出勤	0	1	0	1	1.0
出关	0	1	0	1	1.0
出入口	0	0	1	1	1.0
出入	0	0	1	1	1.0
出众	1	0	0	1	1.0
出事	0	0	1	1	1.0
出世	0	1	0	1	1.0
凸显出	0	1	0	1	1.0
凸出	1	0	0	1	1.0
凶器	0	1	0	1	1.0
凭良心	1	0	0	1	1.0
凡	1	0	0	1	1.0
几里	1	0	0	1	1.0
几秒钟	0	0	1	1	1.0
几秒	0	0	1	1	1.0
几百米	1	0	0	1	1.0
几百万	0	0	1	1	1.0
几率	1	0	0	1	1.0
几架	0	1	0	1	1.0
几月	1	0	0	1	1.0
几无二致	1	0	0	1	1.0
几座	0	0	1	1	1.0
几处	0	1	0	1	1.0
几台	1	0	0	1	1.0
几十米	0	0	1	1	1.0
几十年	0	0	1	1	1.0
几十元	0	0	1	1	1.0
几十个	0	1	0	1	1.0
几何	1	0	0	1	1.0
几亿	1	0	0	1	1.0
几万块	1	0	0	1	1.0
凛凛	0	1	0	1	1.0
凑	0	1	0	1	1.0
减速	1	0	0	1	1.0
减肥	1	0	0	1	1.0
减弱	1	0	0	1	1.0
减压	1	0	0	1	1.0
准谱	0	1	0	1	1.0
准确无误	0	1	0	1	1.0
准确	0	1	0	1	1.0
准生证	0	0	1	1	1.0
准时	0	0	1	1	1.0
凄惨	0	1	0	1	1.0
净空	0	0	1	1	1.0
净	0	1	0	1	1.0
冷静	0	1	0	1	1.0
冷色调	1	0	0	1	1.0
冷色	1	0	0	1	1.0
冷空气	0	1	0	1	1.0
冷清	0	1	0	1	1.0
冷淡	0	1	0	1	1.0
冷汗	0	0	1	1	1.0
冷战	1	0	0	1	1.0
冷寂	0	0	1	1	1.0
冷嘲热讽	0	0	1	1	1.0
冷嘲	0	0	1	1	1.0
冷不丁	1	0	0	1	1.0
决议	0	1	0	1	1.0
决裂	1	0	0	1	1.0
决策层	0	0	1	1	1.0
决定性	0	1	0	1	1.0
决不	0	1	0	1	1.0
决一死战	0	1	0	1	1.0
冲过来	1	0	0	1	1.0
冲过	1	0	0	1	1.0
冰鞋	0	0	1	1	1.0
冰雪	1	0	0	1	1.0
冰凉	0	0	1	1	1.0
冰	0	0	1	1	1.0
冬天	0	1	0	1	1.0
冥冥之中	0	0	1	1	1.0
冥冥	0	0	1	1	1.0
冥	0	1	0	1	1.0
冤案	0	1	0	1	1.0
冤枉	1	0	0	1	1.0
冤冤相报	0	1	0	1	1.0
冠冕堂皇	0	1	0	1	1.0
冠冕	0	1	0	1	1.0
农家院	1	0	0	1	1.0
农家	1	0	0	1	1.0
农	0	1	0	1	1.0
军费	1	0	0	1	1.0
军舰	1	0	0	1	1.0
军旗	1	0	0	1	1.0
军方	0	1	0	1	1.0
军官	1	0	0	1	1.0
军力	1	0	0	1	1.0
军事行动	1	0	0	1	1.0
军中	1	0	0	1	1.0
写道	0	0	1	1	1.0
写给	1	0	0	1	1.0
写到	0	0	1	1	1.0
写信	1	0	0	1	1.0
写下	0	0	1	1	1.0
冒险	0	0	1	1	1.0
再现	0	1	0	1	1.0
再多	0	1	0	1	1.0
内部矛盾	1	0	0	1	1.0
内部测试	0	0	1	1	1.0
内衣	0	0	1	1	1.0
内环	1	0	0	1	1.0
内忧外患	1	0	0	1	1.0
内忧	1	0	0	1	1.0
内心	1	0	0	1	1.0
内幕	0	0	1	1	1.0
内向	1	0	0	1	1.0
内分泌	0	0	1	1	1.0
内分	0	0	1	1	1.0
兽	0	0	1	1	1.0
兼职	0	0	1	1	1.0
兼得	1	0	0	1	1.0
兼具	1	0	0	1	1.0
养育之恩	1	0	0	1	1.0
养老金	0	1	0	1	1.0
养生	1	0	0	1	1.0
养父母	0	1	0	1	1.0
养父	0	1	0	1	1.0
养家糊口	0	1	0	1	1.0
养家	0	1	0	1	1.0
养大	0	1	0	1	1.0
养分	0	0	1	1	1.0
养儿防老	1	0	0	1	1.0
养下来	0	1	0	1	1.0
典范	1	0	0	1	1.0
典礼	1	0	0	1	1.0
具备	0	0	1	1	1.0
具	0	1	0	1	1.0
其妻	1	0	0	1	1.0
其余	0	0	1	1	1.0
其他费用	1	0	0	1	1.0
其他同学	0	0	1	1	1.0
其事	1	0	0	1	1.0
兵马未动	0	1	0	1	1.0
兵马	0	1	0	1	1.0
兵团	1	0	0	1	1.0
兵	0	1	0	1	1.0
兴起	1	0	0	1	1.0
兴许	0	1	0	1	1.0
兴师问罪	0	1	0	1	1.0
兴师	0	1	0	1	1.0
兴奋	1	0	0	1	1.0
关键词	0	0	1	1	1.0
关联	0	0	1	1	1.0
关机	0	0	1	1	1.0
关掉	0	1	0	1	1.0
关切	0	0	1	1	1.0
关乎	1	0	0	1	1.0
兲	0	1	0	1	1.0
共鸣	0	1	0	1	1.0
共荣圈	0	1	0	1	1.0
共约	0	0	1	1	1.0
共用	0	1	0	1	1.0
共犯	1	0	0	1	1.0
共创	0	1	0	1	1.0
共产主义	0	1	0	1	1.0
共产	0	1	0	1	1.0
共乐	0	0	1	1	1.0
兰州	0	1	0	1	1.0
兰博基尼	0	0	1	1	1.0
兰博基	0	0	1	1	1.0
兰克	0	1	0	1	1.0
六部	0	0	1	1	1.0
六岁	1	0	0	1	1.0
六个	0	0	1	1	1.0
六七十万	0	0	1	1	1.0
六七十	0	0	1	1	1.0
六七	0	0	1	1	1.0
六一	1	0	0	1	1.0
公车	0	1	0	1	1.0
公立	0	1	0	1	1.0
公牛	0	1	0	1	1.0
公款	0	1	0	1	1.0
公权	0	1	0	1	1.0
公映	1	0	0	1	1.0
公敌	1	0	0	1	1.0
公报	1	0	0	1	1.0
公家	1	0	0	1	1.0
公安分局	0	0	1	1	1.0
公园	0	0	1	1	1.0
公共秩序	1	0	0	1	1.0
公共服务	0	1	0	1	1.0
公共安全	0	0	1	1	1.0
公公	0	0	1	1	1.0
公元前	1	0	0	1	1.0
公元	1	0	0	1	1.0
公休	1	0	0	1	1.0
公交线路	0	1	0	1	1.0
公交线	0	1	0	1	1.0
公举	0	0	1	1	1.0
公主	1	0	0	1	1.0
八项	0	0	1	1	1.0
八竿子打不着	0	0	1	1	1.0
八月	0	1	0	1	1.0
八成	0	1	0	1	1.0
八天	0	0	1	1	1.0
八国联军	0	1	0	1	1.0
八国	0	1	0	1	1.0
八卦拳	1	0	0	1	1.0
八万块	0	0	1	1	1.0
八万	0	0	1	1	1.0
全面禁止	1	0	0	1	1.0
全身心	0	0	1	1	1.0
全职	0	1	0	1	1.0
全网	0	0	1	1	1.0
全线	0	0	1	1	1.0
全盘考虑	0	1	0	1	1.0
全盘	0	1	0	1	1.0
全球华语	0	0	1	1	1.0
全球华人	0	0	1	1	1.0
全文	0	1	0	1	1.0
全攻略	1	0	0	1	1.0
全攻	1	0	0	1	1.0
全场	1	0	0	1	1.0
全县	0	1	0	1	1.0
全免	0	1	0	1	1.0
全体	1	0	0	1	1.0
全会	1	0	0	1	1.0
入货	0	1	0	1	1.0
入网	0	0	1	1	1.0
入眠	0	0	1	1	1.0
入狱	0	0	1	1	1.0
入学	0	1	0	1	1.0
入境	1	0	0	1	1.0
入场	0	0	1	1	1.0
入土	0	0	1	1	1.0
入口	0	0	1	1	1.0
入冬	0	0	1	1	1.0
入侵	1	0	0	1	1.0
入伙	0	0	1	1	1.0
兜售	0	0	1	1	1.0
党派	0	1	0	1	1.0
党和国家	1	0	0	1	1.0
党专政	0	1	0	1	1.0
兔子	0	1	0	1	1.0
免试	0	1	0	1	1.0
免得	0	1	0	1	1.0
免	0	1	0	1	1.0
克里米亚	0	1	0	1	1.0
克里姆林宫	1	0	0	1	1.0
克里姆林	1	0	0	1	1.0
克里姆	1	0	0	1	1.0
克制	0	1	0	1	1.0
光鲜	0	1	0	1	1.0
光辉	1	0	0	1	1.0
光说不练	1	0	0	1	1.0
光线	0	1	0	1	1.0
光环	0	1	0	1	1.0
光明网	0	1	0	1	1.0
光大	1	0	0	1	1.0
先锋	1	0	0	1	1.0
先进	1	0	0	1	1.0
先祖	1	0	0	1	1.0
先查	1	0	0	1	1.0
先头	0	1	0	1	1.0
先后	0	0	1	1	1.0
先前	1	0	0	1	1.0
先人	0	1	0	1	1.0
先于	0	1	0	1	1.0
充足	0	0	1	1	1.0
充好	0	1	0	1	1.0
充分说明	0	1	0	1	1.0
充分考虑	0	1	0	1	1.0
充值	1	0	0	1	1.0
元月	0	1	0	1	1.0
元日	0	0	1	1	1.0
元宵夜	0	1	0	1	1.0
兀	0	1	0	1	1.0
儿童节	1	0	0	1	1.0
儿童医院	0	0	1	1	1.0
儿科	0	1	0	1	1.0
儿孙	1	0	0	1	1.0
儒教	0	1	0	1	1.0
儒家	0	0	1	1	1.0
儋州	0	0	1	1	1.0
僧	0	0	1	1	1.0
僚机	0	1	0	1	1.0
催动	1	0	0	1	1.0
催促	0	1	0	1	1.0
储存	0	1	0	1	1.0
储备	1	0	0	1	1.0
傍晚	1	0	0	1	1.0
傀儡政权	0	1	0	1	1.0
傀儡	0	1	0	1	1.0
偷着乐	1	0	0	1	1.0
偷拿	0	0	1	1	1.0
偷懒	1	0	0	1	1.0
偷情	0	1	0	1	1.0
偷到	0	0	1	1	1.0
偶遇	0	0	1	1	1.0
健在	0	1	0	1	1.0
健全	0	1	0	1	1.0
健健康康	0	0	1	1	1.0
健	1	0	0	1	1.0
停诊	0	1	0	1	1.0
停火协议	0	1	0	1	1.0
停滞	0	0	1	1	1.0
停放	0	1	0	1	1.0
停办	0	1	0	1	1.0
做文章	1	0	0	1	1.0
做掉	0	0	1	1	1.0
做客	1	0	0	1	1.0
做做	1	0	0	1	1.0
做一套	0	1	0	1	1.0
偏见	0	0	1	1	1.0
偏要	0	0	1	1	1.0
偏爱	1	0	0	1	1.0
偌大	0	1	0	1	1.0
假话	1	0	0	1	1.0
假设	0	1	0	1	1.0
假日酒店	0	0	1	1	1.0
假冒	0	0	1	1	1.0
值钱	0	0	1	1	1.0
值班员	1	0	0	1	1.0
值得注意	0	0	1	1	1.0
值得尊重	0	1	0	1	1.0
值得一提的是	1	0	0	1	1.0
值得一提	1	0	0	1	1.0
值不值得	0	0	1	1	1.0
债	1	0	0	1	1.0
倡议书	0	1	0	1	1.0
借钱	1	0	0	1	1.0
借此	0	0	1	1	1.0
倒霉事	0	1	0	1	1.0
倒霉	0	1	0	1	1.0
倒计时	1	0	0	1	1.0
倒计	1	0	0	1	1.0
倒数	0	0	1	1	1.0
倒把	0	0	1	1	1.0
倒好	1	0	0	1	1.0
倍增	0	1	0	1	1.0
俱往	0	0	1	1	1.0
俱全	1	0	0	1	1.0
俱	0	0	1	1	1.0
修车	0	1	0	1	1.0
修路	0	0	1	1	1.0
修订	0	0	1	1	1.0
修正案	0	1	0	1	1.0
修正	0	1	0	1	1.0
信阳	1	0	0	1	1.0
信贷	1	0	0	1	1.0
信用度	0	1	0	1	1.0
信用	0	1	0	1	1.0
信教	1	0	0	1	1.0
信号	0	1	0	1	1.0
信不信	1	0	0	1	1.0
保险金	0	0	1	1	1.0
保险公司	0	0	1	1	1.0
保镖	0	0	1	1	1.0
保质期	0	0	1	1	1.0
保质	0	0	1	1	1.0
保证书	0	0	1	1	1.0
保留节目	0	0	1	1	1.0
保洁	0	1	0	1	1.0
保护色	1	0	0	1	1.0
保护局	0	0	1	1	1.0
保平安	1	0	0	1	1.0
保平	1	0	0	1	1.0
保家卫国	0	0	1	1	1.0
保家	0	0	1	1	1.0
保守思想	0	1	0	1	1.0
保存	0	1	0	1	1.0
保健	1	0	0	1	1.0
保修	0	0	1	1	1.0
保佑	0	0	1	1	1.0
保住	1	0	0	1	1.0
俗话说	0	0	1	1	1.0
俗话	0	0	1	1	1.0
俗化	0	1	0	1	1.0
俄罗斯外交部	1	0	0	1	1.0
俄总统	1	0	0	1	1.0
俄国人	0	1	0	1	1.0
促销	0	1	0	1	1.0
便民	0	0	1	1	1.0
便携性	1	0	0	1	1.0
便捷	0	0	1	1	1.0
侵占	0	1	0	1	1.0
侵入	1	0	0	1	1.0
侵	1	0	0	1	1.0
侯赛因	0	1	0	1	1.0
侨报	1	0	0	1	1.0
侧面	1	0	0	1	1.0
侧击	0	0	1	1	1.0
侧	0	1	0	1	1.0
侦察	0	1	0	1	1.0
依法行政	0	1	0	1	1.0
依托	0	1	0	1	1.0
依人	0	0	1	1	1.0
依	1	0	0	1	1.0
供暖	1	0	0	1	1.0
供奉	1	0	0	1	1.0
供参考	1	0	0	1	1.0
供养	0	1	0	1	1.0
例如	0	0	1	1	1.0
侄子	1	0	0	1	1.0
使馆	1	0	0	1	1.0
使用者	0	1	0	1	1.0
使用暴力	0	0	1	1	1.0
使命	0	1	0	1	1.0
使劲	1	0	0	1	1.0
佳音	1	0	0	1	1.0
佳肴	1	0	0	1	1.0
佳佳	1	0	0	1	1.0
佣	0	0	1	1	1.0
你追我赶	1	0	0	1	1.0
你们好	1	0	0	1	1.0
你中有我	0	1	0	1	1.0
作风	1	0	0	1	1.0
作派	0	1	0	1	1.0
作法	0	1	0	1	1.0
作案工具	1	0	0	1	1.0
作案	1	0	0	1	1.0
作揖	1	0	0	1	1.0
作息	1	0	0	1	1.0
作废	0	0	1	1	1.0
作声	1	0	0	1	1.0
作出	0	0	1	1	1.0
作假	0	1	0	1	1.0
作人	0	0	1	1	1.0
佛脚	0	1	0	1	1.0
余辆	0	0	1	1	1.0
余姚	0	1	0	1	1.0
余地	0	1	0	1	1.0
余位	1	0	0	1	1.0
余件	0	1	0	1	1.0
何罪之有	0	1	0	1	1.0
何等	1	0	0	1	1.0
何种	1	0	0	1	1.0
何用	0	1	0	1	1.0
何物	0	1	0	1	1.0
何止	0	1	0	1	1.0
何来	0	1	0	1	1.0
何必	0	0	1	1	1.0
何德何能	0	1	0	1	1.0
何德何	0	1	0	1	1.0
何尝	0	1	0	1	1.0
何妨	1	0	0	1	1.0
何处	0	0	1	1	1.0
何其	0	1	0	1	1.0
何为	1	0	0	1	1.0
体育运动	0	1	0	1	1.0
体育	0	1	0	1	1.0
体积小	1	0	0	1	1.0
体制	1	0	0	1	1.0
住民	0	1	0	1	1.0
住校	0	0	1	1	1.0
低阶	0	1	0	1	1.0
低速	1	0	0	1	1.0
低迷	0	0	1	1	1.0
低调	1	0	0	1	1.0
低等	0	1	0	1	1.0
低电量	1	0	0	1	1.0
低廉	1	0	0	1	1.0
低劣	1	0	0	1	1.0
低位	1	0	0	1	1.0
低价	0	0	1	1	1.0
伺候	0	1	0	1	1.0
估摸	1	0	0	1	1.0
估估	0	1	0	1	1.0
伯	1	0	0	1	1.0
伪满州国	0	1	0	1	1.0
伪满	0	1	0	1	1.0
伦西亚	1	0	0	1	1.0
伦理	0	0	1	1	1.0
伦次	1	0	0	1	1.0
伤财	0	1	0	1	1.0
伤脑筋	1	0	0	1	1.0
伤者	0	0	1	1	1.0
伤痕累累	0	1	0	1	1.0
伤痕	0	1	0	1	1.0
伤情	0	0	1	1	1.0
伤口	1	0	0	1	1.0
伤力	1	0	0	1	1.0
伤到	0	1	0	1	1.0
伤人	0	1	0	1	1.0
伤亡事故	1	0	0	1	1.0
传闻	0	0	1	1	1.0
传递	1	0	0	1	1.0
传统节目	1	0	0	1	1.0
传统武术	1	0	0	1	1.0
传统意义	1	0	0	1	1.0
传染	1	0	0	1	1.0
传来	1	0	0	1	1.0
传教士	0	0	1	1	1.0
传教	0	0	1	1	1.0
传出	0	0	1	1	1.0
传下来	1	0	0	1	1.0
传下	1	0	0	1	1.0
伞	0	0	1	1	1.0
会馆	1	0	0	1	1.0
会面	0	1	0	1	1.0
会长	0	1	0	1	1.0
会计学院	1	0	0	1	1.0
会计学	1	0	0	1	1.0
会计	1	0	0	1	1.0
会主	0	1	0	1	1.0
伙食	0	0	1	1	1.0
优越感	1	0	0	1	1.0
优越	1	0	0	1	1.0
优质	0	0	1	1	1.0
优美	0	1	0	1	1.0
优惠政策	0	1	0	1	1.0
优惠	0	1	0	1	1.0
优异	0	0	1	1	1.0
优化	0	0	1	1	1.0
优劣	1	0	0	1	1.0
优于	1	0	0	1	1.0
众所周知	1	0	0	1	1.0
众口难调	1	0	0	1	1.0
众口	1	0	0	1	1.0
众人	0	1	0	1	1.0
伏羲女娲	1	0	0	1	1.0
伏羲	1	0	0	1	1.0
伎俩	0	1	0	1	1.0
伊玛目	1	0	0	1	1.0
伊玛	1	0	0	1	1.0
伊戈尔	1	0	0	1	1.0
仿	0	1	0	1	1.0
份儿	0	1	0	1	1.0
份	0	1	0	1	1.0
任何一方	0	0	1	1	1.0
价廉物美	0	0	1	1	1.0
价廉	0	0	1	1	1.0
仪式	0	1	0	1	1.0
仪器	1	0	0	1	1.0
以防	0	1	0	1	1.0
以色列	1	0	0	1	1.0
以至于	0	0	1	1	1.0
以至	0	0	1	1	1.0
以此	0	0	1	1	1.0
以待	0	1	0	1	1.0
以备	0	1	0	1	1.0
以免	0	1	0	1	1.0
以人为本	0	1	0	1	1.0
以下内容	0	0	1	1	1.0
令箭	0	1	0	1	1.0
令人满意	0	1	0	1	1.0
令人堪忧	0	1	0	1	1.0
代言	0	1	0	1	1.0
代理人	1	0	0	1	1.0
代理	1	0	0	1	1.0
代名词	1	0	0	1	1.0
代名	1	0	0	1	1.0
付出代价	0	0	1	1	1.0
他家	1	0	0	1	1.0
仓促	1	0	0	1	1.0
仓	0	1	0	1	1.0
从而	0	1	0	1	1.0
从此以后	1	0	0	1	1.0
从来不	0	1	0	1	1.0
从古到今	0	1	0	1	1.0
从今年起	0	1	0	1	1.0
从今天起	0	1	0	1	1.0
从严	0	0	1	1	1.0
从业人员	0	0	1	1	1.0
从业	0	0	1	1	1.0
从不	1	0	0	1	1.0
仍旧	1	0	0	1	1.0
介意	1	0	0	1	1.0
介	0	1	0	1	1.0
今非昔比	0	0	1	1	1.0
今春	0	1	0	1	1.0
今天下午	0	0	1	1	1.0
今夜	1	0	0	1	1.0
今冬	0	1	0	1	1.0
仇敌	0	1	0	1	1.0
仅限	0	0	1	1	1.0
仅次于	1	0	0	1	1.0
仁义之师	0	1	0	1	1.0
亿美金	0	1	0	1	1.0
人间	0	1	0	1	1.0
人道主义	0	1	0	1	1.0
人道	0	1	0	1	1.0
人贩子	0	1	0	1	1.0
人类文明	1	0	0	1	1.0
人眼	0	1	0	1	1.0
人皮	0	0	1	1	1.0
人生哲理	1	0	0	1	1.0
人物	0	0	1	1	1.0
人满为患	0	1	0	1	1.0
人流	0	0	1	1	1.0
人气	0	1	0	1	1.0
人民阵线	0	1	0	1	1.0
人民网	0	0	1	1	1.0
人民政府	0	1	0	1	1.0
人意	0	1	0	1	1.0
人影	1	0	0	1	1.0
人大	0	0	1	1	1.0
人均	0	1	0	1	1.0
人命	0	1	0	1	1.0
人员伤亡	0	0	1	1	1.0
人口普查	1	0	0	1	1.0
人口减少	0	1	0	1	1.0
人力物力	0	1	0	1	1.0
人人有责	0	1	0	1	1.0
人云亦云	1	0	0	1	1.0
人云	1	0	0	1	1.0
人事	0	0	1	1	1.0
人为因素	0	1	0	1	1.0
亵渎	1	0	0	1	1.0
亲近	0	1	0	1	1.0
亲身经历	1	0	0	1	1.0
亲自	0	1	0	1	1.0
亲爹	0	1	0	1	1.0
亲手	1	0	0	1	1.0
亲戚朋友	1	0	0	1	1.0
亲密关系	1	0	0	1	1.0
亲密	1	0	0	1	1.0
亲吻	0	1	0	1	1.0
亲口	1	0	0	1	1.0
亲友	1	0	0	1	1.0
亲历	1	0	0	1	1.0
亲切	1	0	0	1	1.0
亮起	0	1	0	1	1.0
亮相	1	0	0	1	1.0
京城	0	1	0	1	1.0
产道	0	0	1	1	1.0
产能	0	0	1	1	1.0
产房	1	0	0	1	1.0
产品质量	0	0	1	1	1.0
产前	1	0	0	1	1.0
产业链	0	0	1	1	1.0
产下	0	0	1	1	1.0
亦可覆舟	0	1	0	1	1.0
亦可	0	1	0	1	1.0
交集	0	0	1	1	1.0
交际	1	0	0	1	1.0
交钱	0	1	0	1	1.0
交通拥堵	0	1	0	1	1.0
交通广播	0	0	1	1	1.0
交通委	0	0	1	1	1.0
交警大队	0	0	1	1	1.0
交管部门	0	1	0	1	1.0
交火	0	0	1	1	1.0
交流	0	1	0	1	1.0
交替	0	1	0	1	1.0
交换	1	0	0	1	1.0
交响曲	1	0	0	1	1.0
交响	1	0	0	1	1.0
交出	0	0	1	1	1.0
亡国	0	1	0	1	1.0
亡	0	1	0	1	1.0
亚心	1	0	0	1	1.0
亚尔	1	0	0	1	1.0
亚太	1	0	0	1	1.0
亚丁	0	1	0	1	1.0
亚	1	0	0	1	1.0
井	1	0	0	1	1.0
五路	0	1	0	1	1.0
五角大楼	0	0	1	1	1.0
五角	0	0	1	1	1.0
五胎	0	1	0	1	1.0
五米	1	0	0	1	1.0
五百	0	1	0	1	1.0
五湖四海	1	0	0	1	1.0
五湖	1	0	0	1	1.0
五晚	0	0	1	1	1.0
五星	0	1	0	1	1.0
五彩缤纷	1	0	0	1	1.0
五彩	1	0	0	1	1.0
五常	1	0	0	1	1.0
五天	0	1	0	1	1.0
五分	0	1	0	1	1.0
五六岁	1	0	0	1	1.0
五六	1	0	0	1	1.0
五中全会	1	0	0	1	1.0
五中	1	0	0	1	1.0
五个	0	0	1	1	1.0
互惠	1	0	0	1	1.0
互信	1	0	0	1	1.0
云游	0	0	1	1	1.0
云层	1	0	0	1	1.0
亏	0	0	1	1	1.0
于洪区	0	0	1	1	1.0
于洪	0	0	1	1	1.0
于此	0	0	1	1	1.0
于未然	1	0	0	1	1.0
二道	0	0	1	1	1.0
二路	0	1	0	1	1.0
二维码	1	0	0	1	1.0
二维	1	0	0	1	1.0
二百万	0	1	0	1	1.0
二百	0	1	0	1	1.0
二男一女	0	1	0	1	1.0
二环	1	0	0	1	1.0
二氧化氮	0	1	0	1	1.0
二次世界大战	0	0	1	1	1.0
二楼	1	0	0	1	1.0
二战	0	1	0	1	1.0
二弟	1	0	0	1	1.0
二季度	0	0	1	1	1.0
二季	0	0	1	1	1.0
二奶	0	0	1	1	1.0
二女儿	0	0	1	1	1.0
二只	0	0	1	1	1.0
二十多分钟	0	1	0	1	1.0
二十多	0	1	0	1	1.0
二十分钟	1	0	0	1	1.0
二十分	1	0	0	1	1.0
二十万元	0	1	0	1	1.0
二十万	0	1	0	1	1.0
二代	1	0	0	1	1.0
二人	0	0	1	1	1.0
事端	1	0	0	1	1.0
事物	0	0	1	1	1.0
事态	1	0	0	1	1.0
事实证明	0	0	1	1	1.0
事宜	1	0	0	1	1.0
争辩	1	0	0	1	1.0
争执不下	0	1	0	1	1.0
争夺战	1	0	0	1	1.0
争夺	1	0	0	1	1.0
争	0	1	0	1	1.0
了然	0	1	0	1	1.0
了事	0	1	0	1	1.0
了不起	1	0	0	1	1.0
乱麻	1	0	0	1	1.0
乱飞	1	0	0	1	1.0
乱纪	0	1	0	1	1.0
乱搞	1	0	0	1	1.0
乱局	0	0	1	1	1.0
乱冲	0	0	1	1	1.0
乱七八糟	0	1	0	1	1.0
买起	0	1	0	1	1.0
买点	0	0	1	1	1.0
买手机	0	0	1	1	1.0
买手	0	0	1	1	1.0
买下	0	1	0	1	1.0
书写	0	1	0	1	1.0
乡间	1	0	0	1	1.0
乡镇	1	0	0	1	1.0
乡村	1	0	0	1	1.0
乡下	1	0	0	1	1.0
乞	0	0	1	1	1.0
九江	1	0	0	1	1.0
九月份	1	0	0	1	1.0
九月	1	0	0	1	1.0
九华	1	0	0	1	1.0
九十多岁	0	1	0	1	1.0
九十多	0	1	0	1	1.0
九十	0	1	0	1	1.0
乘火打劫	0	1	0	1	1.0
乘	1	0	0	1	1.0
乖巧	1	0	0	1	1.0
乖乖	0	1	0	1	1.0
乔老爷	0	1	0	1	1.0
乔帮主	0	1	0	1	1.0
乒乓	0	1	0	1	1.0
乐趣	1	0	0	1	1.0
乐器	0	1	0	1	1.0
乐事	0	0	1	1	1.0
乐乎	1	0	0	1	1.0
乐业	0	1	0	1	1.0
乐一乐	1	0	0	1	1.0
乏术	0	0	1	1	1.0
乏力	0	1	0	1	1.0
乍暖还寒	0	0	1	1	1.0
乍暖	0	0	1	1	1.0
乌龙	1	0	0	1	1.0
乌烟瘴气	0	1	0	1	1.0
乌市	0	0	1	1	1.0
乌云密布	0	0	1	1	1.0
乌云	0	0	1	1	1.0
之用	1	0	0	1	1.0
之所以	1	0	0	1	1.0
之城	0	1	0	1	1.0
之为	0	1	0	1	1.0
之上	0	0	1	1	1.0
之三	0	1	0	1	1.0
义无反顾	1	0	0	1	1.0
义愤填膺	0	0	1	1	1.0
义愤	0	0	1	1	1.0
义务教育	0	1	0	1	1.0
久违	1	0	0	1	1.0
久远	0	1	0	1	1.0
乃至	1	0	0	1	1.0
乃	1	0	0	1	1.0
举足轻重	1	0	0	1	1.0
举足	1	0	0	1	1.0
举起	0	1	0	1	1.0
丽水	0	0	1	1	1.0
丽丽	0	1	0	1	1.0
主页	0	1	0	1	1.0
主观	1	0	0	1	1.0
主编	1	0	0	1	1.0
主管	1	0	0	1	1.0
主权国家	1	0	0	1	1.0
主权国	1	0	0	1	1.0
主干道	1	0	0	1	1.0
主干	1	0	0	1	1.0
主子	1	0	0	1	1.0
主城区	0	1	0	1	1.0
主城	0	1	0	1	1.0
主办	0	1	0	1	1.0
为的是	0	0	1	1	1.0
为止	1	0	0	1	1.0
为所欲为	0	1	0	1	1.0
丹阳	1	0	0	1	1.0
丹江	0	0	1	1	1.0
临汾	1	0	0	1	1.0
串子	1	0	0	1	1.0
串亲戚	1	0	0	1	1.0
丰收	1	0	0	1	1.0
中重度	0	1	0	1	1.0
中途	0	1	0	1	1.0
中计	0	1	0	1	1.0
中老年人	0	1	0	1	1.0
中老年	0	1	0	1	1.0
中美	0	0	1	1	1.0
中策	0	0	1	1	1.0
中等	0	1	0	1	1.0
中科院	0	0	1	1	1.0
中科	0	0	1	1	1.0
中石化	1	0	0	1	1.0
中石	1	0	0	1	1.0
中牟县	0	0	1	1	1.0
中牟	0	0	1	1	1.0
中毒	1	0	0	1	1.0
中档	0	0	1	1	1.0
中旬	1	0	0	1	1.0
中方	0	0	1	1	1.0
中文网	0	1	0	1	1.0
中招	0	1	0	1	1.0
中所	0	0	1	1	1.0
中心站	0	0	1	1	1.0
中庸之道	1	0	0	1	1.0
中庸	1	0	0	1	1.0
中年	0	1	0	1	1.0
中山大道	1	0	0	1	1.0
中山	1	0	0	1	1.0
中小学生	0	1	0	1	1.0
中小学	0	1	0	1	1.0
中小	0	1	0	1	1.0
中将	0	0	1	1	1.0
中学毕业	0	1	0	1	1.0
中央电视台	0	1	0	1	1.0
中央气象台	0	1	0	1	1.0
中央台	0	1	0	1	1.0
中土	1	0	0	1	1.0
中国网民	0	1	0	1	1.0
中国空军	1	0	0	1	1.0
中国日报	1	0	0	1	1.0
中国式	0	1	0	1	1.0
中国国情	0	1	0	1	1.0
中原	1	0	0	1	1.0
中南部	0	1	0	1	1.0
中南	0	1	0	1	1.0
中华苏维埃共和国	0	1	0	1	1.0
中医院	0	1	0	1	1.0
中俄	1	0	0	1	1.0
中东部	0	1	0	1	1.0
中东地区	1	0	0	1	1.0
丫头	1	0	0	1	1.0
丫	1	0	0	1	1.0
个度	1	0	0	1	1.0
个儿	0	1	0	1	1.0
个体	0	1	0	1	1.0
个人行为	0	1	0	1	1.0
个人所有	0	1	0	1	1.0
个人信息	0	0	1	1	1.0
丨	0	0	1	1	1.0
丧心病狂	0	1	0	1	1.0
丧心	0	1	0	1	1.0
丧偶	0	0	1	1	1.0
丧事	0	1	0	1	1.0
丧	0	0	1	1	1.0
严禁	1	0	0	1	1.0
严父	1	0	0	1	1.0
严格管理	0	0	1	1	1.0
严格执行	1	0	0	1	1.0
严抓	0	1	0	1	1.0
严惩	0	1	0	1	1.0
严寒	0	1	0	1	1.0
严厉打击	1	0	0	1	1.0
两面	0	1	0	1	1.0
两难	0	0	1	1	1.0
两起	0	0	1	1	1.0
两节课	1	0	0	1	1.0
两节	1	0	0	1	1.0
两种	0	0	1	1	1.0
两百多	0	1	0	1	1.0
两百	0	1	0	1	1.0
两条腿	0	1	0	1	1.0
两日游	0	0	1	1	1.0
两日	0	0	1	1	1.0
两把	0	0	1	1	1.0
两岸三地	1	0	0	1	1.0
两岸	1	0	0	1	1.0
两套	0	1	0	1	1.0
两国关系	0	0	1	1	1.0
两国	0	0	1	1	1.0
两句话	1	0	0	1	1.0
两句	1	0	0	1	1.0
两千块	1	0	0	1	1.0
两侧	0	0	1	1	1.0
两会	1	0	0	1	1.0
两份	1	0	0	1	1.0
两件事	0	1	0	1	1.0
两件	0	1	0	1	1.0
两三倍	0	1	0	1	1.0
两三	0	1	0	1	1.0
丢饭碗	0	1	0	1	1.0
丢盔卸甲	0	1	0	1	1.0
丢掉	1	0	0	1	1.0
丢弃	1	0	0	1	1.0
丢失	1	0	0	1	1.0
丢下	1	0	0	1	1.0
丝	1	0	0	1	1.0
东风	0	1	0	1	1.0
东门	0	0	1	1	1.0
东边	0	1	0	1	1.0
东站	1	0	0	1	1.0
东突厥	1	0	0	1	1.0
东直	0	0	1	1	1.0
东湖路	1	0	0	1	1.0
东湖	1	0	0	1	1.0
东海岸	0	0	1	1	1.0
东海	0	0	1	1	1.0
东来	0	1	0	1	1.0
东征	1	0	0	1	1.0
东奔西走	1	0	0	1	1.0
东奔西	1	0	0	1	1.0
东南亚地区	0	0	1	1	1.0
东南亚	0	0	1	1	1.0
东南	0	0	1	1	1.0
东北方	1	0	0	1	1.0
东京	0	1	0	1	1.0
东三省	1	0	0	1	1.0
业界	0	1	0	1	1.0
业务	0	0	1	1	1.0
世界杯	0	0	1	1	1.0
世界各地	0	1	0	1	1.0
世博	1	0	0	1	1.0
世俗化	0	1	0	1	1.0
世俗	0	1	0	1	1.0
世代相传	1	0	0	1	1.0
世仇	0	1	0	1	1.0
世	1	0	0	1	1.0
专题	0	1	0	1	1.0
专车接送	0	1	0	1	1.0
专访	0	1	0	1	1.0
专用道	0	0	1	1	1.0
专栏	0	1	0	1	1.0
专政	0	1	0	1	1.0
专拣	1	0	0	1	1.0
专属	1	0	0	1	1.0
专家教授	0	0	1	1	1.0
专家学者	1	0	0	1	1.0
专卖店	0	0	1	1	1.0
专卖	0	0	1	1	1.0
专制	0	1	0	1	1.0
专利	0	1	0	1	1.0
专	0	1	0	1	1.0
丑化	0	1	0	1	1.0
与时俱进	0	1	0	1	1.0
与日俱增	1	0	0	1	1.0
不顺	0	1	0	1	1.0
不靠	0	1	0	1	1.0
不问	0	1	0	1	1.0
不长	0	0	1	1	1.0
不通	0	1	0	1	1.0
不适感	0	0	1	1	1.0
不适	0	0	1	1	1.0
不足为凭	0	0	1	1	1.0
不负责任	0	1	0	1	1.0
不负	0	1	0	1	1.0
不误	0	0	1	1	1.0
不论	0	0	1	1	1.0
不许百姓点灯	1	0	0	1	1.0
不言而喻	1	0	0	1	1.0
不言	1	0	0	1	1.0
不解	0	1	0	1	1.0
不觉	1	0	0	1	1.0
不要紧	1	0	0	1	1.0
不要命	0	1	0	1	1.0
不虚	1	0	0	1	1.0
不良	1	0	0	1	1.0
不至于	0	1	0	1	1.0
不自禁	0	0	1	1	1.0
不自	0	0	1	1	1.0
不能不要	0	1	0	1	1.0
不胜	0	1	0	1	1.0
不肯	0	1	0	1	1.0
不绝	1	0	0	1	1.0
不累	1	0	0	1	1.0
不管怎么	0	0	1	1	1.0
不知不觉	1	0	0	1	1.0
不留	0	1	0	1	1.0
不甘落后	0	0	1	1	1.0
不甘	0	0	1	1	1.0
不熟	0	1	0	1	1.0
不烦	0	1	0	1	1.0
不灵敏	0	0	1	1	1.0
不满	1	0	0	1	1.0
不济	1	0	0	1	1.0
不止一次	1	0	0	1	1.0
不景气	0	0	1	1	1.0
不是故意	0	1	0	1	1.0
不明	0	0	1	1	1.0
不时之需	0	1	0	1	1.0
不料	0	0	1	1	1.0
不振	0	1	0	1	1.0
不打自招	1	0	0	1	1.0
不成比例	1	0	0	1	1.0
不成方圆	1	0	0	1	1.0
不慎	0	0	1	1	1.0
不惜	1	0	0	1	1.0
不息	0	0	1	1	1.0
不怪	0	0	1	1	1.0
不急	0	0	1	1	1.0
不必要	0	0	1	1	1.0
不当	0	0	1	1	1.0
不应	1	0	0	1	1.0
不幸遇难	0	1	0	1	1.0
不尽相同	1	0	0	1	1.0
不尽	1	0	0	1	1.0
不对	0	0	1	1	1.0
不容乐观	1	0	0	1	1.0
不宜	0	1	0	1	1.0
不安	1	0	0	1	1.0
不守	0	1	0	1	1.0
不孕	0	0	1	1	1.0
不妙	0	0	1	1	1.0
不如意	1	0	0	1	1.0
不好过	0	1	0	1	1.0
不失	0	0	1	1	1.0
不太想	1	0	0	1	1.0
不太好	0	1	0	1	1.0
不太会	1	0	0	1	1.0
不大不小	1	0	0	1	1.0
不复存在	0	0	1	1	1.0
不复	0	0	1	1	1.0
不坏	1	0	0	1	1.0
不听话	0	1	0	1	1.0
不含糊	0	1	0	1	1.0
不含	0	1	0	1	1.0
不可收拾	0	1	0	1	1.0
不可思议	1	0	0	1	1.0
不剩	1	0	0	1	1.0
不前	0	1	0	1	1.0
不分场合	0	1	0	1	1.0
不分	0	1	0	1	1.0
不公	0	1	0	1	1.0
不值钱	0	0	1	1	1.0
不信	1	0	0	1	1.0
不俗	1	0	0	1	1.0
不作声	1	0	0	1	1.0
不作	1	0	0	1	1.0
不休	0	1	0	1	1.0
不亦乐乎	1	0	0	1	1.0
不亚于	1	0	0	1	1.0
不争	0	1	0	1	1.0
不乐意	0	0	1	1	1.0
不久前	1	0	0	1	1.0
不一而足	1	0	0	1	1.0
不一	1	0	0	1	1.0
下风	0	0	1	1	1.0
下雪	1	0	0	1	1.0
下雨	0	1	0	1	1.0
下限	0	1	0	1	1.0
下逐客令	0	1	0	1	1.0
下过	0	1	0	1	1.0
下辈子	1	0	0	1	1.0
下辈	1	0	0	1	1.0
下课后	1	0	0	1	1.0
下结论	0	1	0	1	1.0
下沙	1	0	0	1	1.0
下水	1	0	0	1	1.0
下有小	1	0	0	1	1.0
下星期	0	0	1	1	1.0
下探	1	0	0	1	1.0
下意识	1	0	0	1	1.0
下岗	0	1	0	1	1.0
下属	0	1	0	1	1.0
下学	0	1	0	1	1.0
下子	1	0	0	1	1.0
下垂	1	0	0	1	1.0
下坡路	1	0	0	1	1.0
下坡	1	0	0	1	1.0
下图	1	0	0	1	1.0
下周一	0	0	1	1	1.0
下同	0	0	1	1	1.0
下单	0	1	0	1	1.0
下列	0	0	1	1	1.0
下个月	1	0	0	1	1.0
下下	0	1	0	1	1.0
上调	0	1	0	1	1.0
上课	0	1	0	1	1.0
上街	0	0	1	1	1.0
上自	1	0	0	1	1.0
上网	0	0	1	1	1.0
上端	0	1	0	1	1.0
上演	0	0	1	1	1.0
上榜	0	1	0	1	1.0
上楼	0	0	1	1	1.0
上档次	0	0	1	1	1.0
上档	0	0	1	1	1.0
上有老下有小	1	0	0	1	1.0
上有老	1	0	0	1	1.0
上有	1	0	0	1	1.0
上月	0	0	1	1	1.0
上映	0	0	1	1	1.0
上手	0	1	0	1	1.0
上当受骗	1	0	0	1	1.0
上岗证	0	1	0	1	1.0
上山	1	0	0	1	1.0
上层	0	1	0	1	1.0
上天	1	0	0	1	1.0
上图	1	0	0	1	1.0
上台	0	1	0	1	1.0
上代	0	1	0	1	1.0
上下学	0	1	0	1	1.0
上上网	0	0	1	1	1.0
上上	0	0	1	1	1.0
三项	1	0	0	1	1.0
三遍	0	1	0	1	1.0
三角旗	1	0	0	1	1.0
三角	1	0	0	1	1.0
三百多	1	0	0	1	1.0
三流	0	1	0	1	1.0
三期	1	0	0	1	1.0
三月	0	0	1	1	1.0
三明	1	0	0	1	1.0
三捆	0	1	0	1	1.0
三打	1	0	0	1	1.0
三岁	1	0	0	1	1.0
三姑	1	0	0	1	1.0
三四百	0	1	0	1	1.0
三四	0	1	0	1	1.0
三口	1	0	0	1	1.0
三十年	0	1	0	1	1.0
三十多年	1	0	0	1	1.0
三十多万	1	0	0	1	1.0
三十万	0	1	0	1	1.0
三分钟	0	0	1	1	1.0
三分之一	1	0	0	1	1.0
三八妇女节	1	0	0	1	1.0
三八	1	0	0	1	1.0
三儿	0	0	1	1	1.0
三份	1	0	0	1	1.0
三代同堂	1	0	0	1	1.0
三代人	1	0	0	1	1.0
三代	1	0	0	1	1.0
三亚	0	1	0	1	1.0
万里	1	0	0	1	1.0
万紫千红	1	0	0	1	1.0
万科	0	0	1	1	1.0
万斤	0	1	0	1	1.0
万左右	0	0	1	1	1.0
万岁	1	0	0	1	1.0
万家灯火	1	0	0	1	1.0
万头	0	1	0	1	1.0
万余件	0	1	0	1	1.0
万余	0	1	0	1	1.0
万件	0	1	0	1	1.0
万事如意	1	0	0	1	1.0
万事	1	0	0	1	1.0
万万	0	1	0	1	1.0
七章	0	1	0	1	1.0
七点钟	0	1	0	1	1.0
七喜	1	0	0	1	1.0
七十年代	0	0	1	1	1.0
七十年	0	0	1	1	1.0
七十万	0	0	1	1	1.0
七个	1	0	0	1	1.0
丁香	1	0	0	1	1.0
丁点	0	1	0	1	1.0
丁	0	0	1	1	1.0
一首	1	0	0	1	1.0
一顶	0	0	1	1	1.0
一面之词	1	0	0	1	1.0
一集	0	0	1	1	1.0
一阵风	1	0	0	1	1.0
一门	0	1	0	1	1.0
一键	0	1	0	1	1.0
一道	0	0	1	1	1.0
一通	1	0	0	1	1.0
一轮	0	1	0	1	1.0
一车	0	1	0	1	1.0
一身正气	0	1	0	1	1.0
一路货	0	1	0	1	1.0
一趟	0	1	0	1	1.0
一贯作风	1	0	0	1	1.0
一角	0	1	0	1	1.0
一视同仁	0	1	0	1	1.0
一袋	0	0	1	1	1.0
一经	0	1	0	1	1.0
一纸空文	1	0	0	1	1.0
一米	1	0	0	1	1.0
一笔一画	1	0	0	1	1.0
一笔	1	0	0	1	1.0
一禁	0	1	0	1	1.0
一眨眼	1	0	0	1	1.0
一眨	1	0	0	1	1.0
一目了然	0	1	0	1	1.0
一目	0	1	0	1	1.0
一盘棋	0	1	0	1	1.0
一盘	0	1	0	1	1.0
一百年	0	0	1	1	1.0
一百二	0	1	0	1	1.0
一百万	0	1	0	1	1.0
一番	1	0	0	1	1.0
一片狼藉	0	0	1	1	1.0
一滴水	0	1	0	1	1.0
一滴	0	1	0	1	1.0
一清二白	1	0	0	1	1.0
一氧化碳	0	1	0	1	1.0
一氧化氮	0	1	0	1	1.0
一气呵成	1	0	0	1	1.0
一比	0	1	0	1	1.0
一次次	0	0	1	1	1.0
一楼	1	0	0	1	1.0
一桶	1	0	0	1	1.0
一来	0	0	1	1	1.0
一村	1	0	0	1	1.0
一期	1	0	0	1	1.0
一月	0	0	1	1	1.0
一时间	0	0	1	1	1.0
一时半会	1	0	0	1	1.0
一早	0	1	0	1	1.0
一文	1	0	0	1	1.0
一整天	0	0	1	1	1.0
一整	0	0	1	1	1.0
一打	1	0	0	1	1.0
一截	0	1	0	1	1.0
一年一度	1	0	0	1	1.0
一帮人	0	1	0	1	1.0
一席谈	0	0	1	1	1.0
一席	0	0	1	1	1.0
一带	1	0	0	1	1.0
一小	0	1	0	1	1.0
一字排开	0	0	1	1	1.0
一子	1	0	0	1	1.0
一头	1	0	0	1	1.0
一天天	0	1	0	1	1.0
一大群	1	0	0	1	1.0
一大半	0	1	0	1	1.0
一夜间	0	0	1	1	1.0
一夕之间	0	0	1	1	1.0
一夕	0	0	1	1	1.0
一声令下	0	1	0	1	1.0
一塌糊涂	1	0	0	1	1.0
一圈	1	0	0	1	1.0
一团糟	0	0	1	1	1.0
一呼百应	0	1	0	1	1.0
一周年	0	0	1	1	1.0
一员	1	0	0	1	1.0
一口	0	1	0	1	1.0
一厢情愿	1	0	0	1	1.0
一厢	1	0	0	1	1.0
一半左右	0	0	1	1	1.0
一半儿	0	0	1	1	1.0
一千二百万	0	1	0	1	1.0
一千二百	0	1	0	1	1.0
一千二	0	1	0	1	1.0
一千	0	1	0	1	1.0
一包	0	0	1	1	1.0
一劳永逸	0	1	0	1	1.0
一刻起	1	0	0	1	1.0
一则	0	1	0	1	1.0
一切顺利	1	0	0	1	1.0
一切正常	0	0	1	1	1.0
一切众生	0	1	0	1	1.0
一分钱	1	0	0	1	1.0
一分钟	0	0	1	1	1.0
一出	0	1	0	1	1.0
一准	1	0	0	1	1.0
一写到	0	0	1	1	1.0
一党制	0	1	0	1	1.0
一体化	0	1	0	1	1.0
一乐	1	0	0	1	1.0
一举	0	1	0	1	1.0
一个男孩	0	0	1	1	1.0
一个样	0	1	0	1	1.0
一个劲	0	1	0	1	1.0
一个个	0	1	0	1	1.0
一两年	0	1	0	1	1.0
一两句话	1	0	0	1	1.0
一两句	1	0	0	1	1.0
一两个	1	0	0	1	1.0
一下下	0	1	0	1	1.0
一上午	1	0	0	1	1.0
一上	1	0	0	1	1.0
一丁点	0	1	0	1	1.0
一丁	0	1	0	1	1.0
zyxu4zj	1	0	0	1	1.0
zuowenren	1	0	0	1	1.0
zr9kpno	0	0	1	1	1.0
zoxaaic	1	0	0	1	1.0
zoo	0	1	0	1	1.0
zhuzhu1027	1	0	0	1	1.0
z5p	1	0	0	1	1.0
z5c	1	0	0	1	1.0
z3	0	0	1	1	1.0
z	1	0	0	1	1.0
yuan	0	0	1	1	1.0
you	0	0	1	1	1.0
yjj	1	0	0	1	1.0
year	0	1	0	1	1.0
xb	1	0	0	1	1.0
x640	0	0	1	1	1.0
work	1	0	0	1	1.0
wonder	0	0	1	1	1.0
with	1	0	0	1	1.0
wifi	0	0	1	1	1.0
why	1	0	0	1	1.0
white	0	0	1	1	1.0
what	0	1	0	1	1.0
weibo	1	0	0	1	1.0
wechat	1	0	0	1	1.0
watch	1	0	0	1	1.0
vsd5s	0	1	0	1	1.0
vsd5	0	1	0	1	1.0
vsd3	0	1	0	1	1.0
vr	0	1	0	1	1.0
volte	0	0	1	1	1.0
victoria	0	0	1	1	1.0
very	1	0	0	1	1.0
v70	1	0	0	1	1.0
v7	0	0	1	1	1.0
user	1	0	0	1	1.0
update	0	0	1	1	1.0
up	0	0	1	1	1.0
uibeshort	1	0	0	1	1.0
uibe	1	0	0	1	1.0
ui	1	0	0	1	1.0
to	1	0	0	1	1.0
tmb	0	1	0	1	1.0
thyanjiuyuan	1	0	0	1	1.0
thien	1	0	0	1	1.0
the	1	0	0	1	1.0
tg	0	1	0	1	1.0
term	1	0	0	1	1.0
temple	1	0	0	1	1.0
te	0	0	1	1	1.0
tc	0	1	0	1	1.0
talk	0	0	1	1	1.0
ta	1	0	0	1	1.0
swift	0	0	1	1	1.0
sv	0	0	1	1	1.0
suki	0	0	1	1	1.0
su27	1	0	0	1	1.0
streaming	0	0	1	1	1.0
steve	0	1	0	1	1.0
stanford	0	0	1	1	1.0
special	1	0	0	1	1.0
sorry	0	1	0	1	1.0
soc	0	1	0	1	1.0
sim	1	0	0	1	1.0
short	1	0	0	1	1.0
shift	1	0	0	1	1.0
shi	1	0	0	1	1.0
shenzhen	0	1	0	1	1.0
shares	1	0	0	1	1.0
sex	0	0	1	1	1.0
seven	0	1	0	1	1.0
setting	1	0	0	1	1.0
selfie	1	0	0	1	1.0
season	0	1	0	1	1.0
sd	0	1	0	1	1.0
sana	0	1	0	1	1.0
sally	0	1	0	1	1.0
s7edge	0	1	0	1	1.0
s400	1	0	0	1	1.0
rwprszj	0	0	1	1	1.0
rwhbash	0	0	1	1	1.0
rw51ahq	0	1	0	1	1.0
rqyfala	1	0	0	1	1.0
rqxtmpw	0	1	0	1	1.0
rqtr5lb	0	1	0	1	1.0
rqtl0wl	0	0	1	1	1.0
rql5qm1	0	1	0	1	1.0
rqjei7u	0	1	0	1	1.0
rqisw7b	0	0	1	1	1.0
rqcmzun	0	1	0	1	1.0
rq5ytwp	0	0	1	1	1.0
rq5lbud	0	1	0	1	1.0
rq0krhx	1	0	0	1	1.0
rq0ia2g	0	0	1	1	1.0
rq0bcjt	0	0	1	1	1.0
rpu0pi2	0	1	0	1	1.0
root	0	0	1	1	1.0
rocher	1	0	0	1	1.0
recorded	1	0	0	1	1.0
raxljk8	0	0	1	1	1.0
ram	0	0	1	1	1.0
r9	1	0	0	1	1.0
pyd	0	0	1	1	1.0
psv	0	0	1	1	1.0
program	1	0	0	1	1.0
po	1	0	0	1	1.0
pm	1	0	0	1	1.0
piapia	0	1	0	1	1.0
photos	1	0	0	1	1.0
phone5se	0	0	1	1	1.0
periscope	0	0	1	1	1.0
pencil	1	0	0	1	1.0
pe	1	0	0	1	1.0
pb	1	0	0	1	1.0
pass	0	1	0	1	1.0
park	0	0	1	1	1.0
pad	1	0	0	1	1.0
p9	1	0	0	1	1.0
out	0	1	0	1	1.0
os	0	0	1	1	1.0
or	1	0	0	1	1.0
oppo	1	0	0	1	1.0
one	0	1	0	1	1.0
off	1	0	0	1	1.0
of	1	0	0	1	1.0
nuke	1	0	0	1	1.0
nowhereelse	0	0	1	1	1.0
not	1	0	0	1	1.0
nos	0	0	1	1	1.0
no	0	1	0	1	1.0
nina	0	1	0	1	1.0
night	1	0	0	1	1.0
nexus	1	0	0	1	1.0
neinei	1	0	0	1	1.0
ne	0	1	0	1	1.0
nbszyy	0	1	0	1	1.0
nb	0	1	0	1	1.0
my	0	0	1	1	1.0
mx2	0	1	0	1	1.0
mp3	0	0	1	1	1.0
moira	1	0	0	1	1.0
mod	0	1	0	1	1.0
mm	0	1	0	1	1.0
mini4	0	0	1	1	1.0
me	0	0	1	1	1.0
mason	1	0	0	1	1.0
mai	0	1	0	1	1.0
mah	1	0	0	1	1.0
m8	0	0	1	1	1.0
m7	0	1	0	1	1.0
m3	0	0	1	1	1.0
m2	0	0	1	1	1.0
lyn8751	1	0	0	1	1.0
lsls	1	0	0	1	1.0
low	1	0	0	1	1.0
lol	0	0	1	1	1.0
logo	1	0	0	1	1.0
lofter	0	1	0	1	1.0
localytics	0	0	1	1	1.0
liya	0	0	1	1	1.0
let	1	0	0	1	1.0
leo	0	0	1	1	1.0
la	1	0	0	1	1.0
kxrgt6	0	1	0	1	1.0
know	0	0	1	1	1.0
kirkland	1	0	0	1	1.0
kart	0	0	1	1	1.0
kakao	0	0	1	1	1.0
jobs	0	1	0	1	1.0
jb	0	1	0	1	1.0
james	0	0	1	1	1.0
itunse	0	1	0	1	1.0
it	1	0	0	1	1.0
iphono	0	0	1	1	1.0
iphoneses	0	1	0	1	1.0
iphoneplus	0	0	1	1	1.0
iphonen	0	0	1	1	1.0
iphonemos	0	0	1	1	1.0
iphone9	0	0	1	1	1.0
iphone8s	0	0	1	1	1.0
iphone8	0	0	1	1	1.0
iphone7s	0	0	1	1	1.0
iphone6p	1	0	0	1	1.0
iphone5c	0	1	0	1	1.0
iphone4	1	0	0	1	1.0
ios7	0	1	0	1	1.0
ing	0	0	1	1	1.0
important	1	0	0	1	1.0
imissu	0	0	1	1	1.0
ifixit	1	0	0	1	1.0
id	0	1	0	1	1.0
ic	0	1	0	1	1.0
i6	0	1	0	1	1.0
i5	0	1	0	1	1.0
i	1	0	0	1	1.0
hydrakoo	0	0	1	1	1.0
hugo	1	0	0	1	1.0
htc	0	1	0	1	1.0
hhhhhhh	1	0	0	1	1.0
hau	1	0	0	1	1.0
happy	0	1	0	1	1.0
hallo	0	1	0	1	1.0
h	0	0	1	1	1.0
grace	0	0	1	1	1.0
gpu	1	0	0	1	1.0
gps	0	0	1	1	1.0
girls	0	0	1	1	1.0
giphone	0	0	1	1	1.0
get	1	0	0	1	1.0
gdp	0	1	0	1	1.0
fx	0	0	1	1	1.0
fuck	0	1	0	1	1.0
ftxeme	0	1	0	1	1.0
ft	0	1	0	1	1.0
frdtyl	1	0	0	1	1.0
fm88	1	0	0	1	1.0
fm	0	1	0	1	1.0
flash	1	0	0	1	1.0
fjkgmg	1	0	0	1	1.0
fizlwc	0	1	0	1	1.0
firecrackers	1	0	0	1	1.0
fhco1h	0	1	0	1	1.0
festival	1	0	0	1	1.0
festivai	1	0	0	1	1.0
fcuwxa	1	0	0	1	1.0
f4e	1	0	0	1	1.0
everyone	0	1	0	1	1.0
esports	1	0	0	1	1.0
em	1	0	0	1	1.0
elisha	0	0	1	1	1.0
edition	1	0	0	1	1.0
edge	1	0	0	1	1.0
ear	0	0	1	1	1.0
e100021	1	0	0	1	1.0
e06	0	1	0	1	1.0
e	1	0	0	1	1.0
dv	0	1	0	1	1.0
during	1	0	0	1	1.0
dtouch	0	1	0	1	1.0
dlc	0	1	0	1	1.0
diy	0	0	1	1	1.0
disappointed	0	1	0	1	1.0
d107	1	0	0	1	1.0
cx	1	0	0	1	1.0
cry	0	0	1	1	1.0
cr	1	0	0	1	1.0
cp	0	1	0	1	1.0
cosplay	1	0	0	1	1.0
cnr	0	0	1	1	1.0
cnn	0	0	1	1	1.0
cnbc	0	0	1	1	1.0
ceo	0	0	1	1	1.0
cctv	0	1	0	1	1.0
catchup	0	0	1	1	1.0
call	0	0	1	1	1.0
calendar	1	0	0	1	1.0
caijing	0	1	0	1	1.0
bye	1	0	0	1	1.0
byd	0	1	0	1	1.0
by	1	0	0	1	1.0
brian	0	0	1	1	1.0
bot	1	0	0	1	1.0
boss	1	0	0	1	1.0
bing	1	0	0	1	1.0
bilibili	0	0	1	1	1.0
bgr	0	0	1	1	1.0
bayer	1	0	0	1	1.0
baby	1	0	0	1	1.0
ayawawa	0	1	0	1	1.0
arthur	1	0	0	1	1.0
aph	1	0	0	1	1.0
and	1	0	0	1	1.0
amazing	0	0	1	1	1.0
air2	0	0	1	1	1.0
aijun	0	1	0	1	1.0
activity	1	0	0	1	1.0
abc	1	0	0	1	1.0
a8	0	0	1	1	1.0
88	1	0	0	1	1.0
6	1	0	0	1	1.0
4s	0	1	0	1	1.0
蓝天	1	15	0	16	0.9375
土鸡	12	1	0	13	0.923076923077
劳动	1	12	0	13	0.923076923077
退休	1	11	0	12	0.916666666667
横冲	11	1	0	12	0.916666666667
弟弟	11	1	0	12	0.916666666667
孕	10	0	1	11	0.909090909091
亲戚	10	1	0	11	0.909090909091
餐饮业	2	18	0	20	0.9
对准	2	18	0	20	0.9
铁站	9	0	1	10	0.9
烧纸	1	9	0	10	0.9
毫无	1	9	0	10	0.9
断崖	0	9	1	10	0.9
承诺	1	9	0	10	0.9
地铁站	9	0	1	10	0.9
千年	9	0	1	10	0.9
粗暴	0	8	1	9	0.888888888889
穷人	0	8	1	9	0.888888888889
碳	1	8	0	9	0.888888888889
直撞	8	1	0	9	0.888888888889
疯狂	1	8	0	9	0.888888888889
横冲直撞	8	1	0	9	0.888888888889
家家	8	0	1	9	0.888888888889
大气	1	8	0	9	0.888888888889
哥哥	8	1	0	9	0.888888888889
倡议	2	23	1	26	0.884615384615
亲人	15	1	1	17	0.882352941176
法律	1	14	1	16	0.875
感受	14	1	1	16	0.875
自觉	1	7	0	8	0.875
生日	7	0	1	8	0.875
没钱	1	7	0	8	0.875
扎堆	1	0	7	8	0.875
户户	7	0	1	8	0.875
就业	1	7	0	8	0.875
家户	7	0	1	8	0.875
家家户户	7	0	1	8	0.875
守岁	7	0	1	8	0.875
奇葩	0	7	1	8	0.875
同意	0	7	1	8	0.875
可笑	1	7	0	8	0.875
依据	0	7	1	8	0.875
产假	1	7	0	8	0.875
西方	13	1	1	15	0.866666666667
春晚	13	1	1	15	0.866666666667
餐饮	2	19	1	22	0.863636363636
春联	24	1	3	28	0.857142857143
权利	2	12	0	14	0.857142857143
失望	0	12	2	14	0.857142857143
重	0	6	1	7	0.857142857143
财神	6	1	0	7	0.857142857143
祥和	0	6	1	7	0.857142857143
祝福	6	1	0	7	0.857142857143
有钱	1	6	0	7	0.857142857143
政权	0	6	1	7	0.857142857143
擦	6	1	0	7	0.857142857143
携带	6	1	0	7	0.857142857143
打着	1	6	0	7	0.857142857143
恐怖主义	6	1	0	7	0.857142857143
年货	6	1	0	7	0.857142857143
平等	1	6	0	7	0.857142857143
屁	1	6	0	7	0.857142857143
嫌	1	6	0	7	0.857142857143
唱	6	1	0	7	0.857142857143
合适	6	0	1	7	0.857142857143
可爱	6	1	0	7	0.857142857143
加油	6	1	0	7	0.857142857143
通工	0	11	2	13	0.846153846154
吃饺子	11	1	1	13	0.846153846154
交通工具	0	11	2	13	0.846153846154
齐	5	1	0	6	0.833333333333
首映	5	0	1	6	0.833333333333
颜	5	0	1	6	0.833333333333
隐患	0	5	1	6	0.833333333333
该机	1	0	5	6	0.833333333333
记忆	5	0	1	6	0.833333333333
福	5	1	0	6	0.833333333333
涨	1	5	0	6	0.833333333333
没法	1	5	0	6	0.833333333333
没人	5	1	0	6	0.833333333333
朋友圈	1	0	5	6	0.833333333333
明确	0	5	1	6	0.833333333333
明星	5	0	1	6	0.833333333333
无数	0	5	1	6	0.833333333333
新款	1	0	5	6	0.833333333333
排放	5	1	0	6	0.833333333333
挤	5	1	0	6	0.833333333333
承担	1	5	0	6	0.833333333333
成长	5	0	1	6	0.833333333333
恶心	1	5	0	6	0.833333333333
尴尬	0	5	1	6	0.833333333333
大城市	5	1	0	6	0.833333333333
大城	5	1	0	6	0.833333333333
后来	5	1	0	6	0.833333333333
台	5	0	1	6	0.833333333333
半个	5	1	0	6	0.833333333333
出发	1	5	0	6	0.833333333333
倡导	1	5	0	6	0.833333333333
借	1	5	0	6	0.833333333333
人性	1	5	0	6	0.833333333333
一部分	5	0	1	6	0.833333333333
一旦	0	5	1	6	0.833333333333
小时候	14	2	1	17	0.823529411765
鼓励	2	18	2	22	0.818181818182
服务	0	9	2	11	0.818181818182
实话	2	9	0	11	0.818181818182
大量	0	9	2	11	0.818181818182
哈哈哈	9	2	0	11	0.818181818182
计划生育	3	21	2	26	0.807692307692
逆行	12	3	0	15	0.8
懒	1	12	2	15	0.8
宝	12	0	3	15	0.8
新衣	8	1	1	10	0.8
妹妹	8	2	0	10	0.8
坑	2	8	0	10	0.8
噪音	2	8	0	10	0.8
员工	1	1	8	10	0.8
号	2	8	0	10	0.8
鬼	1	4	0	5	0.8
领空	4	0	1	5	0.8
难过	0	4	1	5	0.8
阿萨德	4	1	0	5	0.8
阿萨	4	1	0	5	0.8
阿拉伯	4	1	0	5	0.8
阿拉	4	1	0	5	0.8
都市	4	1	0	5	0.8
迟早	1	4	0	5	0.8
违反	1	4	0	5	0.8
软件	4	0	1	5	0.8
走亲戚	4	1	0	5	0.8
赚钱	0	4	1	5	0.8
谋生	0	4	1	5	0.8
营销	0	4	1	5	0.8
苏联	0	4	1	5	0.8
舒服	4	1	0	5	0.8
老娘	1	4	0	5	0.8
经常	4	1	0	5	0.8
睡觉	4	0	1	5	0.8
特种	1	4	0	5	0.8
物价	1	4	0	5	0.8
爱护	1	4	0	5	0.8
没错	4	1	0	5	0.8
权	0	4	1	5	0.8
期盼	1	4	0	5	0.8
最低	1	4	0	5	0.8
改装	4	0	1	5	0.8
改成	1	4	0	5	0.8
提	0	4	1	5	0.8
指出	1	4	0	5	0.8
拉伯	4	1	0	5	0.8
抚养	1	4	0	5	0.8
技术	0	1	4	5	0.8
我市	0	1	4	5	0.8
感人	4	1	0	5	0.8
恶劣	4	1	0	5	0.8
恭喜	4	0	1	5	0.8
恐	0	4	1	5	0.8
形势	0	4	1	5	0.8
幼儿园	4	1	0	5	0.8
平时	4	1	0	5	0.8
巴马	4	1	0	5	0.8
小宝	4	1	0	5	0.8
客户	0	4	1	5	0.8
守	0	4	1	5	0.8
婴儿	4	1	0	5	0.8
好不容易	0	4	1	5	0.8
奥巴马	4	1	0	5	0.8
奥巴	4	1	0	5	0.8
奥	4	0	1	5	0.8
天上	4	1	0	5	0.8
大幅	0	4	1	5	0.8
多多	1	4	0	5	0.8
圣诞	4	0	1	5	0.8
哪个	1	0	4	5	0.8
印象	4	0	1	5	0.8
千万	0	4	1	5	0.8
加大	0	4	1	5	0.8
加入	4	1	0	5	0.8
力量	4	1	0	5	0.8
出席	4	0	1	5	0.8
出口	4	0	1	5	0.8
保护环境	0	4	1	5	0.8
保护环	0	4	1	5	0.8
俗称	4	0	1	5	0.8
何以	0	4	1	5	0.8
低于	0	1	4	5	0.8
休息	1	4	0	5	0.8
价位	1	4	0	5	0.8
令人	1	4	0	5	0.8
亲情	4	1	0	5	0.8
也好	1	4	0	5	0.8
东突	4	0	1	5	0.8
不怎么	1	4	0	5	0.8
x	1	0	4	5	0.8
tm	1	4	0	5	0.8
pro	1	0	4	5	0.8
总统	11	2	1	14	0.785714285714
团圆	11	3	0	14	0.785714285714
产生	3	11	0	14	0.785714285714
中华民族	11	2	1	14	0.785714285714
贴	32	3	6	41	0.780487804878
说实话	2	7	0	9	0.777777777778
蜀黍	7	2	0	9	0.777777777778
符合	2	7	0	9	0.777777777778
申请	0	2	7	9	0.777777777778
火灾	0	7	2	9	0.777777777778
机会	7	1	1	9	0.777777777778
故事	7	1	1	9	0.777777777778
撞	7	1	1	9	0.777777777778
拜年	7	1	1	9	0.777777777778
广大	1	7	1	9	0.777777777778
年夜饭	7	1	1	9	0.777777777778
尾气	7	2	0	9	0.777777777778
夜饭	7	1	1	9	0.777777777778
响	2	7	0	9	0.777777777778
农村	7	1	1	9	0.777777777778
元宵节	7	1	1	9	0.777777777778
仅仅	1	7	1	9	0.777777777778
今年春节	3	38	8	49	0.775510204082
女性	4	17	1	22	0.772727272727
销量	3	0	10	13	0.769230769231
晚婚	2	10	1	13	0.769230769231
拒绝	1	10	2	13	0.769230769231
听说	3	10	0	13	0.769230769231
发出	2	10	1	13	0.769230769231
动力	2	10	1	13	0.769230769231
工具	2	13	2	17	0.764705882353
取消	1	13	3	17	0.764705882353
社会	11	45	4	60	0.75
低	5	18	1	24	0.75
不错	18	2	4	24	0.75
想想	3	15	2	20	0.75
幸福	15	3	2	20	0.75
允许	2	12	2	16	0.75
买不起	1	12	3	16	0.75
道理	3	9	0	12	0.75
尽量	2	9	1	12	0.75
呵呵	3	9	0	12	0.75
驾驶	6	1	1	8	0.75
越	6	2	0	8	0.75
腿	2	0	6	8	0.75
绿灯	6	0	2	8	0.75
管管	6	1	1	8	0.75
浪费	1	6	1	8	0.75
派	6	1	1	8	0.75
歧视	1	6	1	8	0.75
模式	2	6	0	8	0.75
来源	1	1	6	8	0.75
月份	6	1	1	8	0.75
拍照	6	2	0	8	0.75
房	0	6	2	8	0.75
怎么办	1	6	1	8	0.75
库存	0	6	2	8	0.75
库克	0	6	2	8	0.75
市	0	6	2	8	0.75
对比	6	1	1	8	0.75
姐姐	6	2	0	8	0.75
大概	6	2	0	8	0.75
境内	6	1	1	8	0.75
其它	6	2	0	8	0.75
儿	6	2	0	8	0.75
偷	1	1	6	8	0.75
假期	2	6	0	8	0.75
值	6	1	1	8	0.75
传承	6	2	0	8	0.75
严查	6	1	1	8	0.75
ipad	1	1	6	8	0.75
首映礼	3	0	1	4	0.75
馊主意	3	1	0	4	0.75
食品	1	3	0	4	0.75
风行	0	3	1	4	0.75
预警	1	3	0	4	0.75
雷厉风行	0	3	1	4	0.75
随意	3	0	1	4	0.75
随之	1	0	3	4	0.75
陶	1	3	0	4	0.75
陪伴	3	1	0	4	0.75
阿富汗	3	0	1	4	0.75
阅读	1	3	0	4	0.75
里面	1	3	0	4	0.75
酒	1	3	0	4	0.75
遗憾	3	1	0	4	0.75
逗	1	0	3	4	0.75
送到	1	3	0	4	0.75
连续	0	1	3	4	0.75
这块	3	0	1	4	0.75
达姆	1	3	0	4	0.75
车牌	1	3	0	4	0.75
路段	3	0	1	4	0.75
详见	0	3	1	4	0.75
记录	1	3	0	4	0.75
认	1	3	0	4	0.75
觉悟	3	1	0	4	0.75
规章	0	3	1	4	0.75
规矩	3	0	1	4	0.75
观点	0	1	3	4	0.75
观察	3	1	0	4	0.75
观	0	3	1	4	0.75
街头	0	3	1	4	0.75
行大运	3	1	0	4	0.75
蜜月	1	3	0	4	0.75
萨达姆	1	3	0	4	0.75
节能	1	3	0	4	0.75
良好	3	0	1	4	0.75
联	3	0	1	4	0.75
翻新	1	3	0	4	0.75
缺点	3	1	0	4	0.75
第	3	1	0	4	0.75
空军	3	1	0	4	0.75
穆斯	3	1	0	4	0.75
种	3	1	0	4	0.75
礼花	1	3	0	4	0.75
短时	1	3	0	4	0.75
短信	0	3	1	4	0.75
着急	3	0	1	4	0.75
眼里	3	1	0	4	0.75
省钱	0	3	1	4	0.75
相当于	1	0	3	4	0.75
相亲	3	0	1	4	0.75
百	1	3	0	4	0.75
白	3	1	0	4	0.75
癌	0	3	1	4	0.75
痛苦	0	3	1	4	0.75
留在	3	0	1	4	0.75
画面	3	1	0	4	0.75
男女	1	3	0	4	0.75
生生	1	3	0	4	0.75
生小孩	0	3	1	4	0.75
班	3	1	0	4	0.75
环保部	1	3	0	4	0.75
特种部队	1	3	0	4	0.75
爆竹声	0	3	1	4	0.75
焚烧	1	3	0	4	0.75
烧香	3	1	0	4	0.75
激起	0	1	3	4	0.75
激动	1	3	0	4	0.75
演戏	3	0	1	4	0.75
演	3	1	0	4	0.75
湖北	0	3	1	4	0.75
混乱	3	1	0	4	0.75
消失	1	3	0	4	0.75
法者	1	3	0	4	0.75
油	3	0	1	4	0.75
民意	0	3	1	4	0.75
欧	3	1	0	4	0.75
梅	3	0	1	4	0.75
标	1	3	0	4	0.75
来到	3	0	1	4	0.75
有奖	0	3	1	4	0.75
暴	1	3	0	4	0.75
智商	3	1	0	4	0.75
普遍	1	3	0	4	0.75
晚安	0	3	1	4	0.75
显得	3	1	0	4	0.75
昨日	0	1	3	4	0.75
春节快乐	1	3	0	4	0.75
时期	1	3	0	4	0.75
日常生活	1	3	0	4	0.75
日前	0	3	1	4	0.75
无限	3	1	0	4	0.75
无所谓	0	3	1	4	0.75
无所	0	3	1	4	0.75
无关	1	0	3	4	0.75
族	0	3	1	4	0.75
新春佳节	0	3	1	4	0.75
新政	1	0	3	4	0.75
新年快乐	3	1	0	4	0.75
放出	1	0	3	4	0.75
改革开放	1	3	0	4	0.75
搞不懂	0	3	1	4	0.75
握	3	0	1	4	0.75
揍	3	1	0	4	0.75
挑战	3	1	0	4	0.75
挑	3	0	1	4	0.75
拟	0	3	1	4	0.75
抛弃	3	1	0	4	0.75
抚养费	1	3	0	4	0.75
投资	1	0	3	4	0.75
执法者	1	3	0	4	0.75
战士	3	0	1	4	0.75
愿	1	0	3	4	0.75
感动	3	0	1	4	0.75
想象	3	1	0	4	0.75
恐怖袭击	3	0	1	4	0.75
忠实	3	1	0	4	0.75
微笑	3	1	0	4	0.75
当于	1	0	3	4	0.75
强硬	0	1	3	4	0.75
开启	3	1	0	4	0.75
建国	3	1	0	4	0.75
廉价	0	3	1	4	0.75
度过	3	0	1	4	0.75
应当	3	0	1	4	0.75
广东	1	3	0	4	0.75
广	0	3	1	4	0.75
年后	1	3	0	4	0.75
常生	1	3	0	4	0.75
常	3	0	1	4	0.75
市政府	1	3	0	4	0.75
市政	1	3	0	4	0.75
属	3	0	1	4	0.75
局	0	1	3	4	0.75
小国	0	3	1	4	0.75
寒假	3	1	0	4	0.75
客户端	0	3	1	4	0.75
实实	0	1	3	4	0.75
实力	3	1	0	4	0.75
宜昌	1	3	0	4	0.75
定价	0	1	3	4	0.75
孤单	3	0	1	4	0.75
威胁	0	3	1	4	0.75
妨碍	1	3	0	4	0.75
奇	0	1	3	4	0.75
头胎	3	0	1	4	0.75
夫妇	3	0	1	4	0.75
天空	0	3	1	4	0.75
大都	3	0	1	4	0.75
大运	3	1	0	4	0.75
大事	3	1	0	4	0.75
多月	3	1	0	4	0.75
多彩	3	1	0	4	0.75
外地	0	3	1	4	0.75
外交	1	3	0	4	0.75
增	0	3	1	4	0.75
埋	0	3	1	4	0.75
坚强	3	1	0	4	0.75
在线	3	0	1	4	0.75
国情	0	3	1	4	0.75
团结	1	3	0	4	0.75
喜气	3	1	0	4	0.75
喇叭	3	0	1	4	0.75
周边	1	3	0	4	0.75
启动	3	0	1	4	0.75
听见	3	1	0	4	0.75
吨	0	3	1	4	0.75
后台老板	3	1	0	4	0.75
同事	3	0	1	4	0.75
各界	0	3	1	4	0.75
号称	1	3	0	4	0.75
可悲	1	3	0	4	0.75
受欢迎	3	0	1	4	0.75
发财	0	3	1	4	0.75
发点	1	3	0	4	0.75
友	0	3	1	4	0.75
厉害	3	1	0	4	0.75
即将来临	0	3	1	4	0.75
南头	3	0	1	4	0.75
华为	1	0	3	4	0.75
半	1	3	0	4	0.75
千元	1	3	0	4	0.75
北	0	1	3	4	0.75
勒	0	3	1	4	0.75
劝	1	3	0	4	0.75
刷	1	0	3	4	0.75
出色	3	0	1	4	0.75
出发点	1	3	0	4	0.75
冷	3	1	0	4	0.75
冲	3	0	1	4	0.75
养老	1	3	0	4	0.75
关	0	3	1	4	0.75
公安局	1	3	0	4	0.75
全新	1	0	3	4	0.75
全年	3	1	0	4	0.75
兜	3	1	0	4	0.75
兄弟姐妹	1	3	0	4	0.75
偶尔	3	1	0	4	0.75
停火	1	3	0	4	0.75
作品	3	1	0	4	0.75
位	1	3	0	4	0.75
似的	3	0	1	4	0.75
伴	3	1	0	4	0.75
代步	0	3	1	4	0.75
人民币	1	0	3	4	0.75
产妇	3	0	1	4	0.75
产业	1	0	3	4	0.75
交通管理	1	3	0	4	0.75
互动	0	1	3	4	0.75
二轮	3	0	1	4	0.75
争议	0	1	3	4	0.75
九	3	0	1	4	0.75
主持人	3	0	1	4	0.75
主持	3	0	1	4	0.75
丰富多彩	3	1	0	4	0.75
丰富	3	1	0	4	0.75
中队	3	0	1	4	0.75
中低	0	3	1	4	0.75
两轮	0	3	1	4	0.75
两千	1	3	0	4	0.75
东部	0	3	1	4	0.75
不远	1	3	0	4	0.75
不能不	1	3	0	4	0.75
不久	1	3	0	4	0.75
下次	1	0	3	4	0.75
下场	1	3	0	4	0.75
下令	1	0	3	4	0.75
三天	0	3	1	4	0.75
一生	3	0	1	4	0.75
一个多	3	0	1	4	0.75
ps	3	1	0	4	0.75
饺子	20	5	2	27	0.740740740741
绿色	2	17	4	23	0.739130434783
生产	4	17	2	23	0.739130434783
文化	25	4	5	34	0.735294117647
减少	8	33	4	45	0.733333333333
传统节日	22	3	5	30	0.733333333333
不够	4	11	0	15	0.733333333333
外卖	5	19	2	26	0.730769230769
环保	12	70	14	96	0.729166666667
鞭	3	8	0	11	0.727272727273
载客	8	1	2	11	0.727272727273
装	8	2	1	11	0.727272727273
美好	8	2	1	11	0.727272727273
目的	2	8	1	11	0.727272727273
照顾	8	3	0	11	0.727272727273
流氓	2	8	1	11	0.727272727273
权力	2	8	1	11	0.727272727273
旗舰	1	8	2	11	0.727272727273
号召	2	8	1	11	0.727272727273
公民	2	8	1	11	0.727272727273
做法	2	8	1	11	0.727272727273
老百姓	9	26	1	36	0.722222222222
避免	3	1	10	14	0.714285714286
须	1	1	5	7	0.714285714286
韩	5	1	1	7	0.714285714286
需	1	1	5	7	0.714285714286
重点	5	1	1	7	0.714285714286
适应	5	0	2	7	0.714285714286
财产	0	5	2	7	0.714285714286
贡献	2	5	0	7	0.714285714286
规划	0	5	2	7	0.714285714286
表	0	5	2	7	0.714285714286
节	5	2	0	7	0.714285714286
算是	5	2	0	7	0.714285714286
眼中	5	1	1	7	0.714285714286
生态	1	5	1	7	0.714285714286
猪	5	2	0	7	0.714285714286
独裁	1	5	1	7	0.714285714286
清理	0	5	2	7	0.714285714286
比例	5	1	1	7	0.714285714286
最终	5	2	0	7	0.714285714286
房价	1	5	1	7	0.714285714286
成都	0	5	2	7	0.714285714286
总之	5	1	1	7	0.714285714286
志愿	2	5	0	7	0.714285714286
很快	5	1	1	7	0.714285714286
当初	2	5	0	7	0.714285714286
幼儿	5	2	0	7	0.714285714286
帅	2	0	5	7	0.714285714286
小车	1	5	1	7	0.714285714286
害怕	5	2	0	7	0.714285714286
回事	1	5	1	7	0.714285714286
呼吸	1	5	1	7	0.714285714286
别的	5	2	0	7	0.714285714286
全家	5	1	1	7	0.714285714286
倒退	1	5	1	7	0.714285714286
任务	5	2	0	7	0.714285714286
任	2	0	5	7	0.714285714286
价值	0	5	2	7	0.714285714286
以往	5	0	2	7	0.714285714286
代替	5	2	0	7	0.714285714286
一片	0	5	2	7	0.714285714286
touch	1	5	1	7	0.714285714286
只能	7	22	2	31	0.709677419355
战争	4	12	1	17	0.705882352941
式	4	12	1	17	0.705882352941
子女	4	12	1	17	0.705882352941
上路	3	12	2	17	0.705882352941
来说	21	4	5	30	0.7
终于	14	3	3	20	0.7
活	4	14	2	20	0.7
政	2	14	4	20	0.7
遭遇	0	3	7	10	0.7
迎来	7	1	2	10	0.7
老公	7	2	1	10	0.7
红包	7	2	1	10	0.7
疫苗	1	7	2	10	0.7
电单车	7	2	1	10	0.7
牺牲	3	7	0	10	0.7
添	7	1	2	10	0.7
最新	0	3	7	10	0.7
晚育	2	7	1	10	0.7
掉	3	7	0	10	0.7
怀上	7	0	3	10	0.7
引导	2	7	1	10	0.7
庙会	7	2	1	10	0.7
合伙人	7	0	3	10	0.7
合伙	7	0	3	10	0.7
受到	3	7	0	10	0.7
俄军	7	2	1	10	0.7
从来	3	7	0	10	0.7
英寸	2	5	16	23	0.695652173913
人口	7	25	4	36	0.694444444444
难道	6	18	2	26	0.692307692308
苦	1	9	3	13	0.692307692308
绝对	3	9	1	13	0.692307692308
穿	9	1	3	13	0.692307692308
独生子女	4	9	0	13	0.692307692308
独生子	4	9	0	13	0.692307692308
火	9	2	2	13	0.692307692308
本	3	9	1	13	0.692307692308
国人	2	9	2	13	0.692307692308
团聚	9	3	1	13	0.692307692308
包	9	3	1	13	0.692307692308
一家	9	2	2	13	0.692307692308
她	20	2	7	29	0.689655172414
百姓	13	42	6	61	0.688524590164
女儿	11	4	1	16	0.6875
送	10	26	2	38	0.684210526316
适合	13	3	3	19	0.684210526316
中华	13	5	1	19	0.684210526316
开心	15	4	3	22	0.681818181818
喜欢	46	13	9	68	0.676470588235
计划	6	23	5	34	0.676470588235
钱	12	29	2	43	0.674418604651
解决	8	20	2	30	0.666666666667
到底	4	20	6	30	0.666666666667
快乐	14	7	0	21	0.666666666667
每	5	12	1	18	0.666666666667
这里	10	5	0	15	0.666666666667
操作	10	4	1	15	0.666666666667
年夜	10	3	2	15	0.666666666667
尺寸	10	1	4	15	0.666666666667
声音	3	10	2	15	0.666666666667
力	3	10	2	15	0.666666666667
老龄化	3	8	1	12	0.666666666667
老龄	3	8	1	12	0.666666666667
群众	3	8	1	12	0.666666666667
现象	8	2	2	12	0.666666666667
玫瑰	8	3	1	12	0.666666666667
猴	8	3	1	12	0.666666666667
欢乐	2	8	2	12	0.666666666667
手段	3	8	1	12	0.666666666667
得到	3	8	1	12	0.666666666667
和平	8	1	3	12	0.666666666667
单车	8	2	2	12	0.666666666667
单位	1	3	8	12	0.666666666667
分析师	3	1	8	12	0.666666666667
不知	8	1	3	12	0.666666666667
近	2	6	1	9	0.666666666667
详情	6	2	1	9	0.666666666667
老家	6	2	1	9	0.666666666667
相关	1	6	2	9	0.666666666667
留下	6	3	0	9	0.666666666667
油价	2	6	1	9	0.666666666667
正是	6	1	2	9	0.666666666667
无疑	1	6	2	9	0.666666666667
改革	2	6	1	9	0.666666666667
按	2	6	1	9	0.666666666667
待	6	3	0	9	0.666666666667
弱势群体	3	6	0	9	0.666666666667
弱势	3	6	0	9	0.666666666667
小土豆	6	0	3	9	0.666666666667
小土	6	0	3	9	0.666666666667
对联	6	2	1	9	0.666666666667
土豆	6	0	3	9	0.666666666667
和	3	6	0	9	0.666666666667
周末	6	0	3	9	0.666666666667
否则	3	6	0	9	0.666666666667
吃饭	2	6	1	9	0.666666666667
动	6	2	1	9	0.666666666667
别说	3	6	0	9	0.666666666667
做到	2	6	1	9	0.666666666667
信息	6	1	2	9	0.666666666667
骑车	1	4	1	6	0.666666666667
风	0	2	4	6	0.666666666667
非机动	4	2	0	6	0.666666666667
重新	2	4	0	6	0.666666666667
释放	1	4	1	6	0.666666666667
逛庙会	4	1	1	6	0.666666666667
这款	2	4	0	6	0.666666666667
迎	4	1	1	6	0.666666666667
达	0	4	2	6	0.666666666667
资源	1	4	1	6	0.666666666667
说话	4	1	1	6	0.666666666667
言	4	0	2	6	0.666666666667
落后	1	4	1	6	0.666666666667
苹果公司	1	1	4	6	0.666666666667
脑袋	4	2	0	6	0.666666666667
肾	1	4	1	6	0.666666666667
罚	1	4	1	6	0.666666666667
纷纷	4	1	1	6	0.666666666667
第四	2	0	4	6	0.666666666667
突厥	4	1	1	6	0.666666666667
稍微	2	4	0	6	0.666666666667
离	0	4	2	6	0.666666666667
确定	4	0	2	6	0.666666666667
看起来	4	2	0	6	0.666666666667
看起	4	2	0	6	0.666666666667
相反	1	4	1	6	0.666666666667
监管	1	4	1	6	0.666666666667
电车	1	4	1	6	0.666666666667
生育权	1	4	1	6	0.666666666667
理性	4	0	2	6	0.666666666667
环境污染	1	4	1	6	0.666666666667
犯罪	4	0	2	6	0.666666666667
特色	4	2	0	6	0.666666666667
燃	1	4	1	6	0.666666666667
满意	4	2	0	6	0.666666666667
消防	0	4	2	6	0.666666666667
消耗	1	4	1	6	0.666666666667
济南	1	4	1	6	0.666666666667
求	4	0	2	6	0.666666666667
民	4	1	1	6	0.666666666667
武汉	1	4	1	6	0.666666666667
武	1	4	1	6	0.666666666667
春季	2	0	4	6	0.666666666667
春	4	0	2	6	0.666666666667
无证	4	1	1	6	0.666666666667
新疆	4	1	1	6	0.666666666667
收	2	4	0	6	0.666666666667
提出	1	4	1	6	0.666666666667
控	4	0	2	6	0.666666666667
据说	4	1	1	6	0.666666666667
拥堵	0	4	2	6	0.666666666667
扔	1	4	1	6	0.666666666667
战	1	4	1	6	0.666666666667
愿者	2	4	0	6	0.666666666667
想法	4	0	2	6	0.666666666667
悲哀	2	4	0	6	0.666666666667
引力	2	4	0	6	0.666666666667
延续	2	4	0	6	0.666666666667
干脆	2	4	0	6	0.666666666667
干净	4	1	1	6	0.666666666667
家伙	1	4	1	6	0.666666666667
客	4	0	2	6	0.666666666667
官方	0	4	2	6	0.666666666667
娶	0	4	2	6	0.666666666667
城区	2	4	0	6	0.666666666667
城	4	1	1	6	0.666666666667
均	1	1	4	6	0.666666666667
场景	4	1	1	6	0.666666666667
地球	2	4	0	6	0.666666666667
因素	0	4	2	6	0.666666666667
哈尔滨	1	4	1	6	0.666666666667
哈尔	1	4	1	6	0.666666666667
和谐	2	4	0	6	0.666666666667
吸引力	2	4	0	6	0.666666666667
卵	1	4	1	6	0.666666666667
千	4	1	1	6	0.666666666667
初五	2	4	0	6	0.666666666667
几次	4	1	1	6	0.666666666667
农民	1	4	1	6	0.666666666667
军	2	4	0	6	0.666666666667
关键	4	0	2	6	0.666666666667
共同	2	4	0	6	0.666666666667
伤	1	4	1	6	0.666666666667
众	2	0	4	6	0.666666666667
仗	4	2	0	6	0.666666666667
中央	1	4	1	6	0.666666666667
不禁	4	2	0	6	0.666666666667
下面	4	0	2	6	0.666666666667
下台	4	1	1	6	0.666666666667
一群	2	4	0	6	0.666666666667
一段	4	1	1	6	0.666666666667
一律	4	2	0	6	0.666666666667
doge	2	4	0	6	0.666666666667
黑龙江省	2	0	1	3	0.666666666667
黄金	0	2	1	3	0.666666666667
黄冈	2	0	1	3	0.666666666667
麻麻	1	2	0	3	0.666666666667
麻将	2	0	1	3	0.666666666667
鸡蛋	2	0	1	3	0.666666666667
鸡	1	2	0	3	0.666666666667
鱼	2	0	1	3	0.666666666667
高调	0	2	1	3	0.666666666667
高考	1	0	2	3	0.666666666667
高大	1	2	0	3	0.666666666667
首发	1	0	2	3	0.666666666667
饿	2	1	0	3	0.666666666667
额	0	2	1	3	0.666666666667
领导人	2	1	0	3	0.666666666667
领	2	1	0	3	0.666666666667
预约	2	0	1	3	0.666666666667
静静	1	2	0	3	0.666666666667
青岛	1	2	0	3	0.666666666667
难民潮	2	1	0	3	0.666666666667
难受	2	1	0	3	0.666666666667
随时	2	1	0	3	0.666666666667
除非	0	2	1	3	0.666666666667
降价	0	1	2	3	0.666666666667
陌生	0	2	1	3	0.666666666667
阻止	1	2	0	3	0.666666666667
阶段	0	1	2	3	0.666666666667
防部	2	0	1	3	0.666666666667
长沙	1	2	0	3	0.666666666667
镜头	2	0	1	3	0.666666666667
镇	2	0	1	3	0.666666666667
锵锵	1	0	2	3	0.666666666667
键盘	2	1	0	3	0.666666666667
键	1	2	0	3	0.666666666667
重来	1	2	0	3	0.666666666667
配套	0	2	1	3	0.666666666667
郝	2	1	0	3	0.666666666667
郑州	0	2	1	3	0.666666666667
邻居	0	1	2	3	0.666666666667
邀请	1	0	2	3	0.666666666667
避开	2	1	0	3	0.666666666667
道路交通	1	2	0	3	0.666666666667
道德	1	2	0	3	0.666666666667
遇到	2	0	1	3	0.666666666667
造就	2	1	0	3	0.666666666667
造型	2	0	1	3	0.666666666667
通知	0	2	1	3	0.666666666667
途径	2	0	1	3	0.666666666667
选择性	2	1	0	3	0.666666666667
适当	2	1	0	3	0.666666666667
迷信	1	0	2	3	0.666666666667
迪	0	2	1	3	0.666666666667
迟	1	0	2	3	0.666666666667
违章	1	2	0	3	0.666666666667
远东	0	2	1	3	0.666666666667
这条	0	1	2	3	0.666666666667
这份	2	0	1	3	0.666666666667
近年来	0	2	1	3	0.666666666667
近年	0	2	1	3	0.666666666667
运营	1	2	0	3	0.666666666667
过后	1	2	0	3	0.666666666667
达成	1	2	0	3	0.666666666667
边缘	0	1	2	3	0.666666666667
边	1	0	2	3	0.666666666667
辨率	2	0	1	3	0.666666666667
输	2	1	0	3	0.666666666667
辈子	2	1	0	3	0.666666666667
转为	2	1	0	3	0.666666666667
身体健康	2	1	0	3	0.666666666667
身	2	0	1	3	0.666666666667
跳跳	2	0	1	3	0.666666666667
路面	2	1	0	3	0.666666666667
跟风	2	0	1	3	0.666666666667
跟上	2	1	0	3	0.666666666667
趟	2	1	0	3	0.666666666667
超速	1	2	0	3	0.666666666667
超级	2	0	1	3	0.666666666667
趁着	2	0	1	3	0.666666666667
起码	2	1	0	3	0.666666666667
赶走	2	1	0	3	0.666666666667
赶上	1	2	0	3	0.666666666667
赵	2	0	1	3	0.666666666667
走走	2	1	0	3	0.666666666667
赫	2	1	0	3	0.666666666667
赢	2	0	1	3	0.666666666667
资本	1	0	2	3	0.666666666667
贺	1	2	0	3	0.666666666667
费	1	2	0	3	0.666666666667
贫民	1	2	0	3	0.666666666667
财经	0	1	2	3	0.666666666667
财富	0	2	1	3	0.666666666667
貌似	2	0	1	3	0.666666666667
谜	1	2	0	3	0.666666666667
课	1	0	2	3	0.666666666667
诺基亚	1	2	0	3	0.666666666667
说来	2	0	1	3	0.666666666667
详情请	2	0	1	3	0.666666666667
许可	0	1	2	3	0.666666666667
认识	2	1	0	3	0.666666666667
计生	1	2	0	3	0.666666666667
警车	0	2	1	3	0.666666666667
警方	0	2	1	3	0.666666666667
警力	2	0	1	3	0.666666666667
视为	1	2	0	3	0.666666666667
观众	0	1	2	3	0.666666666667
见识	0	1	2	3	0.666666666667
要闻	1	0	2	3	0.666666666667
要说	1	2	0	3	0.666666666667
衷心	1	2	0	3	0.666666666667
衰	2	1	0	3	0.666666666667
表态	2	1	0	3	0.666666666667
补充	1	2	0	3	0.666666666667
街	2	0	1	3	0.666666666667
蛮	2	1	0	3	0.666666666667
蛋	2	1	0	3	0.666666666667
著	2	1	0	3	0.666666666667
苏州	2	0	1	3	0.666666666667
节俭	1	2	0	3	0.666666666667
艺	1	0	2	3	0.666666666667
航空	2	1	0	3	0.666666666667
舍	2	0	1	3	0.666666666667
自身	1	2	0	3	0.666666666667
自由民主	2	1	0	3	0.666666666667
自由民	2	1	0	3	0.666666666667
自愿	1	2	0	3	0.666666666667
腾讯	0	2	1	3	0.666666666667
腾	1	2	0	3	0.666666666667
胎生	2	1	0	3	0.666666666667
背景	2	0	1	3	0.666666666667
育	1	2	0	3	0.666666666667
肉	2	1	0	3	0.666666666667
肃	2	0	1	3	0.666666666667
联邦	2	1	0	3	0.666666666667
联网	1	2	0	3	0.666666666667
耽误	1	2	0	3	0.666666666667
耳边	0	1	2	3	0.666666666667
耳朵	1	0	2	3	0.666666666667
耐心	2	1	0	3	0.666666666667
耍流氓	0	2	1	3	0.666666666667
考验	1	0	2	3	0.666666666667
考试	1	0	2	3	0.666666666667
老路	0	2	1	3	0.666666666667
老爸	2	0	1	3	0.666666666667
老家伙	0	2	1	3	0.666666666667
美的	1	2	0	3	0.666666666667
美军	1	0	2	3	0.666666666667
缺陷	0	2	1	3	0.666666666667
绿	2	0	1	3	0.666666666667
维	2	0	1	3	0.666666666667
统治	1	2	0	3	0.666666666667
绕	0	1	2	3	0.666666666667
纯	2	0	1	3	0.666666666667
纪录	0	1	2	3	0.666666666667
红色	0	1	2	3	0.666666666667
管理者	1	2	0	3	0.666666666667
管理混乱	2	1	0	3	0.666666666667
等于	1	2	0	3	0.666666666667
第一天	2	1	0	3	0.666666666667
竹子	1	2	0	3	0.666666666667
端	2	0	1	3	0.666666666667
立法	1	2	0	3	0.666666666667
立交桥	2	0	1	3	0.666666666667
空军基地	2	1	0	3	0.666666666667
究竟	0	2	1	3	0.666666666667
穆斯林	2	1	0	3	0.666666666667
科学	1	2	0	3	0.666666666667
私家车	2	1	0	3	0.666666666667
私家	2	1	0	3	0.666666666667
离家	2	1	0	3	0.666666666667
离婚	0	2	1	3	0.666666666667
福田	1	0	2	3	0.666666666667
福建	1	2	0	3	0.666666666667
福州	0	1	2	3	0.666666666667
禁忌	2	0	1	3	0.666666666667
祸害	0	2	1	3	0.666666666667
社保	1	2	0	3	0.666666666667
确	1	2	0	3	0.666666666667
石	2	0	1	3	0.666666666667
短	1	2	0	3	0.666666666667
着想	0	2	1	3	0.666666666667
看电视	1	0	2	3	0.666666666667
看好	2	1	0	3	0.666666666667
盼	1	0	2	3	0.666666666667
相应	0	2	1	3	0.666666666667
直逼	2	1	0	3	0.666666666667
目测	0	1	2	3	0.666666666667
盛大	2	0	1	3	0.666666666667
监督	2	1	0	3	0.666666666667
皇家	1	0	2	3	0.666666666667
皆	1	0	2	3	0.666666666667
百多	1	2	0	3	0.666666666667
百万	0	2	1	3	0.666666666667
白天	0	2	1	3	0.666666666667
疑惑	1	2	0	3	0.666666666667
略	2	1	0	3	0.666666666667
用电	1	2	0	3	0.666666666667
用心	2	1	0	3	0.666666666667
生气	2	1	0	3	0.666666666667
理事	1	2	0	3	0.666666666667
珍惜	1	0	2	3	0.666666666667
玺	2	1	0	3	0.666666666667
现如今	0	2	1	3	0.666666666667
玩笑	2	1	0	3	0.666666666667
王八蛋	2	1	0	3	0.666666666667
猴子	2	1	0	3	0.666666666667
猜测	2	1	0	3	0.666666666667
独立	2	1	0	3	0.666666666667
狂欢	2	1	0	3	0.666666666667
特点	2	1	0	3	0.666666666667
特定	2	0	1	3	0.666666666667
爱好者	1	0	2	3	0.666666666667
熟悉	2	0	1	3	0.666666666667
照样	2	1	0	3	0.666666666667
热爱	2	1	0	3	0.666666666667
热点	1	0	2	3	0.666666666667
烦恼	1	2	0	3	0.666666666667
烊	2	1	0	3	0.666666666667
点击	0	2	1	3	0.666666666667
点儿	2	1	0	3	0.666666666667
灵活	1	2	0	3	0.666666666667
灯节	2	0	1	3	0.666666666667
火锅	1	0	2	3	0.666666666667
火光	1	0	2	3	0.666666666667
潇	2	0	1	3	0.666666666667
滴	2	0	1	3	0.666666666667
滚滚	2	0	1	3	0.666666666667
源于	2	0	1	3	0.666666666667
渐	2	1	0	3	0.666666666667
深圳市政府	1	2	0	3	0.666666666667
涉	1	0	2	3	0.666666666667
浓厚	2	0	1	3	0.666666666667
测	2	0	1	3	0.666666666667
洗脑	0	2	1	3	0.666666666667
洗	2	1	0	3	0.666666666667
洋洋	2	1	0	3	0.666666666667
注意安全	2	0	1	3	0.666666666667
泡	2	1	0	3	0.666666666667
治疗	0	1	2	3	0.666666666667
治标	1	2	0	3	0.666666666667
没用	0	2	1	3	0.666666666667
沙特阿拉伯	2	1	0	3	0.666666666667
江苏	0	2	1	3	0.666666666667
汉子	0	1	2	3	0.666666666667
水泥	0	2	1	3	0.666666666667
比亚迪	0	2	1	3	0.666666666667
段子	2	0	1	3	0.666666666667
段	2	0	1	3	0.666666666667
残	1	2	0	3	0.666666666667
死亡	0	1	2	3	0.666666666667
步	1	2	0	3	0.666666666667
此起彼伏	1	2	0	3	0.666666666667
正当	0	2	1	3	0.666666666667
欺骗	2	1	0	3	0.666666666667
欧盟	1	0	2	3	0.666666666667
横岗	2	1	0	3	0.666666666667
检测	1	2	0	3	0.666666666667
梦见	1	0	2	3	0.666666666667
核	1	2	0	3	0.666666666667
校长	0	1	2	3	0.666666666667
极端分子	2	1	0	3	0.666666666667
极点	2	1	0	3	0.666666666667
极其	2	1	0	3	0.666666666667
松	2	1	0	3	0.666666666667
来回	1	2	0	3	0.666666666667
村里	2	1	0	3	0.666666666667
村民	2	1	0	3	0.666666666667
村	1	2	0	3	0.666666666667
机智	2	1	0	3	0.666666666667
有种	0	2	1	3	0.666666666667
有用	2	1	0	3	0.666666666667
最早	1	2	0	3	0.666666666667
最多	0	2	1	3	0.666666666667
最佳	2	0	1	3	0.666666666667
曰	0	2	1	3	0.666666666667
暴政	1	2	0	3	0.666666666667
暗中	1	2	0	3	0.666666666667
景气	0	1	2	3	0.666666666667
普及	1	0	2	3	0.666666666667
晚报	0	1	2	3	0.666666666667
是从	2	1	0	3	0.666666666667
春天	2	0	1	3	0.666666666667
明摆着	2	0	1	3	0.666666666667
明摆	2	0	1	3	0.666666666667
时机	0	1	2	3	0.666666666667
早早	1	2	0	3	0.666666666667
日渐	1	2	0	3	0.666666666667
日期	2	1	0	3	0.666666666667
无辜	1	2	0	3	0.666666666667
无论如何	1	0	2	3	0.666666666667
无可	2	1	0	3	0.666666666667
旅游	1	0	2	3	0.666666666667
方案	1	2	0	3	0.666666666667
方公里	1	2	0	3	0.666666666667
新鲜	0	2	1	3	0.666666666667
新生	2	0	1	3	0.666666666667
斯	2	0	1	3	0.666666666667
料	1	0	2	3	0.666666666667
文艺	1	2	0	3	0.666666666667
教训	0	2	1	3	0.666666666667
教授	0	1	2	3	0.666666666667
教师	1	2	0	3	0.666666666667
敌	2	1	0	3	0.666666666667
故	1	2	0	3	0.666666666667
政绩	1	2	0	3	0.666666666667
放火	1	2	0	3	0.666666666667
放假	2	1	0	3	0.666666666667
收缴	0	1	2	3	0.666666666667
攒钱	0	1	2	3	0.666666666667
撕	0	1	2	3	0.666666666667
摇	1	2	0	3	0.666666666667
摆脱	2	1	0	3	0.666666666667
摆	0	2	1	3	0.666666666667
搞笑	2	1	0	3	0.666666666667
搜狐	2	0	1	3	0.666666666667
搜	1	2	0	3	0.666666666667
揭	2	1	0	3	0.666666666667
提议	2	1	0	3	0.666666666667
推广	1	2	0	3	0.666666666667
接送	0	2	1	3	0.666666666667
换成	2	0	1	3	0.666666666667
捅	2	1	0	3	0.666666666667
挑起	1	2	0	3	0.666666666667
挑衅	2	0	1	3	0.666666666667
指标	0	1	2	3	0.666666666667
指望	1	2	0	3	0.666666666667
拿到	0	2	1	3	0.666666666667
拼到底	0	2	1	3	0.666666666667
拼到	0	2	1	3	0.666666666667
拥护	2	1	0	3	0.666666666667
拘	1	2	0	3	0.666666666667
拉开	1	2	0	3	0.666666666667
报告	1	0	2	3	0.666666666667
抢占	0	2	1	3	0.666666666667
折	1	2	0	3	0.666666666667
投票	1	2	0	3	0.666666666667
投	1	2	0	3	0.666666666667
批评	1	2	0	3	0.666666666667
扯淡	2	1	0	3	0.666666666667
扫	1	0	2	3	0.666666666667
扩张	2	1	0	3	0.666666666667
扣押	1	2	0	3	0.666666666667
打麻将	2	0	1	3	0.666666666667
打扫	2	1	0	3	0.666666666667
打开	1	2	0	3	0.666666666667
打压	0	2	1	3	0.666666666667
打卡	2	1	0	3	0.666666666667
打仗	2	1	0	3	0.666666666667
手上	1	0	2	3	0.666666666667
战果	2	1	0	3	0.666666666667
战局	2	1	0	3	0.666666666667
战场	0	2	1	3	0.666666666667
我会	2	0	1	3	0.666666666667
成绩	2	0	1	3	0.666666666667
懂事	2	0	1	3	0.666666666667
慢慢	2	0	1	3	0.666666666667
感器	0	2	1	3	0.666666666667
感冒	1	2	0	3	0.666666666667
意料	2	0	1	3	0.666666666667
想去	1	0	2	3	0.666666666667
想买	1	2	0	3	0.666666666667
情怀	1	2	0	3	0.666666666667
恶化	1	2	0	3	0.666666666667
恩爱	1	0	2	3	0.666666666667
怪兽	2	0	1	3	0.666666666667
性质	1	0	2	3	0.666666666667
性命	1	2	0	3	0.666666666667
怎么样	1	0	2	3	0.666666666667
怂	2	1	0	3	0.666666666667
态度	1	2	0	3	0.666666666667
怀疑	1	2	0	3	0.666666666667
忽然	0	2	1	3	0.666666666667
快要	1	0	2	3	0.666666666667
快件	0	2	1	3	0.666666666667
志	0	1	2	3	0.666666666667
必定	2	1	0	3	0.666666666667
律法	1	2	0	3	0.666666666667
影响力	2	0	1	3	0.666666666667
彰显	1	2	0	3	0.666666666667
当场	1	0	2	3	0.666666666667
强迫	1	2	0	3	0.666666666667
强行	2	1	0	3	0.666666666667
强盗	2	1	0	3	0.666666666667
弱智	1	2	0	3	0.666666666667
弄死	0	2	1	3	0.666666666667
异常	2	0	1	3	0.666666666667
废	1	2	0	3	0.666666666667
应用	1	2	0	3	0.666666666667
庆贺	1	0	2	3	0.666666666667
广泛	0	2	1	3	0.666666666667
平方公里	1	2	0	3	0.666666666667
平方	1	2	0	3	0.666666666667
平均	1	2	0	3	0.666666666667
干活	0	2	1	3	0.666666666667
常识	2	1	0	3	0.666666666667
市场份额	0	1	2	3	0.666666666667
已成	0	1	2	3	0.666666666667
差距	0	2	1	3	0.666666666667
工作组	2	1	0	3	0.666666666667
工	1	0	2	3	0.666666666667
山	2	0	1	3	0.666666666667
屠杀	2	1	0	3	0.666666666667
展开	0	2	1	3	0.666666666667
屏门	0	2	1	3	0.666666666667
屎	1	2	0	3	0.666666666667
局面	1	2	0	3	0.666666666667
局势	2	1	0	3	0.666666666667
尽量少	0	2	1	3	0.666666666667
尽快	2	0	1	3	0.666666666667
就让	1	0	2	3	0.666666666667
就行了	0	2	1	3	0.666666666667
少部分	0	2	1	3	0.666666666667
小说	2	1	0	3	0.666666666667
小朋友	1	2	0	3	0.666666666667
小弟	2	0	1	3	0.666666666667
小巷	2	1	0	3	0.666666666667
小家	2	1	0	3	0.666666666667
对着	1	2	0	3	0.666666666667
对待	2	0	1	3	0.666666666667
寒	0	2	1	3	0.666666666667
富人	0	1	2	3	0.666666666667
密集	0	2	1	3	0.666666666667
寄托	2	0	1	3	0.666666666667
室友	2	0	1	3	0.666666666667
宠物	0	1	2	3	0.666666666667
实际上	1	2	0	3	0.666666666667
宝安	2	0	1	3	0.666666666667
定位	0	2	1	3	0.666666666667
宋	2	0	1	3	0.666666666667
宇	2	0	1	3	0.666666666667
学会	2	0	1	3	0.666666666667
孤独	2	1	0	3	0.666666666667
孝顺	1	2	0	3	0.666666666667
孙子	2	1	0	3	0.666666666667
存储	1	0	2	3	0.666666666667
嫣	2	0	1	3	0.666666666667
嫌贵	0	1	2	3	0.666666666667
媒体报道	0	1	2	3	0.666666666667
好者	1	0	2	3	0.666666666667
好开心	2	1	0	3	0.666666666667
好听	2	1	0	3	0.666666666667
奖金	1	0	2	3	0.666666666667
头疼	2	0	1	3	0.666666666667
失	0	2	1	3	0.666666666667
太阳	2	1	0	3	0.666666666667
太慢	0	1	2	3	0.666666666667
太丑	2	0	1	3	0.666666666667
大雨	0	2	1	3	0.666666666667
大队	2	0	1	3	0.666666666667
大道	2	1	0	3	0.666666666667
大街小巷	2	1	0	3	0.666666666667
大学生	1	2	0	3	0.666666666667
大堆	1	2	0	3	0.666666666667
大地	0	2	1	3	0.666666666667
大军	1	0	2	3	0.666666666667
够用	2	1	0	3	0.666666666667
夜间	0	2	1	3	0.666666666667
多种	0	2	1	3	0.666666666667
多万	2	0	1	3	0.666666666667
外长	2	1	0	3	0.666666666667
外环	2	1	0	3	0.666666666667
外交部	1	2	0	3	0.666666666667
夕	2	0	1	3	0.666666666667
备案	2	1	0	3	0.666666666667
墓地	2	1	0	3	0.666666666667
基督教	2	1	0	3	0.666666666667
基督	2	1	0	3	0.666666666667
基本上	0	2	1	3	0.666666666667
基亚	1	2	0	3	0.666666666667
块	0	2	1	3	0.666666666667
坐不住	2	0	1	3	0.666666666667
场	1	2	0	3	0.666666666667
在乎	1	2	0	3	0.666666666667
圈圈	2	1	0	3	0.666666666667
国防部	2	0	1	3	0.666666666667
国防	2	0	1	3	0.666666666667
国政	1	2	0	3	0.666666666667
固定	2	0	1	3	0.666666666667
回收	1	2	0	3	0.666666666667
四十	0	1	2	3	0.666666666667
噼里啪啦	1	2	0	3	0.666666666667
噼噼叭叭	1	2	0	3	0.666666666667
噪声	0	2	1	3	0.666666666667
嘴	1	0	2	3	0.666666666667
喵	2	0	1	3	0.666666666667
喜气洋洋	2	1	0	3	0.666666666667
啪啦	1	2	0	3	0.666666666667
哪怕	2	1	0	3	0.666666666667
哪儿	2	1	0	3	0.666666666667
咱们	2	1	0	3	0.666666666667
咬牙	0	1	2	3	0.666666666667
咨询	2	1	0	3	0.666666666667
咋办	0	1	2	3	0.666666666667
命	0	1	2	3	0.666666666667
周全	1	0	2	3	0.666666666667
呗	0	2	1	3	0.666666666667
吵醒	1	2	0	3	0.666666666667
后边	1	0	2	3	0.666666666667
后续	0	1	2	3	0.666666666667
后悔	2	1	0	3	0.666666666667
同期	1	0	2	3	0.666666666667
吉祥	2	1	0	3	0.666666666667
合格	0	2	1	3	0.666666666667
合作	2	1	0	3	0.666666666667
各个	2	1	0	3	0.666666666667
叭叭	1	2	0	3	0.666666666667
另一方面	0	2	1	3	0.666666666667
另一方	0	2	1	3	0.666666666667
古老	2	0	1	3	0.666666666667
受访	0	2	1	3	0.666666666667
受伤	0	1	2	3	0.666666666667
受不了	2	0	1	3	0.666666666667
取	1	2	0	3	0.666666666667
发明	1	2	0	3	0.666666666667
发售	1	2	0	3	0.666666666667
双方	1	0	2	3	0.666666666667
双	1	2	0	3	0.666666666667
叉	2	1	0	3	0.666666666667
参考	1	2	0	3	0.666666666667
原本	1	2	0	3	0.666666666667
压根	1	2	0	3	0.666666666667
却是	2	1	0	3	0.666666666667
即可	0	2	1	3	0.666666666667
卫视	1	0	2	3	0.666666666667
占用	1	2	0	3	0.666666666667
卖不出去	1	2	0	3	0.666666666667
单纯	1	2	0	3	0.666666666667
单独	1	2	0	3	0.666666666667
单方面	0	1	2	3	0.666666666667
单方	0	1	2	3	0.666666666667
十字军	2	1	0	3	0.666666666667
北部	0	2	1	3	0.666666666667
化解	2	0	1	3	0.666666666667
包裹	1	2	0	3	0.666666666667
动静	0	2	1	3	0.666666666667
加拿大	1	0	2	3	0.666666666667
加拿	1	0	2	3	0.666666666667
加剧	0	1	2	3	0.666666666667
功率	2	0	1	3	0.666666666667
功	1	2	0	3	0.666666666667
办事	1	2	0	3	0.666666666667
力推	1	2	0	3	0.666666666667
到达	1	2	0	3	0.666666666667
到极点	2	1	0	3	0.666666666667
到来	2	0	1	3	0.666666666667
初步	1	2	0	3	0.666666666667
初期	0	1	2	3	0.666666666667
初中	0	2	1	3	0.666666666667
创新	0	2	1	3	0.666666666667
刚好	2	1	0	3	0.666666666667
切勿	2	1	0	3	0.666666666667
分辨率	2	0	1	3	0.666666666667
击	0	1	2	3	0.666666666667
出货	0	1	2	3	0.666666666667
出乎	2	0	1	3	0.666666666667
凶	2	1	0	3	0.666666666667
几张	0	1	2	3	0.666666666667
减	2	1	0	3	0.666666666667
冷漠	2	1	0	3	0.666666666667
养育	2	1	0	3	0.666666666667
具有	1	2	0	3	0.666666666667
共青团	2	1	0	3	0.666666666667
共青	2	1	0	3	0.666666666667
兰	2	1	0	3	0.666666666667
公正	1	2	0	3	0.666666666667
公共交通	0	2	1	3	0.666666666667
公众	0	1	2	3	0.666666666667
公交车	2	1	0	3	0.666666666667
公交站点	1	2	0	3	0.666666666667
八	2	1	0	3	0.666666666667
全都	1	2	0	3	0.666666666667
光盘	0	2	1	3	0.666666666667
充电	2	1	0	3	0.666666666667
停车	1	2	0	3	0.666666666667
停产	1	0	2	3	0.666666666667
做生意	1	2	0	3	0.666666666667
做事	1	2	0	3	0.666666666667
做主	0	2	1	3	0.666666666667
保	2	0	1	3	0.666666666667
俄方	1	2	0	3	0.666666666667
便于	2	1	0	3	0.666666666667
供给	0	2	1	3	0.666666666667
供应商	0	1	2	3	0.666666666667
何不	0	2	1	3	0.666666666667
体健	2	1	0	3	0.666666666667
但愿	1	2	0	3	0.666666666667
似	2	1	0	3	0.666666666667
传感器	0	2	1	3	0.666666666667
传感	0	2	1	3	0.666666666667
会员	0	1	2	3	0.666666666667
休	1	2	0	3	0.666666666667
企图	2	0	1	3	0.666666666667
仿佛	2	1	0	3	0.666666666667
份额	0	1	2	3	0.666666666667
任意	1	0	2	3	0.666666666667
价	0	2	1	3	0.666666666667
以内	2	1	0	3	0.666666666667
代价	0	2	1	3	0.666666666667
仔细	1	2	0	3	0.666666666667
仔	1	0	2	3	0.666666666667
从没	1	0	2	3	0.666666666667
从此	2	1	0	3	0.666666666667
介绍	2	0	1	3	0.666666666667
今天上午	2	1	0	3	0.666666666667
今后	1	2	0	3	0.666666666667
人马	0	2	1	3	0.666666666667
人心	2	1	0	3	0.666666666667
亲朋好友	2	1	0	3	0.666666666667
亲朋	2	1	0	3	0.666666666667
亦	2	0	1	3	0.666666666667
交警部门	1	0	2	3	0.666666666667
交管	1	2	0	3	0.666666666667
交易	1	2	0	3	0.666666666667
亚洲	0	1	2	3	0.666666666667
互	0	2	1	3	0.666666666667
事业	1	2	0	3	0.666666666667
买到	2	1	0	3	0.666666666667
书	1	2	0	3	0.666666666667
也许	1	2	0	3	0.666666666667
乏味	2	1	0	3	0.666666666667
之际	1	2	0	3	0.666666666667
之中	1	0	2	3	0.666666666667
久	1	2	0	3	0.666666666667
举动	1	0	2	3	0.666666666667
举办	2	0	1	3	0.666666666667
主张	1	2	0	3	0.666666666667
临	0	1	2	3	0.666666666667
中期	1	0	2	3	0.666666666667
严谨	2	1	0	3	0.666666666667
严	1	0	2	3	0.666666666667
两款	1	0	2	3	0.666666666667
两家	1	2	0	3	0.666666666667
东北	2	1	0	3	0.666666666667
不许	1	2	0	3	0.666666666667
不快	1	2	0	3	0.666666666667
不幸	0	2	1	3	0.666666666667
不在	1	2	0	3	0.666666666667
不合	1	2	0	3	0.666666666667
不利	1	2	0	3	0.666666666667
不准	1	2	0	3	0.666666666667
下载	0	1	2	3	0.666666666667
下有	1	2	0	3	0.666666666667
上次	2	0	1	3	0.666666666667
上坟	1	2	0	3	0.666666666667
上元节	2	0	1	3	0.666666666667
上元	2	0	1	3	0.666666666667
上个月	0	1	2	3	0.666666666667
三千	1	2	0	3	0.666666666667
三人行	1	0	2	3	0.666666666667
万家	2	1	0	3	0.666666666667
万一	1	2	0	3	0.666666666667
七点	2	1	0	3	0.666666666667
一顿	0	2	1	3	0.666666666667
一纸	1	2	0	3	0.666666666667
一篇	2	1	0	3	0.666666666667
一秒	2	1	0	3	0.666666666667
一百	0	2	1	3	0.666666666667
一模一样	0	2	1	3	0.666666666667
一架	2	1	0	3	0.666666666667
一本	1	0	2	3	0.666666666667
一度	1	2	0	3	0.666666666667
一大堆	1	2	0	3	0.666666666667
一夜	0	2	1	3	0.666666666667
一味	1	2	0	3	0.666666666667
一副	2	1	0	3	0.666666666667
一刻	1	0	2	3	0.666666666667
一个月	2	0	1	3	0.666666666667
一两	2	1	0	3	0.666666666667
zf	1	2	0	3	0.666666666667
tfboys	2	1	0	3	0.666666666667
s7	2	1	0	3	0.666666666667
rqlqap2	1	0	2	3	0.666666666667
phonese	0	2	1	3	0.666666666667
note3	1	2	0	3	0.666666666667
md	0	2	1	3	0.666666666667
good	2	0	1	3	0.666666666667
daryanani	1	0	2	3	0.666666666667
cpu	2	1	0	3	0.666666666667
amit	1	0	2	3	0.666666666667
一起	27	7	7	41	0.658536585366
政府	20	59	11	90	0.655555555556
难	5	15	3	23	0.652173913043
确实	15	7	1	23	0.652173913043
每年	15	6	2	23	0.652173913043
联合	5	13	2	20	0.65
哈哈	13	5	2	20	0.65
挺	22	7	5	34	0.647058823529
心	11	6	0	17	0.647058823529
恐怖分子	31	14	3	48	0.645833333333
环境	13	40	9	62	0.645161290323
经济	5	18	5	28	0.642857142857
小时	18	6	4	28	0.642857142857
赶紧	9	3	2	14	0.642857142857
群体	4	9	1	14	0.642857142857
独生	5	9	0	14	0.642857142857
根据	2	3	9	14	0.642857142857
方便	9	4	1	14	0.642857142857
成本	2	9	3	14	0.642857142857
当年	4	9	1	14	0.642857142857
干嘛	4	9	1	14	0.642857142857
垃圾	4	9	1	14	0.642857142857
变成	4	9	1	14	0.642857142857
分析	3	2	9	14	0.642857142857
刀切	2	9	3	14	0.642857142857
一刀切	2	9	3	14	0.642857142857
燃放烟花	5	21	7	33	0.636363636364
放烟	5	21	7	33	0.636363636364
道路	2	7	2	11	0.636363636364
警察	4	7	0	11	0.636363636364
营运	7	0	4	11	0.636363636364
统一	1	7	3	11	0.636363636364
纠结	7	2	2	11	0.636363636364
看法	3	1	7	11	0.636363636364
样子	7	3	1	11	0.636363636364
普	4	7	0	11	0.636363636364
昨晚	7	2	2	11	0.636363636364
早上	7	3	1	11	0.636363636364
新浪	4	7	0	11	0.636363636364
数据	2	2	7	11	0.636363636364
收入	4	7	0	11	0.636363636364
提前	2	2	7	11	0.636363636364
感谢	7	1	3	11	0.636363636364
字	7	4	0	11	0.636363636364
好看	7	3	1	11	0.636363636364
交警	46	16	11	73	0.630136986301
管理	11	27	5	43	0.627906976744
节日	37	10	12	59	0.627118644068
起	12	25	3	40	0.625
睡	4	10	2	16	0.625
抢	10	4	2	16	0.625
多年	4	10	2	16	0.625
倒	10	6	0	16	0.625
伙伴	10	2	4	16	0.625
一代	4	10	2	16	0.625
高中	2	5	1	8	0.625
车辆	2	1	5	8	0.625
身上	1	5	2	8	0.625
讲	2	5	1	8	0.625
街道	2	5	1	8	0.625
行人	5	3	0	8	0.625
者	3	5	0	8	0.625
老妈	5	0	3	8	0.625
福利	2	5	1	8	0.625
祝	5	1	2	8	0.625
石油	5	2	1	8	0.625
知	5	0	3	8	0.625
电瓶车	2	5	1	8	0.625
电瓶	2	5	1	8	0.625
牌照	2	5	1	8	0.625
然	5	1	2	8	0.625
深圳市	3	5	0	8	0.625
法规	2	5	1	8	0.625
梦	5	2	1	8	0.625
权益	2	5	1	8	0.625
最高	1	2	5	8	0.625
智能	0	5	3	8	0.625
晚婚晚育	2	5	1	8	0.625
明明	3	5	0	8	0.625
教	5	0	3	8	0.625
接受	3	5	0	8	0.625
指数	1	5	2	8	0.625
担心	0	5	3	8	0.625
抱	5	2	1	8	0.625
意味着	2	1	5	8	0.625
意味	2	1	5	8	0.625
并非	2	1	5	8	0.625
工资	2	5	1	8	0.625
居民	3	5	0	8	0.625
学	1	5	2	8	0.625
大大	5	3	0	8	0.625
大力	2	5	1	8	0.625
坚决	5	3	0	8	0.625
哪些	2	1	5	8	0.625
咱	3	5	0	8	0.625
后台	5	3	0	8	0.625
军队	5	1	2	8	0.625
内容	5	0	3	8	0.625
公里	2	5	1	8	0.625
体会	5	3	0	8	0.625
代人	2	5	1	8	0.625
今晚	2	1	5	8	0.625
人生	5	2	1	8	0.625
且	2	5	1	8	0.625
上市	1	2	5	8	0.625
上去	5	3	0	8	0.625
三星	5	2	1	8	0.625
一条	1	5	2	8	0.625
烟花爆竹	6	23	8	37	0.621621621622
回家	23	7	7	37	0.621621621622
分子	36	17	5	58	0.620689655172
部门	4	18	7	29	0.620689655172
只有	4	18	7	29	0.620689655172
汽车	10	26	6	42	0.619047619048
设计	6	13	2	21	0.619047619048
教育	6	13	2	21	0.619047619048
只是	8	21	5	34	0.617647058824
is	24	12	3	39	0.615384615385
采取	2	8	3	13	0.615384615385
过节	4	8	1	13	0.615384615385
身体	8	4	1	13	0.615384615385
爸爸	8	2	3	13	0.615384615385
将来	3	8	2	13	0.615384615385
到处	8	2	3	13	0.615384615385
以上	5	8	0	13	0.615384615385
亲	8	2	3	13	0.615384615385
恐怖	52	25	8	85	0.611764705882
支持	66	27	15	108	0.611111111111
靠	4	11	3	18	0.611111111111
非法	11	2	5	18	0.611111111111
特别	11	3	4	18	0.611111111111
毛子	6	11	1	18	0.611111111111
标准	2	11	5	18	0.611111111111
反	5	11	2	18	0.611111111111
出行	4	11	3	18	0.611111111111
爆竹	11	42	16	69	0.608695652174
简单	3	14	6	23	0.608695652174
地铁	14	3	6	23	0.608695652174
骑	7	17	4	28	0.607142857143
打击	17	7	4	28	0.607142857143
妈妈	20	5	8	33	0.606060606061
觉得	52	24	10	86	0.604651162791
霾	8	32	13	53	0.603773584906
可	17	35	6	58	0.603448275862
今年	21	63	21	105	0.6
只	19	42	9	70	0.6
逼	9	21	5	35	0.6
民族	18	8	4	30	0.6
根本	8	15	2	25	0.6
抓	8	15	2	25	0.6
差	7	15	3	25	0.6
陪	12	4	4	20	0.6
推出	2	6	12	20	0.6
哦	12	5	3	20	0.6
禁放	3	9	3	15	0.6
注意	9	3	3	15	0.6
条件	4	9	2	15	0.6
吸引	9	5	1	15	0.6
击落	9	2	4	15	0.6
值得	9	3	3	15	0.6
青春	3	1	6	10	0.6
销售	0	4	6	10	0.6
贵	1	6	3	10	0.6
负责	1	6	3	10	0.6
该不该	1	3	6	10	0.6
脑子	3	6	1	10	0.6
真心	6	1	3	10	0.6
版	2	2	6	10	0.6
消费者	1	3	6	10	0.6
毛	3	6	1	10	0.6
正	2	2	6	10	0.6
某些	4	6	0	10	0.6
暴力	3	6	1	10	0.6
无奈	3	6	1	10	0.6
意识	3	6	1	10	0.6
名	2	6	2	10	0.6
各	6	0	4	10	0.6
博弈	3	6	1	10	0.6
办	6	4	0	10	0.6
了	6	2	2	10	0.6
中心	6	3	1	10	0.6
不见	4	6	0	10	0.6
龙	3	1	1	5	0.6
鲜花	3	1	1	5	0.6
首日	3	0	2	5	0.6
饭	1	3	1	5	0.6
题	1	1	3	5	0.6
预订	1	1	3	5	0.6
顺产	3	1	1	5	0.6
面临	1	1	3	5	0.6
非机动车	3	2	0	5	0.6
零售	0	3	2	5	0.6
间	3	2	0	5	0.6
闯	3	1	1	5	0.6
锅	1	3	1	5	0.6
重视	2	3	0	5	0.6
酒店	1	3	1	5	0.6
遭殃	2	3	0	5	0.6
逻辑	3	2	0	5	0.6
违规	2	3	0	5	0.6
辣	3	1	1	5	0.6
轻易	3	2	0	5	0.6
轻	1	3	1	5	0.6
轰炸机	3	2	0	5	0.6
车祸	2	3	0	5	0.6
跳	3	1	1	5	0.6
超生	2	3	0	5	0.6
资格	1	3	1	5	0.6
费用	2	3	0	5	0.6
负担	3	2	0	5	0.6
该禁	3	2	0	5	0.6
诚意	2	3	0	5	0.6
试试	0	3	2	5	0.6
论坛	3	1	1	5	0.6
融融	3	1	1	5	0.6
萌	2	0	3	5	0.6
花样	1	3	1	5	0.6
聚会	3	0	2	5	0.6
联合国	1	3	1	5	0.6
老婆	1	3	1	5	0.6
罢了	3	2	0	5	0.6
第一次	3	2	0	5	0.6
立	2	3	0	5	0.6
突破	0	3	2	5	0.6
秀	3	0	2	5	0.6
祭祖	3	2	0	5	0.6
神	3	2	0	5	0.6
祝愿	3	2	0	5	0.6
祖宗	3	2	0	5	0.6
社区	1	3	1	5	0.6
破五	3	1	1	5	0.6
眼睛	3	1	1	5	0.6
眼看	1	3	1	5	0.6
百余	3	0	2	5	0.6
痛	3	2	0	5	0.6
疼	3	2	0	5	0.6
疑问	2	3	0	5	0.6
用惯	3	2	0	5	0.6
现	1	1	3	5	0.6
玩意	2	3	0	5	0.6
特区	1	3	1	5	0.6
物质	2	3	0	5	0.6
烟火	3	1	1	5	0.6
溪	3	1	1	5	0.6
流畅	3	2	0	5	0.6
泛滥	2	3	0	5	0.6
格	3	2	0	5	0.6
果然	3	2	0	5	0.6
极	1	1	3	5	0.6
本身	2	3	0	5	0.6
有着	3	1	1	5	0.6
有时候	3	1	1	5	0.6
有利	3	1	1	5	0.6
更为	0	3	2	5	0.6
曝	3	1	1	5	0.6
星期	1	1	3	5	0.6
易	3	2	0	5	0.6
明年	3	2	0	5	0.6
早就	3	1	1	5	0.6
方向	3	1	1	5	0.6
文	2	3	0	5	0.6
攻击	3	2	0	5	0.6
撤军	2	3	0	5	0.6
提问	0	3	2	5	0.6
推	1	1	3	5	0.6
拍摄	2	3	0	5	0.6
报复	3	2	0	5	0.6
扶持	1	3	1	5	0.6
打死	2	3	0	5	0.6
怪不得	2	0	3	5	0.6
忽悠	2	3	0	5	0.6
志愿者	2	3	0	5	0.6
必然	1	3	1	5	0.6
必	3	2	0	5	0.6
心情	3	0	2	5	0.6
心中	3	1	1	5	0.6
很少	3	2	0	5	0.6
形象	3	1	1	5	0.6
当前	1	3	1	5	0.6
年饭	3	2	0	5	0.6
平衡	1	1	3	5	0.6
干什么	0	3	2	5	0.6
帝	3	1	1	5	0.6
布斯	1	3	1	5	0.6
工业	3	1	1	5	0.6
屌	3	1	1	5	0.6
小学生	1	3	1	5	0.6
实际行动	2	3	0	5	0.6
定义	3	1	1	5	0.6
学习	3	1	1	5	0.6
媳妇	1	3	1	5	0.6
媒	2	0	3	5	0.6
好玩	3	2	0	5	0.6
好意思	3	1	1	5	0.6
好意	3	1	1	5	0.6
大屏幕	3	1	1	5	0.6
大众	0	3	2	5	0.6
多个	2	3	0	5	0.6
外国	2	3	0	5	0.6
基地	3	2	0	5	0.6
国家标准	0	2	3	5	0.6
回去	3	1	1	5	0.6
四	2	3	0	5	0.6
喝	3	0	2	5	0.6
啥时候	2	3	0	5	0.6
响声	1	3	1	5	0.6
哈	3	1	1	5	0.6
卷	2	3	0	5	0.6
卧槽	3	1	1	5	0.6
南山	3	0	2	5	0.6
十三	2	3	0	5	0.6
十万	0	3	2	5	0.6
医疗	1	3	1	5	0.6
加重	0	3	2	5	0.6
前提	1	3	1	5	0.6
利比亚	3	1	1	5	0.6
利比	3	1	1	5	0.6
出手	1	3	1	5	0.6
几百	3	1	1	5	0.6
几十	0	2	3	5	0.6
其乐融融	3	1	1	5	0.6
公开	1	3	1	5	0.6
党	1	1	3	5	0.6
借口	2	3	0	5	0.6
体现	3	2	0	5	0.6
会儿	1	3	1	5	0.6
优秀	3	1	1	5	0.6
仍然	2	0	3	5	0.6
今年过年	0	3	2	5	0.6
亿	2	3	0	5	0.6
人民日报	1	3	1	5	0.6
人人	1	3	1	5	0.6
京东	3	1	1	5	0.6
享受	2	0	3	5	0.6
于是	2	3	0	5	0.6
乔布斯	1	3	1	5	0.6
乔布	1	3	1	5	0.6
乐融融	3	1	1	5	0.6
中午	3	0	2	5	0.6
个个	1	3	1	5	0.6
业	2	0	3	5	0.6
不小	3	1	1	5	0.6
不停	0	3	2	5	0.6
上下班	2	3	0	5	0.6
三百余	3	0	2	5	0.6
万元	0	2	3	5	0.6
一组	0	3	2	5	0.6
一把	3	1	1	5	0.6
一批	1	3	1	5	0.6
一会儿	1	3	1	5	0.6
一代人	1	3	1	5	0.6
k	3	1	1	5	0.6
行车	13	34	10	57	0.59649122807
自行车	13	34	10	57	0.59649122807
自行	13	34	10	57	0.59649122807
方式	9	19	4	32	0.59375
增加	4	16	7	27	0.592592592593
鞭炮声	6	13	3	22	0.590909090909
简直	13	8	1	22	0.590909090909
狗	13	2	7	22	0.590909090909
功能	7	13	2	22	0.590909090909
车	6	20	8	34	0.588235294118
意思	10	5	2	17	0.588235294118
如今	4	10	3	17	0.588235294118
养	5	10	2	17	0.588235294118
些	10	4	3	17	0.588235294118
热闹	17	8	4	29	0.586206896552
吃	28	13	7	48	0.583333333333
怕	14	7	3	24	0.583333333333
飞行	7	4	1	12	0.583333333333
长春	3	2	7	12	0.583333333333
记得	7	3	2	12	0.583333333333
爸妈	7	4	1	12	0.583333333333
梦想	7	2	3	12	0.583333333333
更好	5	7	0	12	0.583333333333
控制	7	3	2	12	0.583333333333
心里	4	7	1	12	0.583333333333
就算	7	1	4	12	0.583333333333
大小	7	1	4	12	0.583333333333
国外	7	2	3	12	0.583333333333
因此	3	7	2	12	0.583333333333
危险	4	7	1	12	0.583333333333
力度	5	7	0	12	0.583333333333
元宵	7	3	2	12	0.583333333333
代表	7	4	1	12	0.583333333333
那	28	53	10	91	0.582417582418
啦	18	8	5	31	0.58064516129
准备	18	10	3	31	0.58064516129
马	6	11	2	19	0.578947368421
自由	5	11	3	19	0.578947368421
老人	7	11	1	19	0.578947368421
看着	11	5	3	19	0.578947368421
导致	4	11	4	19	0.578947368421
媒体	4	11	4	19	0.578947368421
假	7	11	1	19	0.578947368421
谁	13	26	6	45	0.577777777778
空气	21	45	12	78	0.576923076923
限制	5	15	6	26	0.576923076923
全国	8	15	3	26	0.576923076923
以前	7	15	4	26	0.576923076923
传统	97	40	32	169	0.573964497041
发展	12	20	3	35	0.571428571429
可是	10	16	2	28	0.571428571429
执法	6	12	3	21	0.571428571429
容易	5	12	4	21	0.571428571429
除夕夜	8	3	3	14	0.571428571429
转发	3	8	3	14	0.571428571429
次	8	3	3	14	0.571428571429
巴沙尔	6	8	0	14	0.571428571429
巴沙	6	8	0	14	0.571428571429
小伙伴	8	2	4	14	0.571428571429
坚持	8	5	1	14	0.571428571429
味儿	8	4	2	14	0.571428571429
刚刚	8	4	2	14	0.571428571429
龙华	4	0	3	7	0.571428571429
频发	3	4	0	7	0.571428571429
预计	2	1	4	7	0.571428571429
韩国	4	2	1	7	0.571428571429
降低	1	4	2	7	0.571428571429
门	2	4	1	7	0.571428571429
造	3	4	0	7	0.571428571429
进步	2	4	1	7	0.571428571429
边境	4	2	1	7	0.571428571429
辛苦	3	4	0	7	0.571428571429
辆	2	1	4	7	0.571428571429
身份	1	2	4	7	0.571428571429
货	1	4	2	7	0.571428571429
责任	3	4	0	7	0.571428571429
袭击	4	2	1	7	0.571428571429
表现	4	3	0	7	0.571428571429
行车道	1	4	2	7	0.571428571429
行政	3	4	0	7	0.571428571429
良心	4	2	1	7	0.571428571429
自行车道	1	4	2	7	0.571428571429
能手	0	4	3	7	0.571428571429
胎	1	4	2	7	0.571428571429
老板	4	3	0	7	0.571428571429
网上	4	1	2	7	0.571428571429
综合	2	1	4	7	0.571428571429
算	4	2	1	7	0.571428571429
第一个	3	0	4	7	0.571428571429
空	4	3	0	7	0.571428571429
称为	1	2	4	7	0.571428571429
破	4	2	1	7	0.571428571429
研究	0	3	4	7	0.571428571429
爱国	1	4	2	7	0.571428571429
熊	3	4	0	7	0.571428571429
浓浓的	4	2	1	7	0.571428571429
浓浓	4	2	1	7	0.571428571429
法治	1	4	2	7	0.571428571429
正确	2	4	1	7	0.571428571429
样	3	4	0	7	0.571428571429
条	4	3	0	7	0.571428571429
机器	2	4	1	7	0.571428571429
有时	4	2	1	7	0.571428571429
智能手机	0	4	3	7	0.571428571429
日常	3	4	0	7	0.571428571429
方法	0	4	3	7	0.571428571429
新机	2	1	4	7	0.571428571429
挖	3	4	0	7	0.571428571429
指纹	4	2	1	7	0.571428571429
持续	4	3	0	7	0.571428571429
招	2	4	1	7	0.571428571429
手里	3	4	0	7	0.571428571429
成功	4	1	2	7	0.571428571429
怒	4	1	2	7	0.571428571429
怎样	4	3	0	7	0.571428571429
忙	4	3	0	7	0.571428571429
建设	2	4	1	7	0.571428571429
度	4	3	0	7	0.571428571429
小哥	3	4	0	7	0.571428571429
婚	0	3	4	7	0.571428571429
姐妹	4	3	0	7	0.571428571429
头	4	1	2	7	0.571428571429
土地	3	4	0	7	0.571428571429
唉	4	3	0	7	0.571428571429
吓	2	4	1	7	0.571428571429
各位	2	4	1	7	0.571428571429
压岁钱	4	0	3	7	0.571428571429
压岁	4	0	3	7	0.571428571429
区	2	4	1	7	0.571428571429
加强	4	3	0	7	0.571428571429
凡是	4	2	1	7	0.571428571429
决策	2	4	1	7	0.571428571429
冲突	1	4	2	7	0.571428571429
再说	3	4	0	7	0.571428571429
关心	4	2	1	7	0.571428571429
共	3	0	4	7	0.571428571429
先生	1	2	4	7	0.571428571429
做好	4	2	1	7	0.571428571429
侵犯	3	4	0	7	0.571428571429
依旧	4	3	0	7	0.571428571429
何	2	4	1	7	0.571428571429
伊朗	1	2	4	7	0.571428571429
任性	2	4	1	7	0.571428571429
今	1	4	2	7	0.571428571429
人口老龄化	2	4	1	7	0.571428571429
五年	4	3	0	7	0.571428571429
二个	4	1	2	7	0.571428571429
买买	4	2	1	7	0.571428571429
主流	0	3	4	7	0.571428571429
为啥	2	4	1	7	0.571428571429
临近	4	2	1	7	0.571428571429
不及	4	2	1	7	0.571428571429
一方面	2	4	1	7	0.571428571429
iphone6s	2	1	4	7	0.571428571429
ios	4	0	3	7	0.571428571429
出现	10	21	6	37	0.567567567568
一定	21	9	7	37	0.567567567568
然后	7	17	6	30	0.566666666667
生育	9	30	14	53	0.566037735849
当	14	30	9	53	0.566037735849
炮声	7	13	3	23	0.565217391304
机动车	13	4	6	23	0.565217391304
机动	13	4	6	23	0.565217391304
基本	7	13	3	23	0.565217391304
燃放	11	35	16	62	0.564516129032
少	33	66	18	117	0.564102564103
希望	27	11	10	48	0.5625
开	6	18	8	32	0.5625
飞机	9	6	1	16	0.5625
这次	9	6	1	16	0.5625
管	9	5	2	16	0.5625
奖励	4	9	3	16	0.5625
之后	4	9	3	16	0.5625
主义	9	6	1	16	0.5625
下去	5	9	2	16	0.5625
一刀	3	9	4	16	0.5625
每天	14	6	5	25	0.56
本来	10	14	1	25	0.56
还要	8	19	7	34	0.558823529412
禁	86	187	62	335	0.558208955224
组织	24	14	5	43	0.558139534884
看到	30	20	4	54	0.555555555556
雾	8	25	12	45	0.555555555556
行为	6	15	6	27	0.555555555556
考虑	6	15	6	27	0.555555555556
生子	7	10	1	18	0.555555555556
尤其	7	10	1	18	0.555555555556
完全	10	7	1	18	0.555555555556
喜庆	10	3	5	18	0.555555555556
哪	5	10	3	18	0.555555555556
高峰	4	0	5	9	0.555555555556
高兴	5	3	1	9	0.555555555556
非	5	2	2	9	0.555555555556
闹	4	5	0	9	0.555555555556
那种	5	1	3	9	0.555555555556
转	3	5	1	9	0.555555555556
超过	2	2	5	9	0.555555555556
规范	2	5	2	9	0.555555555556
节奏	5	4	0	9	0.555555555556
粉丝	2	2	5	9	0.555555555556
祖国	2	5	2	9	0.555555555556
真不	5	4	0	9	0.555555555556
的确	2	5	2	9	0.555555555556
牛	5	3	1	9	0.555555555556
爹	3	5	1	9	0.555555555556
灰	1	5	3	9	0.555555555556
水	2	5	2	9	0.555555555556
武器	5	3	1	9	0.555555555556
正式	3	1	5	9	0.555555555556
李	5	2	2	9	0.555555555556
明天	5	4	0	9	0.555555555556
摄像头	3	1	5	9	0.555555555556
摄像	3	1	5	9	0.555555555556
所有人	5	3	1	9	0.555555555556
我家	5	3	1	9	0.555555555556
必要	5	2	2	9	0.555555555556
小米	3	1	5	9	0.555555555556
小学	3	5	1	9	0.555555555556
同学	3	1	5	9	0.555555555556
合法	1	5	3	9	0.555555555556
原来	4	5	0	9	0.555555555556
即使	2	5	2	9	0.555555555556
利用	5	3	1	9	0.555555555556
入	5	3	1	9	0.555555555556
克兰	5	4	0	9	0.555555555556
像头	3	1	5	9	0.555555555556
做出	5	4	0	9	0.555555555556
便	5	1	3	9	0.555555555556
侵略	4	5	0	9	0.555555555556
企业	2	5	2	9	0.555555555556
乌克兰	5	4	0	9	0.555555555556
不足	1	5	3	9	0.555555555556
不断	2	5	2	9	0.555555555556
不再	5	2	2	9	0.555555555556
下午	5	2	2	9	0.555555555556
上下	3	5	1	9	0.555555555556
一般	3	5	1	9	0.555555555556
不好	12	21	5	38	0.552631578947
家庭	8	16	5	29	0.551724137931
保护	7	16	6	29	0.551724137931
很	81	48	18	147	0.551020408163
要是	6	11	3	20	0.55
炸	7	11	2	20	0.55
以为	5	11	4	20	0.55
不如	11	7	2	20	0.55
利益	10	18	5	33	0.545454545455
两个	18	10	5	33	0.545454545455
路上	12	4	6	22	0.545454545455
活动	12	8	2	22	0.545454545455
恐怖组织	12	8	2	22	0.545454545455
就要	12	7	3	22	0.545454545455
地区	5	12	5	22	0.545454545455
马路	6	4	1	11	0.545454545455
量	0	5	6	11	0.545454545455
身边	6	4	1	11	0.545454545455
谢谢	6	2	3	11	0.545454545455
程度	4	6	1	11	0.545454545455
硬件	4	6	1	11	0.545454545455
法	2	6	3	11	0.545454545455
查	3	6	2	11	0.545454545455
极端	6	3	2	11	0.545454545455
拉客	6	3	2	11	0.545454545455
拉克	3	2	6	11	0.545454545455
执行	6	4	1	11	0.545454545455
性价比	4	6	1	11	0.545454545455
思想	2	6	3	11	0.545454545455
宣布	3	2	6	11	0.545454545455
好多	6	4	1	11	0.545454545455
大部分	6	3	2	11	0.545454545455
大街	6	4	1	11	0.545454545455
坐	6	4	1	11	0.545454545455
回	6	3	2	11	0.545454545455
哪里	6	3	2	11	0.545454545455
变	6	2	3	11	0.545454545455
包括	3	2	6	11	0.545454545455
加	6	2	3	11	0.545454545455
伊拉克	3	2	6	11	0.545454545455
伊拉	3	2	6	11	0.545454545455
了解	6	3	2	11	0.545454545455
不容	2	6	3	11	0.545454545455
不仅	5	6	0	11	0.545454545455
下来	4	6	1	11	0.545454545455
上午	6	3	2	11	0.545454545455
plus	6	1	4	11	0.545454545455
普京	25	18	3	46	0.54347826087
空气污染	7	13	4	24	0.541666666667
民俗	13	5	6	24	0.541666666667
限电	69	150	58	277	0.541516245487
需要	22	33	6	61	0.540983606557
污染	27	47	13	87	0.540229885057
晨	12	0	14	26	0.538461538462
讨论	1	7	5	13	0.538461538462
规	3	3	7	13	0.538461538462
罚款	5	7	1	13	0.538461538462
牌	5	7	1	13	0.538461538462
款	7	2	4	13	0.538461538462
查扣	3	3	7	13	0.538461538462
有没有	7	3	3	13	0.538461538462
既然	6	7	0	13	0.538461538462
整个	7	5	1	13	0.538461538462
放弃	7	4	2	13	0.538461538462
挂	7	6	0	13	0.538461538462
定	5	1	7	13	0.538461538462
女人	5	7	1	13	0.538461538462
叙	7	5	1	13	0.538461538462
出生	7	6	0	13	0.538461538462
今日	5	1	7	13	0.538461538462
两	2	4	7	13	0.538461538462
上班	4	7	2	13	0.538461538462
上海	3	7	3	13	0.538461538462
一半	4	7	2	13	0.538461538462
重要	22	9	10	41	0.536585365854
限	5	15	8	28	0.535714285714
父母	15	11	2	28	0.535714285714
好好	15	9	4	28	0.535714285714
方面	16	8	6	30	0.533333333333
必须	16	9	5	30	0.533333333333
呼吁	10	16	4	30	0.533333333333
金	8	3	4	15	0.533333333333
那个	8	3	4	15	0.533333333333
遵守	8	5	2	15	0.533333333333
记者	6	1	8	15	0.533333333333
规则	7	8	0	15	0.533333333333
未来	5	8	2	15	0.533333333333
晚上	8	3	4	15	0.533333333333
应	4	8	3	15	0.533333333333
平民	6	8	1	15	0.533333333333
小伙	8	3	4	15	0.533333333333
实在	8	6	1	15	0.533333333333
人员	1	8	6	15	0.533333333333
不让	8	7	0	15	0.533333333333
关系	17	9	6	32	0.53125
而且	18	13	3	34	0.529411764706
违法	9	6	2	17	0.529411764706
是因为	9	7	1	17	0.529411764706
敢	7	9	1	17	0.529411764706
政治	5	9	3	17	0.529411764706
国产	5	9	3	17	0.529411764706
嘛	6	9	2	17	0.529411764706
全	9	5	3	17	0.529411764706
专家	4	9	4	17	0.529411764706
多	55	103	37	195	0.528205128205
为了	25	39	10	74	0.527027027027
死	15	20	3	38	0.526315789474
集中	2	7	10	19	0.526315789474
至	6	10	3	19	0.526315789474
来看	10	5	4	19	0.526315789474
手	10	5	4	19	0.526315789474
寸	10	5	4	19	0.526315789474
家人	10	8	1	19	0.526315789474
制定	1	10	8	19	0.526315789474
不用	7	10	2	19	0.526315789474
三	8	10	1	19	0.526315789474
pm2	7	10	2	19	0.526315789474
5	7	10	2	19	0.526315789474
过年	51	34	12	97	0.525773195876
所	5	11	5	21	0.52380952381
性能	11	6	4	21	0.52380952381
平安	11	9	1	21	0.52380952381
够	7	11	3	21	0.52380952381
卓	11	5	5	21	0.52380952381
不多	11	8	2	21	0.52380952381
如果	21	45	20	86	0.523255813953
土	9	12	2	23	0.521739130435
问题	30	49	15	94	0.521276595745
不放	7	13	5	25	0.52
姚	13	0	14	27	0.518518518519
人家	14	8	5	27	0.518518518519
isis	14	11	2	27	0.518518518519
跟	30	13	15	58	0.51724137931
不能	34	49	12	95	0.515789473684
行	7	18	10	35	0.514285714286
时代	10	18	7	35	0.514285714286
土耳其	39	21	16	76	0.513157894737
不	195	317	106	618	0.512944983819
味	20	10	9	39	0.512820512821
吗	62	101	34	197	0.51269035533
怀	19	1	21	41	0.512195121951
么	16	22	5	43	0.511627906977
虽然	14	23	8	45	0.511111111111
工作	14	24	9	47	0.510638297872
反对	19	24	4	47	0.510638297872
摩	92	176	77	345	0.510144927536
去	36	56	18	110	0.509090909091
城市	19	34	14	67	0.507462686567
开放	65	104	36	205	0.507317073171
没有	66	105	36	207	0.507246376812
那么	20	36	15	71	0.507042253521
烟花	24	42	17	83	0.506024096386
大家	29	44	15	88	0.5
而	31	42	11	84	0.5
交通	22	33	11	66	0.5
人民	16	29	13	58	0.5
爱	26	14	12	52	0.5
拿	18	24	6	48	0.5
市民	6	19	13	38	0.5
除夕	18	12	6	36	0.5
禁止	10	18	8	36	0.5
宝宝	17	8	9	34	0.5
或者	8	15	7	30	0.5
安	15	9	6	30	0.5
妈	12	14	2	28	0.5
不想	9	14	5	28	0.5
放炮	9	13	4	26	0.5
报道	5	7	12	24	0.5
您	8	4	12	24	0.5
呀	12	8	4	24	0.5
事故	9	12	3	24	0.5
小孩	9	11	2	22	0.5
家	5	11	6	22	0.5
国内	11	5	6	22	0.5
道	8	10	2	20	0.5
能力	3	10	7	20	0.5
看来	10	6	4	20	0.5
沙特	10	4	6	20	0.5
引发	1	9	10	20	0.5
出台	4	10	6	20	0.5
全世界	10	8	2	20	0.5
伊斯兰	10	6	4	20	0.5
伊斯	10	6	4	20	0.5
gb	7	3	10	20	0.5
据	3	6	9	18	0.5
干	7	9	2	18	0.5
女	3	9	6	18	0.5
同时	4	9	5	18	0.5
去年	2	9	7	18	0.5
别人	7	9	2	18	0.5
内存	4	9	5	18	0.5
花	8	8	0	16	0.5
明显	5	8	3	16	0.5
差不多	7	8	1	16	0.5
孩	5	8	3	16	0.5
学生	6	8	2	16	0.5
听	8	5	3	16	0.5
公交	6	8	2	16	0.5
不行	5	8	3	16	0.5
闯红灯	7	6	1	14	0.5
长大	6	7	1	14	0.5
过大年	7	7	0	14	0.5
续航	7	6	1	14	0.5
省	7	4	3	14	0.5
未	4	7	3	14	0.5
新春	3	7	4	14	0.5
学校	4	7	3	14	0.5
娃	5	7	2	14	0.5
好处	5	7	2	14	0.5
天气	2	7	5	14	0.5
处理	3	7	4	14	0.5
参与	7	5	2	14	0.5
加上	4	7	3	14	0.5
出去	6	7	1	14	0.5
傻	7	6	1	14	0.5
体验	7	5	2	14	0.5
习惯	2	5	7	14	0.5
不可	7	3	4	14	0.5
一句	7	3	4	14	0.5
骂	6	4	2	12	0.5
矛盾	4	6	2	12	0.5
特	6	5	1	12	0.5
燃放鞭炮	4	6	2	12	0.5
炮	6	4	2	12	0.5
清楚	2	6	4	12	0.5
消费	1	5	6	12	0.5
污染环境	4	6	2	12	0.5
每次	5	6	1	12	0.5
政府军	6	6	0	12	0.5
大部	6	4	2	12	0.5
多数	3	6	3	12	0.5
外形	6	3	3	12	0.5
告诉	6	2	4	12	0.5
听到	5	6	1	12	0.5
合理	6	3	3	12	0.5
凌晨	1	6	5	12	0.5
俄国	4	6	2	12	0.5
以来	4	2	6	12	0.5
人类	6	5	1	12	0.5
不敢	6	4	2	12	0.5
一部	6	3	3	12	0.5
一件	3	6	3	12	0.5
针对	2	3	5	10	0.5
还好	5	3	2	10	0.5
议	1	4	5	10	0.5
背后	5	4	1	10	0.5
编	5	2	3	10	0.5
素质	5	5	0	10	0.5
笑	5	3	2	10	0.5
相对	5	2	3	10	0.5
消灭	5	4	1	10	0.5
武装	5	3	2	10	0.5
此	5	1	4	10	0.5
正义	3	5	2	10	0.5
提醒	5	3	2	10	0.5
拼	2	3	5	10	0.5
意见	2	5	3	10	0.5
意义	5	3	2	10	0.5
很大	1	5	4	10	0.5
强大	4	1	5	10	0.5
实行	5	4	1	10	0.5
完成	5	5	0	10	0.5
好事	2	5	3	10	0.5
奶奶	4	5	1	10	0.5
多么	3	5	2	10	0.5
图片	4	1	5	10	0.5
国际	5	5	0	10	0.5
喷	5	3	2	10	0.5
名字	5	4	1	10	0.5
可惜	1	4	5	10	0.5
占	5	3	2	10	0.5
剥夺	3	5	2	10	0.5
出门	4	5	1	10	0.5
农历	5	1	4	10	0.5
军事	5	4	1	10	0.5
信	5	1	4	10	0.5
依然	1	5	4	10	0.5
你家	5	3	2	10	0.5
交通规则	5	5	0	10	0.5
不然	5	4	1	10	0.5
一切	5	4	1	10	0.5
apple	1	4	5	10	0.5
黑	4	3	1	8	0.5
麻烦	1	3	4	8	0.5
高端	2	4	2	8	0.5
风险	2	4	2	8	0.5
顺利	4	1	3	8	0.5
陈	4	2	2	8	0.5
那样	2	4	2	8	0.5
这点	4	4	0	8	0.5
运行	3	4	1	8	0.5
较	2	2	4	8	0.5
西安	4	2	2	8	0.5
至少	2	4	2	8	0.5
自从	2	2	4	8	0.5
肚子	4	0	4	8	0.5
维护	4	4	0	8	0.5
经历	4	2	2	8	0.5
精彩	3	1	4	8	0.5
目标	4	2	2	8	0.5
氛围	4	3	1	8	0.5
母亲	3	4	1	8	0.5
槽	3	4	1	8	0.5
某	1	3	4	8	0.5
来临	2	4	2	8	0.5
杀	3	4	1	8	0.5
暂时	4	2	2	8	0.5
拥有	4	2	2	8	0.5
房子	2	4	2	8	0.5
怪	4	4	0	8	0.5
当时	1	3	4	8	0.5
年初一	2	4	2	8	0.5
年代	4	3	1	8	0.5
帮忙	2	2	4	8	0.5
尽	1	4	3	8	0.5
尼玛	1	4	3	8	0.5
孕妇	4	1	3	8	0.5
娱乐	4	2	2	8	0.5
妹	3	4	1	8	0.5
大战	1	3	4	8	0.5
大年初一	2	4	2	8	0.5
大多	4	3	1	8	0.5
在家	3	4	1	8	0.5
哥	4	2	2	8	0.5
周围	3	4	1	8	0.5
吐	2	4	2	8	0.5
印度	0	4	4	8	0.5
南京	4	3	1	8	0.5
十几	3	4	1	8	0.5
区别	2	4	2	8	0.5
再次	1	4	3	8	0.5
公共	1	4	3	8	0.5
全民	4	4	0	8	0.5
光	4	3	1	8	0.5
供应	1	3	4	8	0.5
作	4	1	3	8	0.5
令	4	3	1	8	0.5
二十	4	4	0	8	0.5
之间	2	2	4	8	0.5
之一	4	3	1	8	0.5
为何	4	3	1	8	0.5
东	2	4	2	8	0.5
三百	4	2	2	8	0.5
c	2	2	4	8	0.5
鼻	3	3	0	6	0.5
领土	1	3	2	6	0.5
项目	3	1	2	6	0.5
难以	2	3	1	6	0.5
随便	1	3	2	6	0.5
除	0	3	3	6	0.5
附近	1	3	2	6	0.5
阖家	3	2	1	6	0.5
长期	2	1	3	6	0.5
错	3	2	1	6	0.5
铁口	3	1	2	6	0.5
配	2	3	1	6	0.5
部件	0	3	3	6	0.5
这事	1	2	3	6	0.5
过程	3	1	2	6	0.5
辞职	3	2	1	6	0.5
赶	3	2	1	6	0.5
赞成	3	2	1	6	0.5
谈	2	1	3	6	0.5
说好	3	3	0	6	0.5
说出	2	3	1	6	0.5
蛇	2	3	1	6	0.5
舆论	0	3	3	6	0.5
自然	3	3	0	6	0.5
育儿	3	3	0	6	0.5
聊	3	1	2	6	0.5
老师	3	2	1	6	0.5
老实	1	3	2	6	0.5
网站	0	3	3	6	0.5
结	3	2	1	6	0.5
精神	2	3	1	6	0.5
粉	1	2	3	6	0.5
第二个	3	1	2	6	0.5
禁行	3	3	0	6	0.5
直到	3	1	2	6	0.5
疯	3	2	1	6	0.5
男孩	1	3	2	6	0.5
男人	0	3	3	6	0.5
片	3	3	0	6	0.5
爸	2	1	3	6	0.5
烧	3	3	0	6	0.5
炸伤	1	2	3	6	0.5
深	1	2	3	6	0.5
河南	3	2	1	6	0.5
没想到	1	3	2	6	0.5
没想	1	3	2	6	0.5
气	3	2	1	6	0.5
每日	2	1	3	6	0.5
欢度春节	2	3	1	6	0.5
楼	2	3	1	6	0.5
枪	2	3	1	6	0.5
机构	2	1	3	6	0.5
本人	1	3	2	6	0.5
有感	3	3	0	6	0.5
曝光	2	1	3	6	0.5
智	3	1	2	6	0.5
显然	3	3	0	6	0.5
明	2	3	1	6	0.5
旧	2	3	1	6	0.5
既	1	3	2	6	0.5
旁边	2	1	3	6	0.5
放点	2	1	3	6	0.5
收拾	2	3	1	6	0.5
提供	3	0	3	6	0.5
损害	1	2	3	6	0.5
指责	3	3	0	6	0.5
抱怨	2	3	1	6	0.5
报	3	0	3	6	0.5
扣	2	3	1	6	0.5
战略	3	2	1	6	0.5
战斗	3	3	0	6	0.5
慢	1	2	3	6	0.5
意外	3	1	2	6	0.5
悲剧	2	3	1	6	0.5
急	2	1	3	6	0.5
思维	1	2	3	6	0.5
忽视	3	2	1	6	0.5
心疼	3	1	2	6	0.5
往往	2	3	1	6	0.5
彻底	3	3	0	6	0.5
形式	3	3	0	6	0.5
强制	0	3	3	6	0.5
店	2	3	1	6	0.5
应对	1	3	2	6	0.5
年来	1	3	2	6	0.5
年三十	1	3	2	6	0.5
帮助	3	2	1	6	0.5
尔	3	2	1	6	0.5
小孩子	3	3	0	6	0.5
小区	2	1	3	6	0.5
宣传	2	3	1	6	0.5
实施	3	3	0	6	0.5
宗教	3	1	2	6	0.5
完整	3	3	0	6	0.5
完善	2	3	1	6	0.5
安静	1	3	2	6	0.5
始终	3	3	0	6	0.5
妇女	1	3	2	6	0.5
女生	3	1	2	6	0.5
失去	3	3	0	6	0.5
夫妻	3	2	1	6	0.5
塞	3	3	0	6	0.5
地铁口	3	1	2	6	0.5
地位	1	2	3	6	0.5
在于	0	3	3	6	0.5
回答	2	1	3	6	0.5
四个	1	2	3	6	0.5
品牌	0	3	3	6	0.5
周	3	1	2	6	0.5
君	2	3	1	6	0.5
后果	3	2	1	6	0.5
另外	2	3	1	6	0.5
另	2	3	1	6	0.5
叔叔	3	3	0	6	0.5
发言	3	2	1	6	0.5
博客	1	2	3	6	0.5
半年	3	0	3	6	0.5
化	1	3	2	6	0.5
努力	2	1	3	6	0.5
刺激	2	3	1	6	0.5
制度	2	3	1	6	0.5
凤凰	2	3	1	6	0.5
像是	1	3	2	6	0.5
催	3	0	3	6	0.5
俩	2	3	1	6	0.5
保障	3	3	0	6	0.5
保留	3	0	3	6	0.5
伟大	3	2	1	6	0.5
件	3	2	1	6	0.5
什么样	2	3	1	6	0.5
人权	3	2	1	6	0.5
人为	2	3	1	6	0.5
五	2	3	1	6	0.5
互相	1	3	2	6	0.5
乐	2	3	1	6	0.5
之外	1	2	3	6	0.5
主意	3	2	1	6	0.5
不止	3	2	1	6	0.5
不得不	3	2	1	6	0.5
不下	1	2	3	6	0.5
万部	2	1	3	6	0.5
一名	1	3	2	6	0.5
一位	1	3	2	6	0.5
一会	1	3	2	6	0.5
phone	2	3	1	6	0.5
鸡肋	1	2	1	4	0.5
驱逐	1	1	2	4	0.5
预产期	2	0	2	4	0.5
预产	2	0	2	4	0.5
顺便	1	1	2	4	0.5
音乐	2	0	2	4	0.5
面前	2	0	2	4	0.5
面	2	1	1	4	0.5
非得	2	2	0	4	0.5
零部件	0	2	2	4	0.5
集体	1	2	1	4	0.5
阵营	2	0	2	4	0.5
长辈	1	2	1	4	0.5
错误	1	2	1	4	0.5
鉴于	1	2	1	4	0.5
金色	2	0	2	4	0.5
重度	2	2	0	4	0.5
采访	2	0	2	4	0.5
醉	2	2	0	4	0.5
酷	1	2	1	4	0.5
配色	2	1	1	4	0.5
配备	0	2	2	4	0.5
配合	1	1	2	4	0.5
鄙视	2	2	0	4	0.5
部	2	1	1	4	0.5
逐渐	2	0	2	4	0.5
选	1	1	2	4	0.5
逆	2	1	1	4	0.5
近期	1	1	2	4	0.5
运	1	2	1	4	0.5
迎新	2	2	0	4	0.5
边框	2	2	0	4	0.5
辖区	2	0	2	4	0.5
轻松	2	1	1	4	0.5
转载	1	2	1	4	0.5
车速	2	0	2	4	0.5
身材	2	0	2	4	0.5
起步	0	2	2	4	0.5
赶到	2	1	1	4	0.5
赞同	1	2	1	4	0.5
资讯	1	2	1	4	0.5
负面影响	2	2	0	4	0.5
负面	2	2	0	4	0.5
谱	1	2	1	4	0.5
调	2	1	1	4	0.5
识别	2	2	0	4	0.5
评	1	1	2	4	0.5
证明	1	1	2	4	0.5
设备	1	1	2	4	0.5
解锁	2	1	1	4	0.5
规模	2	1	1	4	0.5
要脸	1	2	1	4	0.5
西	1	2	1	4	0.5
表达	1	2	1	4	0.5
表演	2	1	1	4	0.5
表明	2	1	1	4	0.5
衣服	1	2	1	4	0.5
菜	2	1	1	4	0.5
获得	1	1	2	4	0.5
药	1	2	1	4	0.5
芯片	2	2	0	4	0.5
自我	1	2	1	4	0.5
腊月	2	1	1	4	0.5
脑	2	2	0	4	0.5
能量	1	2	1	4	0.5
能否	1	1	2	4	0.5
胞胎	2	2	0	4	0.5
背	1	2	1	4	0.5
聊天	2	1	1	4	0.5
耶	1	1	2	4	0.5
而言	2	2	0	4	0.5
考	1	1	2	4	0.5
老子	1	2	1	4	0.5
老二	1	2	1	4	0.5
网易	1	1	2	4	0.5
缺乏	0	2	2	4	0.5
统观	1	2	1	4	0.5
结合	2	1	1	4	0.5
组成	2	1	1	4	0.5
糟糕	2	1	1	4	0.5
类	1	2	1	4	0.5
答	2	1	1	4	0.5
等待	1	1	2	4	0.5
等到	2	1	1	4	0.5
第二天	1	2	1	4	0.5
第三次	0	2	2	4	0.5
第一胎	1	2	1	4	0.5
竞争	2	2	0	4	0.5
站点	1	2	1	4	0.5
立交	2	0	2	4	0.5
窗外	2	2	0	4	0.5
突出	1	1	2	4	0.5
积极响应	2	1	1	4	0.5
秩序	2	2	0	4	0.5
礼物	2	1	1	4	0.5
眼前	2	2	0	4	0.5
眼	1	2	1	4	0.5
真实	2	1	1	4	0.5
看似	1	1	2	4	0.5
看不到	2	1	1	4	0.5
相机	2	1	1	4	0.5
相同	2	0	2	4	0.5
皮肤	1	1	2	4	0.5
百度	2	1	1	4	0.5
病	2	1	1	4	0.5
留言	2	0	2	4	0.5
留	2	2	0	4	0.5
电视台	2	2	0	4	0.5
电视剧	0	2	2	4	0.5
用来	1	2	1	4	0.5
玩儿	2	1	1	4	0.5
王八	2	2	0	4	0.5
猜	2	1	1	4	0.5
独特	2	1	1	4	0.5
状态	2	2	0	4	0.5
状况	2	1	1	4	0.5
爽	2	1	1	4	0.5
热热闹闹	2	2	0	4	0.5
热热	2	2	0	4	0.5
灾难	1	2	1	4	0.5
灰色	2	1	1	4	0.5
潮	2	1	1	4	0.5
漠视	2	2	0	4	0.5
满足	2	1	1	4	0.5
满满	1	2	1	4	0.5
满	2	2	0	4	0.5
港	0	2	2	4	0.5
温暖	2	2	0	4	0.5
清明	1	2	1	4	0.5
清扫	1	2	1	4	0.5
混	2	0	2	4	0.5
浙江	2	1	1	4	0.5
测试	1	1	2	4	0.5
派出所	2	1	1	4	0.5
波	2	0	2	4	0.5
法国	1	1	2	4	0.5
沈阳	2	1	1	4	0.5
民警	1	1	2	4	0.5
比起	2	1	1	4	0.5
此次	1	1	2	4	0.5
此外	0	2	2	4	0.5
正月初一	2	1	1	4	0.5
概念	1	2	1	4	0.5
林	1	2	1	4	0.5
机身	1	2	1	4	0.5
有感而发	2	2	0	4	0.5
有意	1	2	1	4	0.5
最为	1	2	1	4	0.5
暗	2	2	0	4	0.5
晒	2	1	1	4	0.5
春风	2	1	1	4	0.5
星	1	2	1	4	0.5
时速	2	1	1	4	0.5
早点	1	2	1	4	0.5
旗号	2	2	0	4	0.5
方	2	1	1	4	0.5
新区	2	0	2	4	0.5
斤	2	1	1	4	0.5
斗	1	1	2	4	0.5
文字	2	1	1	4	0.5
整体	2	2	0	4	0.5
整	2	2	0	4	0.5
数量	1	1	2	4	0.5
敏感	0	2	2	4	0.5
敌人	0	2	2	4	0.5
放在	2	1	1	4	0.5
收到	2	2	0	4	0.5
播	0	2	2	4	0.5
摊	2	1	1	4	0.5
推迟	1	2	1	4	0.5
推荐	2	1	1	4	0.5
推翻	2	2	0	4	0.5
排号	1	2	1	4	0.5
损失	0	2	2	4	0.5
挣钱	2	2	0	4	0.5
指纹识别	2	2	0	4	0.5
指	1	2	1	4	0.5
拥挤	2	2	0	4	0.5
承认	2	1	1	4	0.5
扩散	1	2	1	4	0.5
戳	2	0	2	4	0.5
成立	1	1	2	4	0.5
成熟	0	2	2	4	0.5
成员	2	1	1	4	0.5
感情	1	1	2	4	0.5
感到	2	2	0	4	0.5
恋爱	2	0	2	4	0.5
总体	2	1	1	4	0.5
思考	1	2	1	4	0.5
念	1	1	2	4	0.5
心理	0	2	2	4	0.5
心愿	0	2	2	4	0.5
心动	2	1	1	4	0.5
得出	1	2	1	4	0.5
当天	2	0	2	4	0.5
弱	2	0	2	4	0.5
引	1	1	2	4	0.5
开门	1	2	1	4	0.5
建	1	1	2	4	0.5
应有	2	1	1	4	0.5
库曼	2	2	0	4	0.5
库尔德人	2	1	1	4	0.5
幼稚	2	1	1	4	0.5
年纪	2	0	2	4	0.5
平	1	2	1	4	0.5
巴尔米	2	1	1	4	0.5
巴尔	2	1	1	4	0.5
巨大	0	2	2	4	0.5
岗位	2	2	0	4	0.5
屁股	2	2	0	4	0.5
就是说	2	1	1	4	0.5
少数	2	1	1	4	0.5
小心	1	1	2	4	0.5
小年夜	2	1	1	4	0.5
对象	2	1	1	4	0.5
对付	1	2	1	4	0.5
家乡	2	1	1	4	0.5
客机	2	1	1	4	0.5
实体	0	2	2	4	0.5
定性	1	2	1	4	0.5
完美	2	1	1	4	0.5
存	2	2	0	4	0.5
子宫	2	1	1	4	0.5
子孙	2	2	0	4	0.5
好久	2	2	0	4	0.5
好不好	2	2	0	4	0.5
她们	1	2	1	4	0.5
女士	1	1	2	4	0.5
套	2	2	0	4	0.5
头上	0	2	2	4	0.5
央视	0	2	2	4	0.5
天津	0	2	2	4	0.5
大年三十	1	2	1	4	0.5
大帝	2	2	0	4	0.5
多些	1	1	2	4	0.5
复杂	2	1	1	4	0.5
基	2	1	1	4	0.5
培养	2	2	0	4	0.5
城市交通	1	2	1	4	0.5
圣战	2	1	1	4	0.5
土库曼	2	2	0	4	0.5
土库	2	2	0	4	0.5
国标	1	2	1	4	0.5
国度	2	2	0	4	0.5
国产机	2	2	0	4	0.5
国产手机	0	2	2	4	0.5
回忆	2	2	0	4	0.5
嘴巴	1	2	1	4	0.5
嗯	2	1	1	4	0.5
商业	2	1	1	4	0.5
唐	2	0	2	4	0.5
哎	2	1	1	4	0.5
响起	1	2	1	4	0.5
和谈	2	2	0	4	0.5
告知	0	2	2	4	0.5
吵	2	2	0	4	0.5
吴	2	0	2	4	0.5
否认	1	2	1	4	0.5
同性恋	1	1	2	4	0.5
同性	1	1	2	4	0.5
各国	0	2	2	4	0.5
古代	1	1	2	4	0.5
发达国家	2	1	1	4	0.5
发起	2	2	0	4	0.5
反映	1	2	1	4	0.5
双胞胎	2	2	0	4	0.5
双胞	2	2	0	4	0.5
及时	1	2	1	4	0.5
原文	2	1	1	4	0.5
即便	1	2	1	4	0.5
升高	2	2	0	4	0.5
十字	2	1	1	4	0.5
十多年	1	2	1	4	0.5
十分	2	1	1	4	0.5
北极熊	1	2	1	4	0.5
北极	1	2	1	4	0.5
动作	2	0	2	4	0.5
动不动	2	2	0	4	0.5
办理	2	0	2	4	0.5
办公	2	1	1	4	0.5
副	2	1	1	4	0.5
前两天	2	1	1	4	0.5
到手	2	2	0	4	0.5
利于	2	2	0	4	0.5
分辨	2	0	2	4	0.5
分裂	1	1	2	4	0.5
出动	2	0	2	4	0.5
凌	2	0	2	4	0.5
冒	1	2	1	4	0.5
内外	1	2	1	4	0.5
其次	2	2	0	4	0.5
公然	1	1	2	4	0.5
公平	1	1	2	4	0.5
公交站	1	2	1	4	0.5
克里	2	1	1	4	0.5
光是	0	2	2	4	0.5
催生	0	2	2	4	0.5
假日	0	2	2	4	0.5
倾向	1	1	2	4	0.5
信仰	2	2	0	4	0.5
保险	2	0	2	4	0.5
俗	1	2	1	4	0.5
俄新社	2	0	2	4	0.5
供应链	0	2	2	4	0.5
佳	2	0	2	4	0.5
作者	1	2	1	4	0.5
作用	2	2	0	4	0.5
位置	1	2	1	4	0.5
传统观念	1	2	1	4	0.5
优势	2	2	0	4	0.5
付出	1	2	1	4	0.5
人士	0	2	2	4	0.5
亮点	1	2	1	4	0.5
产期	2	0	2	4	0.5
二房	0	2	2	4	0.5
二天	1	2	1	4	0.5
事实上	1	2	1	4	0.5
乱象	2	2	0	4	0.5
买单	2	2	0	4	0.5
也就是说	2	1	1	4	0.5
乐意	2	1	1	4	0.5
之类	1	2	1	4	0.5
举行	2	1	1	4	0.5
主题	2	2	0	4	0.5
为首	2	1	1	4	0.5
串	1	2	1	4	0.5
中间	2	2	0	4	0.5
两次	2	2	0	4	0.5
东莞	2	1	1	4	0.5
世界大战	0	2	2	4	0.5
世代	2	1	1	4	0.5
专业	1	2	1	4	0.5
不顾	2	2	0	4	0.5
不算	2	1	1	4	0.5
不必	1	1	2	4	0.5
不开	1	2	1	4	0.5
不好意思	2	1	1	4	0.5
不动	2	2	0	4	0.5
不但	1	2	1	4	0.5
下一代	2	2	0	4	0.5
上学	2	2	0	4	0.5
上个	0	2	2	4	0.5
三次	0	2	2	4	0.5
一项	1	2	1	4	0.5
一路	2	2	0	4	0.5
一段时间	2	1	1	4	0.5
一日	0	2	2	4	0.5
一战	1	2	1	4	0.5
一家人	2	2	0	4	0.5
一声	1	2	1	4	0.5
一团	2	0	2	4	0.5
tmd	2	1	1	4	0.5
m9	1	1	2	4	0.5
km	2	0	2	4	0.5
iphone7	1	2	1	4	0.5
iphone5	2	2	0	4	0.5
com	2	2	0	4	0.5
app	1	2	1	4	0.5
3	1	1	2	4	0.5
鼻子	1	1	0	2	0.5
鼠	1	1	0	2	0.5
默认	0	1	1	2	0.5
黎巴嫩	0	1	1	2	0.5
鹰	1	0	1	2	0.5
鹏	1	1	0	2	0.5
鸣	1	0	1	2	0.5
鸡飞狗跳	0	1	1	2	0.5
鸟	0	1	1	2	0.5
魅力	1	1	0	2	0.5
高龄产妇	1	0	1	2	0.5
高龄	1	0	1	2	0.5
高清	0	1	1	2	0.5
高架	1	0	1	2	0.5
骡子	1	1	0	2	0.5
骗子	1	0	1	2	0.5
驾驶员	1	0	1	2	0.5
馨	1	0	1	2	0.5
首页	1	1	0	2	0.5
首选	1	1	0	2	0.5
首次	0	1	1	2	0.5
饥饿	0	1	1	2	0.5
餐	1	1	0	2	0.5
食物	0	1	1	2	0.5
风范	1	1	0	2	0.5
风光	1	0	1	2	0.5
频频	0	1	1	2	0.5
预定	1	1	0	2	0.5
音	1	1	0	2	0.5
非洲	1	1	0	2	0.5
非一日之寒	0	1	1	2	0.5
霸权	1	1	0	2	0.5
露出	1	1	0	2	0.5
霍姆斯	0	1	1	2	0.5
震惊	0	1	1	2	0.5
雷声大雨	0	1	1	2	0.5
雷声大	0	1	1	2	0.5
雷声	0	1	1	2	0.5
零距离	0	1	1	2	0.5
零售店	0	1	1	2	0.5
零件	1	0	1	2	0.5
零	0	1	1	2	0.5
雏形	1	1	0	2	0.5
难得	1	1	0	2	0.5
难免	1	1	0	2	0.5
难事	1	1	0	2	0.5
障碍	0	1	1	2	0.5
随后	0	1	1	2	0.5
隆隆	1	1	0	2	0.5
隆重	1	0	1	2	0.5
限量	1	1	0	2	0.5
限购	1	1	0	2	0.5
陆续	1	1	0	2	0.5
阴	1	1	0	2	0.5
防范	1	0	1	2	0.5
防火	1	1	0	2	0.5
防水	0	1	1	2	0.5
防止	0	1	1	2	0.5
防护	1	0	1	2	0.5
防	0	1	1	2	0.5
队伍	1	1	0	2	0.5
阖家欢乐	0	1	1	2	0.5
阖家欢	0	1	1	2	0.5
阖家团圆	1	1	0	2	0.5
闺女	1	0	1	2	0.5
间接	0	1	1	2	0.5
闲钱	1	1	0	2	0.5
问问	1	1	0	2	0.5
问世	0	1	1	2	0.5
闪闪	1	0	1	2	0.5
长线	0	1	1	2	0.5
长春市	1	0	1	2	0.5
长时间	1	1	0	2	0.5
长大成人	1	1	0	2	0.5
锣鼓喧天	1	0	1	2	0.5
错过	1	0	1	2	0.5
钻	1	1	0	2	0.5
钥匙	1	1	0	2	0.5
量力	1	0	1	2	0.5
重庆	1	0	1	2	0.5
重复	1	1	0	2	0.5
重回	0	1	1	2	0.5
醒	0	1	1	2	0.5
酝酿	1	0	1	2	0.5
配送	0	1	1	2	0.5
配上	1	0	1	2	0.5
郭	0	1	1	2	0.5
部长	1	1	0	2	0.5
那位	1	1	0	2	0.5
邀	1	1	0	2	0.5
避	1	1	0	2	0.5
遵	0	1	1	2	0.5
遭受	1	1	0	2	0.5
遍地	1	1	0	2	0.5
遇难	1	1	0	2	0.5
遇	1	1	0	2	0.5
造孽	0	1	1	2	0.5
通讯	1	1	0	2	0.5
逐	1	0	1	2	0.5
送暖	0	1	1	2	0.5
退步	1	1	0	2	0.5
退休金	1	1	0	2	0.5
迷藏	0	1	1	2	0.5
迫使	1	0	1	2	0.5
连环	1	0	1	2	0.5
远征	1	1	0	2	0.5
远去	0	1	1	2	0.5
进展	1	0	1	2	0.5
这点儿	1	1	0	2	0.5
这样的话	1	1	0	2	0.5
这时	1	0	1	2	0.5
这方面	1	1	0	2	0.5
这方	1	1	0	2	0.5
还行	1	1	0	2	0.5
还给	1	0	1	2	0.5
过期	0	1	1	2	0.5
过度	1	1	0	2	0.5
辽宁	1	1	0	2	0.5
边界	1	0	1	2	0.5
辩证	1	1	0	2	0.5
输入	1	1	0	2	0.5
较为	1	0	1	2	0.5
轿车	1	1	0	2	0.5
载	1	1	0	2	0.5
轻轻	1	0	1	2	0.5
轻度	0	1	1	2	0.5
轮子	0	1	1	2	0.5
转行	0	1	1	2	0.5
转移	1	1	0	2	0.5
转眼	1	0	1	2	0.5
转世	1	1	0	2	0.5
轩	1	0	1	2	0.5
车站	0	1	1	2	0.5
车场	1	1	0	2	0.5
车厢	1	1	0	2	0.5
躲	1	1	0	2	0.5
身体素质	1	1	0	2	0.5
躁	0	1	1	2	0.5
践踏	1	1	0	2	0.5
跳楼	0	1	1	2	0.5
跳出	1	0	1	2	0.5
路人	0	1	1	2	0.5
跪	1	1	0	2	0.5
跨	1	0	1	2	0.5
跑旱船	1	0	1	2	0.5
越是	1	1	0	2	0.5
越发	1	1	0	2	0.5
超高	1	0	1	2	0.5
起床	1	0	1	2	0.5
赶着	0	1	1	2	0.5
走来	1	1	0	2	0.5
赚	1	1	0	2	0.5
资助	0	1	1	2	0.5
购	0	1	1	2	0.5
贪官	1	1	0	2	0.5
贩子	0	1	1	2	0.5
账	0	1	1	2	0.5
财力	1	1	0	2	0.5
财产权	0	1	1	2	0.5
谈谈	1	0	1	2	0.5
调解	1	1	0	2	0.5
调节	1	1	0	2	0.5
诸多	1	1	0	2	0.5
请来	0	1	1	2	0.5
说道	1	1	0	2	0.5
说了算	1	1	0	2	0.5
说不清	1	1	0	2	0.5
说不定	1	1	0	2	0.5
误解	1	0	1	2	0.5
语言	0	1	1	2	0.5
诚信	1	1	0	2	0.5
试验场	0	1	1	2	0.5
试验	0	1	1	2	0.5
试问	0	1	1	2	0.5
试	1	1	0	2	0.5
识	1	1	0	2	0.5
证件	0	1	1	2	0.5
访谈	0	1	1	2	0.5
论文	0	1	1	2	0.5
许可证	0	1	1	2	0.5
许	0	1	1	2	0.5
讲究	1	1	0	2	0.5
认同	0	1	1	2	0.5
订单	1	0	1	2	0.5
警告	1	1	0	2	0.5
警	0	1	1	2	0.5
解禁	1	0	1	2	0.5
解散	1	1	0	2	0.5
解	0	1	1	2	0.5
角落	0	1	1	2	0.5
视	1	0	1	2	0.5
见面	1	0	1	2	0.5
见到	1	0	1	2	0.5
覆盖	0	1	1	2	0.5
要死	1	1	0	2	0.5
要不然	1	1	0	2	0.5
西部	0	1	1	2	0.5
西游	0	1	1	2	0.5
西北部	0	1	1	2	0.5
装车	1	1	0	2	0.5
裂	1	1	0	2	0.5
被迫	1	1	0	2	0.5
被车撞	1	0	1	2	0.5
表面	0	1	1	2	0.5
补	1	0	1	2	0.5
街上	1	0	1	2	0.5
行路	1	1	0	2	0.5
行政拘留	1	1	0	2	0.5
虽说	1	1	0	2	0.5
虎	0	1	1	2	0.5
蒙古	1	1	0	2	0.5
落入	1	1	0	2	0.5
落	1	1	0	2	0.5
荒唐	1	1	0	2	0.5
英国	1	0	1	2	0.5
苟且	1	1	0	2	0.5
芳	1	1	0	2	0.5
花炮	0	1	1	2	0.5
节庆	1	1	0	2	0.5
节后	1	1	0	2	0.5
节假日	0	1	1	2	0.5
节假	0	1	1	2	0.5
艾	1	1	0	2	0.5
色	1	1	0	2	0.5
艰难	1	1	0	2	0.5
良	0	1	1	2	0.5
般的	1	1	0	2	0.5
航母	1	1	0	2	0.5
舞龙	1	1	0	2	0.5
舞	0	1	1	2	0.5
舜	1	1	0	2	0.5
自治	1	1	0	2	0.5
自不量力	1	0	1	2	0.5
脸面	1	1	0	2	0.5
脱	0	1	1	2	0.5
胸	0	1	1	2	0.5
胜利	0	1	1	2	0.5
股市	1	1	0	2	0.5
聚集	1	0	1	2	0.5
聚	1	1	0	2	0.5
联欢晚会	0	1	1	2	0.5
联欢	0	1	1	2	0.5
联军	1	1	0	2	0.5
职业	1	1	0	2	0.5
耐用	1	0	1	2	0.5
而过	1	1	0	2	0.5
老虎	1	0	1	2	0.5
老头	0	1	1	2	0.5
翻倍	1	1	0	2	0.5
羡慕	1	0	1	2	0.5
羞辱	1	1	0	2	0.5
羞耻	0	1	1	2	0.5
美美	1	0	1	2	0.5
置疑	1	1	0	2	0.5
罪人	1	1	0	2	0.5
罢	1	0	1	2	0.5
网通	0	1	1	2	0.5
网民	1	1	0	2	0.5
缴纳	1	0	1	2	0.5
缓缓	1	1	0	2	0.5
绝路	1	1	0	2	0.5
给出	1	0	1	2	0.5
给予	1	1	0	2	0.5
结起来	1	1	0	2	0.5
结起	1	1	0	2	0.5
结论	1	1	0	2	0.5
结局	1	0	1	2	0.5
经	1	1	0	2	0.5
细节	0	1	1	2	0.5
细分	0	1	1	2	0.5
组合	1	0	1	2	0.5
纵	1	0	1	2	0.5
级别	1	1	0	2	0.5
累赘	1	1	0	2	0.5
累累	1	1	0	2	0.5
累死	1	1	0	2	0.5
素	0	1	1	2	0.5
系	0	1	1	2	0.5
糟	0	1	1	2	0.5
糕	1	1	0	2	0.5
精	1	1	0	2	0.5
粮	1	0	1	2	0.5
粗放	1	1	0	2	0.5
粑	1	1	0	2	0.5
米饭	1	1	0	2	0.5
米姆	1	1	0	2	0.5
篱笆	1	0	1	2	0.5
箱	0	1	1	2	0.5
简约	1	1	0	2	0.5
简化	0	1	1	2	0.5
策略	0	1	1	2	0.5
等着瞧	1	1	0	2	0.5
等同	1	1	0	2	0.5
笔记本	1	1	0	2	0.5
笔记	1	1	0	2	0.5
笑语	1	1	0	2	0.5
窜	1	0	1	2	0.5
窗户	1	0	1	2	0.5
穿梭	0	1	1	2	0.5
稿件	0	1	1	2	0.5
稀里哗啦	1	1	0	2	0.5
秧歌	1	0	1	2	0.5
租金	1	1	0	2	0.5
秘密	0	1	1	2	0.5
离不开	0	1	1	2	0.5
福字	1	1	0	2	0.5
祸水	0	1	1	2	0.5
神学	0	1	1	2	0.5
祖	0	1	1	2	0.5
祈祷	1	0	1	2	0.5
礼貌	1	1	0	2	0.5
确认	1	0	1	2	0.5
确保	1	0	1	2	0.5
砸	1	0	1	2	0.5
石家庄	0	1	1	2	0.5
石家	0	1	1	2	0.5
短期	0	1	1	2	0.5
短时间	1	1	0	2	0.5
知识	1	0	1	2	0.5
瞧瞧	0	1	1	2	0.5
瞧	1	1	0	2	0.5
睿	1	1	0	2	0.5
睡不着	1	0	1	2	0.5
真多	1	1	0	2	0.5
真主	1	1	0	2	0.5
看齐	0	1	1	2	0.5
看着办	1	0	1	2	0.5
看望	1	0	1	2	0.5
看待	0	1	1	2	0.5
看完	1	1	0	2	0.5
看吧	1	1	0	2	0.5
看书	1	1	0	2	0.5
看不懂	0	1	1	2	0.5
省道	1	1	0	2	0.5
省市	0	1	1	2	0.5
相差	1	1	0	2	0.5
相传	1	0	1	2	0.5
相互	1	0	1	2	0.5
盘点	1	0	1	2	0.5
盖	1	0	1	2	0.5
监测	0	1	1	2	0.5
百倍	1	1	0	2	0.5
百人	1	1	0	2	0.5
百二	1	1	0	2	0.5
白眼	1	1	0	2	0.5
登记	1	1	0	2	0.5
瘫痪	0	1	1	2	0.5
疑似	0	1	1	2	0.5
畜	1	1	0	2	0.5
留学	0	1	1	2	0.5
界面	1	1	0	2	0.5
男娃	0	1	1	2	0.5
电脑	1	0	1	2	0.5
由衷	1	1	0	2	0.5
用车	1	0	1	2	0.5
用度	0	1	1	2	0.5
用到	0	1	1	2	0.5
用于	1	1	0	2	0.5
生计	0	1	1	2	0.5
生物	0	1	1	2	0.5
生产线	1	1	0	2	0.5
瓜	1	1	0	2	0.5
瑟	1	0	1	2	0.5
理直气壮	1	1	0	2	0.5
理想	1	1	0	2	0.5
理念	0	1	1	2	0.5
现阶段	0	1	1	2	0.5
现状	1	1	0	2	0.5
环	0	1	1	2	0.5
玛	0	1	1	2	0.5
猫	1	0	1	2	0.5
猪头	1	1	0	2	0.5
猛烈	1	0	1	2	0.5
猛增	1	1	0	2	0.5
狮子	1	1	0	2	0.5
独裁政权	0	1	1	2	0.5
狠揍	1	1	0	2	0.5
狂	1	1	0	2	0.5
犹豫	1	0	1	2	0.5
犹如	0	1	1	2	0.5
犯罪分子	1	0	1	2	0.5
特派记者	1	0	1	2	0.5
特派	1	0	1	2	0.5
特殊政策	1	0	1	2	0.5
物料	1	0	1	2	0.5
牛郎	1	0	1	2	0.5
牌坊	1	1	0	2	0.5
爹妈	1	1	0	2	0.5
爷爷奶奶	1	1	0	2	0.5
爬	1	0	1	2	0.5
熬夜	0	1	1	2	0.5
煮	1	0	1	2	0.5
焰火	1	0	1	2	0.5
热门	1	1	0	2	0.5
热衷于	0	1	1	2	0.5
热衷	0	1	1	2	0.5
热烈	1	1	0	2	0.5
热点话题	1	0	1	2	0.5
烦	0	1	1	2	0.5
烟雾	0	1	1	2	0.5
烟尘	0	1	1	2	0.5
烛	0	1	1	2	0.5
炸死	1	1	0	2	0.5
炮轰	0	1	1	2	0.5
炫	1	1	0	2	0.5
炒	1	1	0	2	0.5
灶神	1	0	1	2	0.5
灯谜	1	0	1	2	0.5
灭绝	1	1	0	2	0.5
灭	1	1	0	2	0.5
火车	1	1	0	2	0.5
火爆	1	1	0	2	0.5
火光冲天	1	0	1	2	0.5
灌输	0	1	1	2	0.5
激活	0	1	1	2	0.5
激化	1	1	0	2	0.5
潘	1	1	0	2	0.5
满面	1	0	1	2	0.5
满满的	1	1	0	2	0.5
滞后	1	1	0	2	0.5
湖南	0	1	1	2	0.5
游戏	1	0	1	2	0.5
游	1	1	0	2	0.5
温州	1	0	1	2	0.5
渣	1	1	0	2	0.5
清晨	0	1	1	2	0.5
清明节	1	0	1	2	0.5
清华	0	1	1	2	0.5
添个	1	0	1	2	0.5
深空	1	1	0	2	0.5
深深	1	0	1	2	0.5
涕零	1	0	1	2	0.5
消防员	0	1	1	2	0.5
消	0	1	1	2	0.5
浏览	0	1	1	2	0.5
流行	1	0	1	2	0.5
流满	1	0	1	2	0.5
流	0	1	1	2	0.5
活该	0	1	1	2	0.5
泽	0	1	1	2	0.5
泪流满面	1	0	1	2	0.5
泪流	1	0	1	2	0.5
泥	1	1	0	2	0.5
法律法规	1	1	0	2	0.5
治病	0	1	1	2	0.5
沸沸扬扬	0	1	1	2	0.5
沸沸	0	1	1	2	0.5
沙漠	1	0	1	2	0.5
污浊	0	1	1	2	0.5
江西	0	1	1	2	0.5
江	1	0	1	2	0.5
求助	0	1	1	2	0.5
气息	1	0	1	2	0.5
气味	1	1	0	2	0.5
民工	0	1	1	2	0.5
民兵	1	0	1	2	0.5
每逢	1	0	1	2	0.5
每当	1	1	0	2	0.5
毋庸置疑	1	1	0	2	0.5
毋庸	1	1	0	2	0.5
死活	1	1	0	2	0.5
死去	1	0	1	2	0.5
步步	1	1	0	2	0.5
步入	1	1	0	2	0.5
此后	1	0	1	2	0.5
正面	1	1	0	2	0.5
歌谣	1	1	0	2	0.5
歇歇	1	1	0	2	0.5
欢声笑语	1	1	0	2	0.5
欢声	1	1	0	2	0.5
次日	0	1	1	2	0.5
欠	1	1	0	2	0.5
横	1	0	1	2	0.5
模	0	1	1	2	0.5
榜	0	1	1	2	0.5
概率	1	1	0	2	0.5
棒子	1	1	0	2	0.5
棒	1	1	0	2	0.5
检查	1	0	1	2	0.5
档次	1	0	1	2	0.5
根源	0	1	1	2	0.5
核算	1	0	1	2	0.5
栏目	1	0	1	2	0.5
标配	0	1	1	2	0.5
标志	1	1	0	2	0.5
查获	1	0	1	2	0.5
查看	1	1	0	2	0.5
某人	1	0	1	2	0.5
架次	1	1	0	2	0.5
极端主义	1	1	0	2	0.5
杨	0	1	1	2	0.5
来源于	1	0	1	2	0.5
杂志	1	0	1	2	0.5
杀伤	1	1	0	2	0.5
机子	1	1	0	2	0.5
本国	1	1	0	2	0.5
未必	1	0	1	2	0.5
有罪	0	1	1	2	0.5
有点像	1	0	1	2	0.5
有序	0	1	1	2	0.5
有利于	1	1	0	2	0.5
月前	0	1	1	2	0.5
最爱	1	0	1	2	0.5
最强	1	1	0	2	0.5
替	0	1	1	2	0.5
暴露	1	1	0	2	0.5
暖冬	1	1	0	2	0.5
智障	0	1	1	2	0.5
智慧	1	1	0	2	0.5
晴朗	0	1	1	2	0.5
晨报	0	1	1	2	0.5
晚餐	1	0	1	2	0.5
显示屏	1	0	1	2	0.5
春运	1	0	1	2	0.5
星星	1	1	0	2	0.5
昏	0	1	1	2	0.5
时任	1	1	0	2	0.5
旱船	1	0	1	2	0.5
早起	1	1	0	2	0.5
早已	0	1	1	2	0.5
早上好	1	1	0	2	0.5
无语	1	1	0	2	0.5
无论是	1	0	1	2	0.5
无聊	1	1	0	2	0.5
无意	1	0	1	2	0.5
无尽	1	1	0	2	0.5
无可厚非	1	1	0	2	0.5
无力	1	1	0	2	0.5
无休	1	0	1	2	0.5
旅行	0	1	1	2	0.5
新风	0	1	1	2	0.5
新年好	1	1	0	2	0.5
新品	0	1	1	2	0.5
文件	1	1	0	2	0.5
敲	1	0	1	2	0.5
数额	1	0	1	2	0.5
数百年	1	1	0	2	0.5
数百	1	1	0	2	0.5
数	0	1	1	2	0.5
效仿	1	1	0	2	0.5
政客	0	1	1	2	0.5
放起	1	0	1	2	0.5
放心	1	1	0	2	0.5
放屁	1	1	0	2	0.5
放宽	1	1	0	2	0.5
放学	1	1	0	2	0.5
收场	0	1	1	2	0.5
支那	1	1	0	2	0.5
支持者	1	0	1	2	0.5
支	1	1	0	2	0.5
操控	1	0	1	2	0.5
操心	1	0	1	2	0.5
撒娇	1	0	1	2	0.5
撑	0	1	1	2	0.5
摸	0	1	1	2	0.5
摩尔	1	0	1	2	0.5
摧毁	1	1	0	2	0.5
搅乱	1	0	1	2	0.5
搁	1	1	0	2	0.5
掰	1	1	0	2	0.5
措手不及	1	0	1	2	0.5
措手	1	0	1	2	0.5
推给	1	1	0	2	0.5
推定	0	1	1	2	0.5
推到	0	1	1	2	0.5
接近	1	1	0	2	0.5
接到	1	0	1	2	0.5
掠夺	0	1	1	2	0.5
排队	1	1	0	2	0.5
排到	1	0	1	2	0.5
排	1	1	0	2	0.5
掌握	1	1	0	2	0.5
换掉	1	1	0	2	0.5
捐给	1	1	0	2	0.5
捉迷藏	0	1	1	2	0.5
捉	1	0	1	2	0.5
挤压	1	1	0	2	0.5
指手画脚	0	1	1	2	0.5
指使	1	0	1	2	0.5
拜托	1	0	1	2	0.5
招手	1	0	1	2	0.5
拍手	0	1	1	2	0.5
拉动	0	1	1	2	0.5
拆解	1	1	0	2	0.5
拆	0	1	1	2	0.5
担忧	0	1	1	2	0.5
抵触	1	1	0	2	0.5
抵制	1	0	1	2	0.5
护眼	1	1	0	2	0.5
护理	1	0	1	2	0.5
抢红包	1	1	0	2	0.5
抢掠	1	1	0	2	0.5
抢夺	1	1	0	2	0.5
折腾	1	0	1	2	0.5
抗衡	0	1	1	2	0.5
抗法	1	1	0	2	0.5
抗	0	1	1	2	0.5
投诉	1	1	0	2	0.5
抓捕	0	1	1	2	0.5
找准	1	1	0	2	0.5
批	1	1	0	2	0.5
扭秧歌	1	0	1	2	0.5
扬扬	0	1	1	2	0.5
扫把	0	1	1	2	0.5
打扫卫生	1	1	0	2	0.5
打字	1	0	1	2	0.5
打动	1	0	1	2	0.5
打人	1	1	0	2	0.5
手续	1	1	0	2	0.5
所欲	0	1	1	2	0.5
所幸	1	0	1	2	0.5
房地	1	0	1	2	0.5
成人	1	1	0	2	0.5
懒得	1	0	1	2	0.5
感激涕零	1	0	1	2	0.5
感激	1	0	1	2	0.5
感兴趣	1	1	0	2	0.5
感兴	1	1	0	2	0.5
意图	0	1	1	2	0.5
想像	0	1	1	2	0.5
惧怕	1	1	0	2	0.5
惊喜	1	0	1	2	0.5
情愿	1	1	0	2	0.5
悲	1	0	1	2	0.5
悠久	0	1	1	2	0.5
恶性	1	1	0	2	0.5
恰好	1	1	0	2	0.5
恨	1	0	1	2	0.5
总部	1	1	0	2	0.5
总能	1	0	1	2	0.5
总结	0	1	1	2	0.5
总算	0	1	1	2	0.5
总归	1	1	0	2	0.5
性格	1	1	0	2	0.5
急需	1	0	1	2	0.5
怀里	1	0	1	2	0.5
念佛	0	1	1	2	0.5
快快	1	0	1	2	0.5
忍耐	1	1	0	2	0.5
忍不住	1	0	1	2	0.5
必备	1	1	0	2	0.5
必不可少	1	0	1	2	0.5
心焦	1	0	1	2	0.5
心思	1	0	1	2	0.5
德行	1	0	1	2	0.5
得罪	0	1	1	2	0.5
得利	1	0	1	2	0.5
得不偿失	1	1	0	2	0.5
很久	1	1	0	2	0.5
彼得	0	1	1	2	0.5
当成	1	0	1	2	0.5
当作	1	1	0	2	0.5
当今社会	1	1	0	2	0.5
当事人	0	1	1	2	0.5
当事	0	1	1	2	0.5
归咎	1	0	1	2	0.5
强悍	1	1	0	2	0.5
强度	1	1	0	2	0.5
弟	1	1	0	2	0.5
引人	1	0	1	2	0.5
弊端	1	1	0	2	0.5
开玩笑	1	1	0	2	0.5
开工	0	1	1	2	0.5
建筑	0	1	1	2	0.5
康	0	1	1	2	0.5
庆幸	0	1	1	2	0.5
庆	1	0	1	2	0.5
广东台	1	1	0	2	0.5
幺	0	1	1	2	0.5
干扰	1	0	1	2	0.5
帽子	1	1	0	2	0.5
帖子	1	0	1	2	0.5
市县	1	1	0	2	0.5
巴黎	1	1	0	2	0.5
巴不得	1	1	0	2	0.5
巨响	1	1	0	2	0.5
左手	1	0	1	2	0.5
左	1	1	0	2	0.5
崇洋媚外	1	0	1	2	0.5
崇洋	1	0	1	2	0.5
岗	1	0	1	2	0.5
山路	1	0	1	2	0.5
山姆	1	0	1	2	0.5
屠苏	0	1	1	2	0.5
屏蔽	0	1	1	2	0.5
屏幕显示	0	1	1	2	0.5
居住	1	0	1	2	0.5
居	1	0	1	2	0.5
尾巴	0	1	1	2	0.5
尽早	1	0	1	2	0.5
少数民族	0	1	1	2	0.5
少年	0	1	1	2	0.5
小队	1	0	1	2	0.5
小康	1	0	1	2	0.5
小子	1	1	0	2	0.5
小众	1	1	0	2	0.5
小人	1	1	0	2	0.5
尊	1	0	1	2	0.5
射	1	1	0	2	0.5
富	0	1	1	2	0.5
寂寞	1	1	0	2	0.5
宽敞	1	0	1	2	0.5
宽	0	1	1	2	0.5
家庄	0	1	1	2	0.5
宰	1	1	0	2	0.5
实践	1	0	1	2	0.5
实	0	1	1	2	0.5
官兵	1	0	1	2	0.5
安宁	0	1	1	2	0.5
守夜	1	1	0	2	0.5
宁波	1	1	0	2	0.5
孽	1	1	0	2	0.5
孩儿	1	1	0	2	0.5
孕育	1	0	1	2	0.5
子	1	0	1	2	0.5
嫌疑人	1	0	1	2	0.5
嫂	1	1	0	2	0.5
媚外	1	0	1	2	0.5
婶婶	1	0	1	2	0.5
婚姻	0	1	1	2	0.5
娜	1	0	1	2	0.5
威武	1	0	1	2	0.5
威力	0	1	1	2	0.5
姥姥	1	0	1	2	0.5
妙	1	0	1	2	0.5
妈咪	1	1	0	2	0.5
妇幼	1	0	1	2	0.5
如下	0	1	1	2	0.5
好转	1	1	0	2	0.5
好用	1	1	0	2	0.5
好多年	1	1	0	2	0.5
好吃	1	1	0	2	0.5
她家	0	1	1	2	0.5
女王	1	0	1	2	0.5
女强人	0	1	1	2	0.5
女孩子	0	1	1	2	0.5
女婴	1	1	0	2	0.5
套房	0	1	1	2	0.5
奋斗	0	1	1	2	0.5
夺走	1	1	0	2	0.5
头目	1	0	1	2	0.5
失踪	1	1	0	2	0.5
失火	0	1	1	2	0.5
央	0	1	1	2	0.5
太大	1	1	0	2	0.5
天地	1	0	1	2	0.5
天军	1	1	0	2	0.5
大餐	1	1	0	2	0.5
大连	0	1	1	2	0.5
大跌	1	0	1	2	0.5
大规模	0	1	1	2	0.5
大规	0	1	1	2	0.5
大群	1	1	0	2	0.5
大约	0	1	1	2	0.5
大片	0	1	1	2	0.5
大浪	1	0	1	2	0.5
大法	1	0	1	2	0.5
大毛	1	1	0	2	0.5
大本营	1	1	0	2	0.5
大本	1	1	0	2	0.5
大早	1	1	0	2	0.5
大成	1	1	0	2	0.5
大宗	1	1	0	2	0.5
大学毕业	1	0	1	2	0.5
大姚	1	0	1	2	0.5
大吉	1	1	0	2	0.5
大功	1	1	0	2	0.5
大力支持	1	1	0	2	0.5
大使	1	1	0	2	0.5
大人	0	1	1	2	0.5
多长	1	0	1	2	0.5
多款	1	0	1	2	0.5
多日	0	1	1	2	0.5
多家	0	1	1	2	0.5
多吨	0	1	1	2	0.5
外型	1	0	1	2	0.5
外加	1	1	0	2	0.5
复兴	1	1	0	2	0.5
备胎	1	0	1	2	0.5
处处	1	1	0	2	0.5
声声	0	1	1	2	0.5
增长	1	1	0	2	0.5
增援	1	1	0	2	0.5
塌	0	1	1	2	0.5
堵住	1	0	1	2	0.5
堪称	0	1	1	2	0.5
堕胎	1	1	0	2	0.5
堆积	0	1	1	2	0.5
坦克	1	1	0	2	0.5
坐在	1	1	0	2	0.5
场面	1	0	1	2	0.5
场所	0	1	1	2	0.5
场合	1	1	0	2	0.5
地缘	0	1	1	2	0.5
在外	1	1	0	2	0.5
土豪	0	1	1	2	0.5
土狗	1	1	0	2	0.5
土匪	1	1	0	2	0.5
圈	0	1	1	2	0.5
圆角	1	1	0	2	0.5
国道	1	1	0	2	0.5
国力	1	1	0	2	0.5
困	1	0	1	2	0.5
园	1	0	1	2	0.5
团结起来	1	1	0	2	0.5
回顾	1	1	0	2	0.5
回过	1	1	0	2	0.5
回味	1	1	0	2	0.5
回到	1	1	0	2	0.5
回不去	1	1	0	2	0.5
四胎	0	1	1	2	0.5
四种	0	1	1	2	0.5
四天	1	1	0	2	0.5
四分	0	1	1	2	0.5
嘴里	1	0	1	2	0.5
嘲讽	1	1	0	2	0.5
嘉	0	1	1	2	0.5
喧天	1	0	1	2	0.5
喧哗	1	1	0	2	0.5
喜悦	1	0	1	2	0.5
喜乐	1	1	0	2	0.5
喜	1	0	1	2	0.5
善	0	1	1	2	0.5
啸	0	1	1	2	0.5
商量	1	1	0	2	0.5
商场	0	1	1	2	0.5
商人	1	0	1	2	0.5
唯	1	0	1	2	0.5
唤醒	1	1	0	2	0.5
唐人街	1	0	1	2	0.5
哪天	1	0	1	2	0.5
哥们	1	1	0	2	0.5
哗啦	1	1	0	2	0.5
哗众取宠	1	0	1	2	0.5
哗众	1	0	1	2	0.5
哈市	0	1	1	2	0.5
哈尔滨市	0	1	1	2	0.5
品质	0	1	1	2	0.5
咨询电话	1	1	0	2	0.5
和尚	1	1	0	2	0.5
咄咄	0	1	1	2	0.5
呼啸而过	1	1	0	2	0.5
呼啸	1	1	0	2	0.5
周年	1	0	1	2	0.5
呆	1	1	0	2	0.5
吹	1	0	1	2	0.5
听话	1	1	0	2	0.5
同谋	1	1	0	2	0.5
同盟	1	1	0	2	0.5
同步	1	0	1	2	0.5
吃香	1	1	0	2	0.5
吃火锅	1	0	1	2	0.5
吃亏	1	1	0	2	0.5
司机	1	1	0	2	0.5
右手	1	0	1	2	0.5
右	0	1	1	2	0.5
可取	0	1	1	2	0.5
只许	1	1	0	2	0.5
另类	0	1	1	2	0.5
口岸	1	1	0	2	0.5
受访者	0	1	1	2	0.5
取宠	1	0	1	2	0.5
发黄	1	1	0	2	0.5
发货	1	1	0	2	0.5
发言人	1	1	0	2	0.5
发烧	1	1	0	2	0.5
反对者	1	0	1	2	0.5
双号	1	1	0	2	0.5
友谊	1	1	0	2	0.5
县城	1	1	0	2	0.5
县	0	1	1	2	0.5
厦门	0	1	1	2	0.5
厚非	1	1	0	2	0.5
厕所	1	0	1	2	0.5
历来	1	1	0	2	0.5
历史悠久	0	1	1	2	0.5
卷入	1	0	1	2	0.5
卫国	1	0	1	2	0.5
占领	1	1	0	2	0.5
南昌	1	1	0	2	0.5
南方	1	0	1	2	0.5
协助	1	0	1	2	0.5
协	0	1	1	2	0.5
华大	1	1	0	2	0.5
华丽	1	0	1	2	0.5
华	1	0	1	2	0.5
千金	1	1	0	2	0.5
千百	0	1	1	2	0.5
十多万	1	0	1	2	0.5
十几年	1	1	0	2	0.5
十八	1	0	1	2	0.5
十二点	1	1	0	2	0.5
十二	1	1	0	2	0.5
十个	1	1	0	2	0.5
十一	1	0	1	2	0.5
医保	1	1	0	2	0.5
区间	1	1	0	2	0.5
北路	0	1	1	2	0.5
包装	0	1	1	2	0.5
包子	1	0	1	2	0.5
包含	0	1	1	2	0.5
勿	1	0	1	2	0.5
勾搭	1	1	0	2	0.5
勤劳	1	0	1	2	0.5
勇敢	1	0	1	2	0.5
动手	1	1	0	2	0.5
加倍	1	0	1	2	0.5
力气	0	1	1	2	0.5
剩	1	0	1	2	0.5
剧	1	1	0	2	0.5
剥离	1	1	0	2	0.5
剑	1	0	1	2	0.5
前者	0	1	1	2	0.5
前置	0	1	1	2	0.5
前段时间	1	1	0	2	0.5
前段	1	1	0	2	0.5
前来	1	1	0	2	0.5
前夫	1	0	1	2	0.5
前后	1	1	0	2	0.5
刻起	1	1	0	2	0.5
制订	1	1	0	2	0.5
到头	1	0	1	2	0.5
利润率	0	1	1	2	0.5
利润	0	1	1	2	0.5
删除	0	1	1	2	0.5
初三	1	1	0	2	0.5
初	1	0	1	2	0.5
创业	1	1	0	2	0.5
划算	1	1	0	2	0.5
分歧	1	1	0	2	0.5
出面	1	1	0	2	0.5
出过	1	1	0	2	0.5
出路	0	1	1	2	0.5
出示	0	1	1	2	0.5
出息	1	1	0	2	0.5
出击	1	1	0	2	0.5
出于	0	1	1	2	0.5
出乎意料	1	0	1	2	0.5
凯末尔	1	1	0	2	0.5
凯旋	1	1	0	2	0.5
凯	0	1	1	2	0.5
凭	1	0	1	2	0.5
凤凰网	1	1	0	2	0.5
几百人	1	1	0	2	0.5
几句	1	1	0	2	0.5
几万	1	0	1	2	0.5
冷藏	0	1	1	2	0.5
冲着	1	0	1	2	0.5
冲天	1	0	1	2	0.5
冲动	1	1	0	2	0.5
冰冻三尺非一日之寒	0	1	1	2	0.5
冰冻三尺	0	1	1	2	0.5
冰冻	0	1	1	2	0.5
冬季	1	1	0	2	0.5
农民工	0	1	1	2	0.5
军事冲突	0	1	1	2	0.5
内战	1	1	0	2	0.5
养活	0	1	1	2	0.5
养儿	1	1	0	2	0.5
其他人	1	1	0	2	0.5
关外	0	1	1	2	0.5
共计	0	1	1	2	0.5
共和国	0	1	1	2	0.5
共和	0	1	1	2	0.5
六月	1	1	0	2	0.5
六	1	1	0	2	0.5
公明	1	0	1	2	0.5
公布	0	1	1	2	0.5
公害	1	1	0	2	0.5
公告	1	0	1	2	0.5
八卦	1	0	1	2	0.5
全身	1	0	1	2	0.5
全市	1	1	0	2	0.5
全区	1	0	1	2	0.5
克服	1	1	0	2	0.5
克星	1	0	1	2	0.5
克	0	1	1	2	0.5
光荣	1	1	0	2	0.5
傻傻	0	1	1	2	0.5
停车场	1	1	0	2	0.5
停战	1	1	0	2	0.5
做人	1	1	0	2	0.5
值班	1	1	0	2	0.5
倍	1	1	0	2	0.5
俺	1	0	1	2	0.5
修改	0	1	1	2	0.5
修	1	1	0	2	0.5
保护费	1	1	0	2	0.5
保守	1	1	0	2	0.5
保卫者	1	1	0	2	0.5
保卫	1	1	0	2	0.5
保不住	0	1	1	2	0.5
俘虏	1	1	0	2	0.5
便携	1	1	0	2	0.5
依靠	1	0	1	2	0.5
依赖	1	0	1	2	0.5
例子	1	0	1	2	0.5
使得	0	1	1	2	0.5
你老	0	1	1	2	0.5
作对	1	1	0	2	0.5
作家	1	1	0	2	0.5
余名	1	0	1	2	0.5
何去何从	1	1	0	2	0.5
何况	1	1	0	2	0.5
何以堪	0	1	1	2	0.5
体重	1	0	1	2	0.5
体力	1	1	0	2	0.5
住院	1	0	1	2	0.5
低下	0	1	1	2	0.5
伪	1	1	0	2	0.5
传播	0	1	1	2	0.5
伟	1	1	0	2	0.5
会议	1	0	1	2	0.5
会上	1	0	1	2	0.5
伙子	1	1	0	2	0.5
伏	0	1	1	2	0.5
价值观	0	1	1	2	0.5
以外	1	1	0	2	0.5
代步车	0	1	1	2	0.5
代尔	0	1	1	2	0.5
代代	1	1	0	2	0.5
他国	1	0	1	2	0.5
从未	1	0	1	2	0.5
今儿	1	1	0	2	0.5
仇恨	1	0	1	2	0.5
仁义	1	1	0	2	0.5
人身	1	1	0	2	0.5
人情世故	0	1	1	2	0.5
亲身	1	1	0	2	0.5
亲爱	1	1	0	2	0.5
亮灯	1	0	1	2	0.5
亮度	1	1	0	2	0.5
享	1	0	1	2	0.5
产量	1	1	0	2	0.5
产科	1	1	0	2	0.5
产物	1	1	0	2	0.5
产权	0	1	1	2	0.5
交通部门	0	1	1	2	0.5
交通部	0	1	1	2	0.5
交通状况	1	1	0	2	0.5
交通安全	0	1	1	2	0.5
五大	1	1	0	2	0.5
五十多	1	0	1	2	0.5
五十	1	0	1	2	0.5
互换	1	1	0	2	0.5
二点	1	1	0	2	0.5
二十年	1	1	0	2	0.5
二十三	1	1	0	2	0.5
事项	1	0	1	2	0.5
争执	0	1	1	2	0.5
乱世	1	0	1	2	0.5
买来	0	1	1	2	0.5
书记	1	0	1	2	0.5
习	1	0	1	2	0.5
乐见	0	1	1	2	0.5
之内	0	1	1	2	0.5
举措	1	0	1	2	0.5
主导	1	1	0	2	0.5
为名	0	1	1	2	0.5
中药	1	1	0	2	0.5
中度	1	0	1	2	0.5
中医	0	1	1	2	0.5
中兴	1	0	1	2	0.5
中低端	0	1	1	2	0.5
个人感觉	1	0	1	2	0.5
两者	1	1	0	2	0.5
两条	1	1	0	2	0.5
两倍	1	1	0	2	0.5
丢人	1	1	0	2	0.5
丝毫	0	1	1	2	0.5
东欧	1	0	1	2	0.5
东台	1	1	0	2	0.5
世纪	1	1	0	2	0.5
世故	0	1	1	2	0.5
世上	0	1	1	2	0.5
专门	0	1	1	2	0.5
专车	1	1	0	2	0.5
丑	0	1	1	2	0.5
不量力	1	0	1	2	0.5
不育	0	1	1	2	0.5
不管怎样	1	1	0	2	0.5
不理	1	0	1	2	0.5
不爽	1	0	1	2	0.5
不来	0	1	1	2	0.5
不得了	1	1	0	2	0.5
不容忽视	0	1	1	2	0.5
不定	1	1	0	2	0.5
不合理	1	1	0	2	0.5
不吃	1	0	1	2	0.5
不可避免	1	0	1	2	0.5
不利于	1	1	0	2	0.5
不划算	1	1	0	2	0.5
不出意外	1	0	1	2	0.5
下车	1	0	1	2	0.5
下文	1	0	1	2	0.5
下放	1	0	1	2	0.5
下手	1	0	1	2	0.5
下周	1	0	1	2	0.5
上游	0	1	1	2	0.5
上好	1	1	0	2	0.5
上升	1	1	0	2	0.5
上千	0	1	1	2	0.5
三尺	0	1	1	2	0.5
三周	1	0	1	2	0.5
三倍	1	1	0	2	0.5
三位	0	1	1	2	0.5
三五年	1	1	0	2	0.5
三五	1	1	0	2	0.5
万块	1	0	1	2	0.5
万分	1	1	0	2	0.5
七八	1	1	0	2	0.5
一辈子	1	1	0	2	0.5
一辈	1	1	0	2	0.5
一贯	1	0	1	2	0.5
一股	1	1	0	2	0.5
一线	1	1	0	2	0.5
一系列	0	1	1	2	0.5
一系	0	1	1	2	0.5
一气	1	1	0	2	0.5
一枚	1	0	1	2	0.5
一座	0	1	1	2	0.5
一并	1	1	0	2	0.5
一岁	0	1	1	2	0.5
一大早	1	1	0	2	0.5
一向	0	1	1	2	0.5
一同	1	0	1	2	0.5
一分	1	0	1	2	0.5
一代代	1	1	0	2	0.5
一不小心	1	1	0	2	0.5
www	1	1	0	2	0.5
w	1	0	1	2	0.5
v	1	0	1	2	0.5
store	0	1	1	2	0.5
sp	0	1	1	2	0.5
so	1	1	0	2	0.5
sns	1	0	1	2	0.5
siri	1	1	0	2	0.5
say	1	1	0	2	0.5
retina	1	0	1	2	0.5
n	0	1	1	2	0.5
live	1	0	1	2	0.5
l	1	1	0	2	0.5
iss	1	1	0	2	0.5
iphones	0	1	1	2	0.5
ip	1	1	0	2	0.5
ios6	1	0	1	2	0.5
home	1	1	0	2	0.5
duang	1	0	1	2	0.5
cia	1	0	1	2	0.5
boy	1	0	1	2	0.5
b	1	1	0	2	0.5
aqi	0	1	1	2	0.5
深圳	87	156	70	313	0.498402555911
放	37	50	14	101	0.49504950495
生活	23	31	9	63	0.492063492063
事	28	21	8	57	0.491228070175
摩托车	26	18	9	53	0.490566037736
托车	26	18	9	53	0.490566037736
安全	15	24	10	49	0.489795918367
一点	18	22	5	45	0.488888888889
却	15	21	7	43	0.488372093023
做	23	41	20	84	0.488095238095
以	14	20	7	41	0.487804878049
老	15	18	4	37	0.486486486486
那些	17	11	7	35	0.485714285714
博文	16	11	6	33	0.484848484848
叙利亚	46	35	14	95	0.484210526316
利亚	46	35	14	95	0.484210526316
是不是	12	15	4	31	0.483870967742
已	15	6	10	31	0.483870967742
发表	15	8	8	31	0.483870967742
你们	34	43	12	89	0.483146067416
整治	14	8	7	29	0.48275862069
想要	9	6	14	29	0.48275862069
各种	14	11	4	29	0.48275862069
健康	12	14	3	29	0.48275862069
一直	26	18	10	54	0.481481481481
小	76	46	36	158	0.481012658228
反恐	20	24	6	50	0.48
话题	5	8	12	25	0.48
毕竟	12	7	6	25	0.48
如此	10	12	3	25	0.48
压力	10	12	3	25	0.48
真的	26	35	12	73	0.479452054795
生	38	58	25	121	0.479338842975
世界	33	21	15	69	0.478260869565
表示	22	7	17	46	0.478260869565
继续	11	8	4	23	0.478260869565
愿意	6	11	6	23	0.478260869565
发生	2	11	10	23	0.478260869565
但是	34	43	13	90	0.477777777778
我们	59	83	32	174	0.477011494253
领导	10	9	2	21	0.47619047619
除了	10	7	4	21	0.47619047619
轰炸	10	9	2	21	0.47619047619
见	10	8	3	21	0.47619047619
的话	7	10	4	21	0.47619047619
所谓	6	10	5	21	0.47619047619
几个	10	7	4	21	0.47619047619
其他	5	10	6	21	0.47619047619
公司	4	7	10	21	0.47619047619
g	5	10	6	21	0.47619047619
个	59	78	27	164	0.475609756098
期间	12	19	9	40	0.475
国	19	10	11	40	0.475
好	94	71	33	198	0.474747474747
他们	27	28	4	59	0.474576271186
随着	8	2	9	19	0.473684210526
正常	4	6	9	19	0.473684210526
机	5	5	9	19	0.473684210526
建议	4	9	6	19	0.473684210526
岁	9	7	3	19	0.473684210526
完	9	6	4	19	0.473684210526
图	9	5	5	19	0.473684210526
医院	4	9	6	19	0.473684210526
决定	6	9	4	19	0.473684210526
发布	12	17	26	55	0.472727272727
为什么	26	34	12	72	0.472222222222
部分	17	12	7	36	0.472222222222
越来越	17	11	8	36	0.472222222222
越来	17	11	8	36	0.472222222222
所有	16	13	5	34	0.470588235294
啥	9	16	9	34	0.470588235294
一种	11	16	7	34	0.470588235294
而是	7	8	2	17	0.470588235294
当地	3	8	6	17	0.470588235294
天天	8	6	3	17	0.470588235294
史	4	5	8	17	0.470588235294
几年	8	7	2	17	0.470588235294
元	5	4	8	17	0.470588235294
大年	14	15	3	32	0.46875
我	244	184	93	521	0.468330134357
里	29	19	14	62	0.467741935484
屏幕	29	22	11	62	0.467741935484
过去	7	6	2	15	0.466666666667
许多	7	4	4	15	0.466666666667
节目	7	3	5	15	0.466666666667
结果	7	5	3	15	0.466666666667
竟然	4	7	4	15	0.466666666667
电话	7	5	3	15	0.466666666667
欢迎	7	2	6	15	0.466666666667
日子	7	5	3	15	0.466666666667
放开	7	6	2	15	0.466666666667
提倡	5	7	3	15	0.466666666667
家里	5	7	3	15	0.466666666667
反而	7	5	3	15	0.466666666667
制造	6	7	2	15	0.466666666667
交	6	7	2	15	0.466666666667
不管	7	5	3	15	0.466666666667
会	69	104	50	223	0.466367713004
并	25	34	14	73	0.465753424658
们	34	26	13	73	0.465753424658
打	23	27	8	58	0.465517241379
对于	20	12	11	43	0.46511627907
再	39	32	13	84	0.464285714286
视频	8	7	13	28	0.464285714286
比较	13	8	7	28	0.464285714286
反对派	13	13	2	28	0.464285714286
不到	13	11	4	28	0.464285714286
为	40	62	32	134	0.462686567164
最	49	28	29	106	0.462264150943
时候	53	55	11	119	0.46218487395
现在	70	79	22	171	0.461988304094
这样	29	36	13	78	0.461538461538
使用	18	8	13	39	0.461538461538
超标	3	6	4	13	0.461538461538
至今	3	6	4	13	0.461538461538
男	6	5	2	13	0.461538461538
电影	6	1	6	13	0.461538461538
爆	5	6	2	13	0.461538461538
照片	2	5	6	13	0.461538461538
没了	4	6	3	13	0.461538461538
更是	6	6	1	13	0.461538461538
更加	5	6	2	13	0.461538461538
无法	4	3	6	13	0.461538461538
改变	3	6	4	13	0.461538461538
提高	6	6	1	13	0.461538461538
引起	3	6	4	13	0.461538461538
帮	6	5	2	13	0.461538461538
反正	6	3	4	13	0.461538461538
几乎	1	6	6	13	0.461538461538
公安	6	6	1	13	0.461538461538
三胎	5	6	2	13	0.461538461538
这么	24	35	17	76	0.460526315789
就是	75	87	27	189	0.460317460317
这些	18	29	16	63	0.460317460317
新年	17	14	6	37	0.459459459459
外观	12	17	8	37	0.459459459459
啊	65	73	21	159	0.459119496855
真是	28	24	9	61	0.459016393443
近日	3	10	11	24	0.458333333333
有些	7	11	6	24	0.458333333333
或	8	20	16	44	0.454545454545
别	19	20	5	44	0.454545454545
严重	12	15	6	33	0.454545454545
长	10	4	8	22	0.454545454545
历史	7	10	5	22	0.454545454545
全面	7	10	5	22	0.454545454545
任何	10	10	2	22	0.454545454545
门口	4	5	2	11	0.454545454545
行业	3	5	3	11	0.454545454545
能够	5	2	4	11	0.454545454545
老大	4	5	2	11	0.454545454545
美元	3	3	5	11	0.454545454545
第三	5	2	4	11	0.454545454545
污染空气	5	4	2	11	0.454545454545
民生	3	5	3	11	0.454545454545
提升	3	5	3	11	0.454545454545
强烈	3	5	3	11	0.454545454545
强	5	5	1	11	0.454545454545
庆祝	5	4	2	11	0.454545454545
并且	5	4	2	11	0.454545454545
天下	3	5	3	11	0.454545454545
外	4	2	5	11	0.454545454545
堵	5	4	2	11	0.454545454545
唯一	5	3	3	11	0.454545454545
反应	5	3	3	11	0.454545454545
十五	5	4	2	11	0.454545454545
则	2	4	5	11	0.454545454545
仅	1	5	5	11	0.454545454545
两年	5	5	1	11	0.454545454545
两天	4	5	2	11	0.454545454545
一款	5	4	2	11	0.454545454545
罗斯	47	49	12	108	0.453703703704
俄罗斯	47	49	12	108	0.453703703704
就	160	200	81	441	0.453514739229
美国	39	20	27	86	0.453488372093
呢	53	42	22	117	0.452991452991
知道	38	35	11	84	0.452380952381
之	21	28	13	62	0.451612903226
文明	11	14	6	31	0.451612903226
不过	14	8	9	31	0.451612903226
总	9	6	5	20	0.45
带来	6	9	5	20	0.45
事儿	9	9	2	20	0.45
要	90	113	49	252	0.448412698413
黄	10	13	6	29	0.448275862069
网友	7	9	13	29	0.448275862069
向	10	13	6	29	0.448275862069
分享	13	10	6	29	0.448275862069
开始	20	30	17	67	0.44776119403
可以	64	58	21	143	0.447552447552
第一	17	8	13	38	0.447368421053
摩托	29	21	15	65	0.446153846154
很多	36	37	10	83	0.44578313253
又	62	76	33	171	0.444444444444
国家	55	64	25	144	0.444444444444
还有	32	24	16	72	0.444444444444
比	28	22	13	63	0.444444444444
市场	9	16	11	36	0.444444444444
像	16	10	10	36	0.444444444444
结婚	9	12	6	27	0.444444444444
一天	12	9	6	27	0.444444444444
跑	8	6	4	18	0.444444444444
超	4	6	8	18	0.444444444444
突然	8	7	3	18	0.444444444444
然而	4	8	6	18	0.444444444444
比如	8	8	2	18	0.444444444444
办法	6	8	4	18	0.444444444444
初一	7	8	3	18	0.444444444444
估计	8	7	3	18	0.444444444444
飞行员	4	4	1	9	0.444444444444
部队	4	3	2	9	0.444444444444
通事	3	4	2	9	0.444444444444
跟着	4	2	3	9	0.444444444444
请问	3	4	2	9	0.444444444444
说明	3	4	2	9	0.444444444444
讨厌	3	4	2	9	0.444444444444
行员	4	4	1	9	0.444444444444
至于	2	4	3	9	0.444444444444
脸	4	3	2	9	0.444444444444
而已	4	4	1	9	0.444444444444
网络	3	4	2	9	0.444444444444
缺少	4	2	3	9	0.444444444444
结束	1	4	4	9	0.444444444444
经典	4	4	1	9	0.444444444444
累	3	4	2	9	0.444444444444
穷	3	4	2	9	0.444444444444
科技	2	4	3	9	0.444444444444
电池	2	4	3	9	0.444444444444
现场	4	1	4	9	0.444444444444
王	2	4	3	9	0.444444444444
版本	3	2	4	9	0.444444444444
照	3	2	4	9	0.444444444444
民主	4	4	1	9	0.444444444444
段时间	4	3	2	9	0.444444444444
欧洲	4	2	3	9	0.444444444444
明白	4	2	3	9	0.444444444444
手感	4	3	2	9	0.444444444444
想起	4	3	2	9	0.444444444444
往年	2	3	4	9	0.444444444444
当今	4	3	2	9	0.444444444444
年龄	3	4	2	9	0.444444444444
属于	3	2	4	9	0.444444444444
官	3	2	4	9	0.444444444444
它们	3	4	2	9	0.444444444444
婆婆	4	3	2	9	0.444444444444
埃	4	4	1	9	0.444444444444
回归	4	4	1	9	0.444444444444
句	2	4	3	9	0.444444444444
变化	4	2	3	9	0.444444444444
区域	3	4	2	9	0.444444444444
剩下	2	4	3	9	0.444444444444
再生	4	3	2	9	0.444444444444
其中	4	3	2	9	0.444444444444
兴趣	2	4	3	9	0.444444444444
像素	4	2	3	9	0.444444444444
交通事故	3	4	2	9	0.444444444444
严厉	3	2	4	9	0.444444444444
丢	4	4	1	9	0.444444444444
不出	2	4	3	9	0.444444444444
上面	2	3	4	9	0.444444444444
iphone6	4	3	2	9	0.444444444444
iphone5se	3	4	2	9	0.444444444444
iphone5s	2	3	4	9	0.444444444444
a9	4	2	3	9	0.444444444444
还	98	114	45	257	0.443579766537
才	39	34	15	88	0.443181818182
从	39	31	18	88	0.443181818182
着	53	49	18	120	0.441666666667
感觉	34	31	12	77	0.441558441558
无	14	15	5	34	0.441176470588
俄	13	15	6	34	0.441176470588
来	59	48	27	134	0.440298507463
孩子	43	55	27	125	0.44
更	32	44	24	100	0.44
所以	27	33	15	75	0.44
不会	23	33	19	75	0.44
玩	11	9	5	25	0.44
昨天	11	9	5	25	0.44
作为	9	11	5	25	0.44
产品	5	9	11	25	0.44
一年	11	3	11	25	0.44
对	80	65	37	182	0.43956043956
成	16	18	7	41	0.439024390244
带	18	17	6	41	0.439024390244
电动车	43	50	21	114	0.438596491228
用	47	57	26	130	0.438461538462
起来	18	21	9	48	0.4375
造成	14	13	5	32	0.4375
看看	14	10	8	32	0.4375
t	7	11	14	32	0.4375
红灯	7	7	2	16	0.4375
理解	7	5	4	16	0.4375
气质	4	7	5	16	0.4375
措施	5	7	4	16	0.4375
全球	7	5	4	16	0.4375
一大	7	6	3	16	0.4375
一个	97	92	33	222	0.436936936937
今天	41	40	13	94	0.436170212766
以后	15	17	7	39	0.435897435897
一下	15	17	7	39	0.435897435897
地方	15	20	11	46	0.434782608696
要求	8	5	10	23	0.434782608696
第二	9	4	10	23	0.434782608696
环卫	7	10	6	23	0.434782608696
说	83	99	46	228	0.434210526316
等	39	46	21	106	0.433962264151
什么	83	95	41	219	0.433789954338
价格	19	26	15	60	0.433333333333
评论	13	10	7	30	0.433333333333
人	118	129	51	298	0.43288590604
一些	16	9	12	37	0.432432432432
也	171	145	80	396	0.431818181818
卖	12	19	13	44	0.431818181818
这个	57	59	21	137	0.430656934307
还是	50	55	23	128	0.4296875
春节	177	167	69	413	0.428571428571
怎么	32	51	36	119	0.428571428571
这种	23	24	9	56	0.428571428571
原因	7	12	9	28	0.428571428571
进入	9	6	6	21	0.428571428571
系统	8	9	4	21	0.428571428571
理由	9	9	3	21	0.428571428571
搞	7	9	5	21	0.428571428571
当然	8	4	9	21	0.428571428571
北约	8	9	4	21	0.428571428571
事情	7	9	5	21	0.428571428571
速度	6	4	4	14	0.428571428571
调查	5	3	6	14	0.428571428571
用户	4	6	4	14	0.428571428571
拉	6	2	6	14	0.428571428571
打算	5	6	3	14	0.428571428571
想到	5	6	3	14	0.428571428571
响应	6	6	2	14	0.428571428571
及	6	6	2	14	0.428571428571
全部	3	6	5	14	0.428571428571
于	3	6	5	14	0.428571428571
三十	6	6	2	14	0.428571428571
一场	4	6	4	14	0.428571428571
龙江	3	3	1	7	0.428571428571
黑龙江	3	3	1	7	0.428571428571
需求	2	3	2	7	0.428571428571
阿	2	3	2	7	0.428571428571
进一步	2	2	3	7	0.428571428571
运动	1	3	3	7	0.428571428571
车主	2	3	2	7	0.428571428571
调整	2	3	2	7	0.428571428571
角度	3	3	1	7	0.428571428571
血	3	2	2	7	0.428571428571
美丽	2	3	2	7	0.428571428571
经过	3	3	1	7	0.428571428571
类似	1	3	3	7	0.428571428571
相比	3	3	1	7	0.428571428571
相当	2	2	3	7	0.428571428571
百年	2	3	2	7	0.428571428571
生意	3	3	1	7	0.428571428571
理器	2	2	3	7	0.428571428571
特殊	2	3	2	7	0.428571428571
烂	3	3	1	7	0.428571428571
治	2	2	3	7	0.428571428571
正月十五	3	3	1	7	0.428571428571
欢度	3	3	1	7	0.428571428571
曾经	2	2	3	7	0.428571428571
效果	3	2	2	7	0.428571428571
故意	2	3	2	7	0.428571428571
打电话	3	2	2	7	0.428571428571
或许	3	1	3	7	0.428571428571
总是	3	2	2	7	0.428571428571
性别	2	3	2	7	0.428571428571
年轻人	2	2	3	7	0.428571428571
尔多	3	3	1	7	0.428571428571
对外	1	3	3	7	0.428571428571
家长	2	2	3	7	0.428571428571
姐	2	2	3	7	0.428571428571
好友	3	3	1	7	0.428571428571
女孩	2	2	3	7	0.428571428571
大多数	3	3	1	7	0.428571428571
处理器	2	2	3	7	0.428571428571
坏	1	3	3	7	0.428571428571
哭	3	3	1	7	0.428571428571
同	2	3	2	7	0.428571428571
可怜	1	3	3	7	0.428571428571
发达	3	3	1	7	0.428571428571
参加	2	3	2	7	0.428571428571
卫生	2	3	2	7	0.428571428571
势力	3	3	1	7	0.428571428571
出兵	2	3	2	7	0.428571428571
冲击	3	3	1	7	0.428571428571
兄弟	2	3	2	7	0.428571428571
停	2	3	2	7	0.428571428571
保证	2	3	2	7	0.428571428571
作战	2	3	2	7	0.428571428571
传	3	1	3	7	0.428571428571
事件	1	3	3	7	0.428571428571
举	3	2	2	7	0.428571428571
主	2	2	3	7	0.428571428571
严格	3	2	2	7	0.428571428571
下班	3	3	1	7	0.428571428571
一边	1	3	3	7	0.428571428571
一张	1	3	3	7	0.428571428571
一只	3	2	2	7	0.428571428571
鞭炮	177	168	69	414	0.427536231884
放鞭炮	177	168	69	414	0.427536231884
放鞭	177	168	69	414	0.427536231884
二胎	171	138	91	400	0.4275
屏	35	26	21	82	0.426829268293
真	29	29	10	68	0.426470588235
没	67	65	26	158	0.424050632911
给	64	62	25	151	0.423841059603
因为	47	46	18	111	0.423423423423
想	58	54	25	137	0.423357664234
一次	11	9	6	26	0.423076923077
后	26	41	30	97	0.422680412371
政策	53	60	29	142	0.422535211268
生二胎	19	16	10	45	0.422222222222
能	63	65	26	154	0.422077922078
不要	24	27	13	64	0.421875
过	70	70	26	166	0.421686746988
月	35	17	31	83	0.421686746988
二	16	15	7	38	0.421052631579
规定	6	8	5	19	0.421052631579
最好	7	8	4	19	0.421052631579
如	4	8	7	19	0.421052631579
大国	8	7	4	19	0.421052631579
发布会	5	6	8	19	0.421052631579
儿子	8	6	5	19	0.421052631579
便宜	5	6	8	19	0.421052631579
以及	8	5	6	19	0.421052631579
中东	8	6	5	19	0.421052631579
一胎	7	8	4	19	0.421052631579
中	45	34	28	107	0.420560747664
直接	13	12	6	31	0.41935483871
快递	13	9	9	31	0.41935483871
不得	13	11	7	31	0.41935483871
到	62	58	28	148	0.418918918919
已经	36	27	23	86	0.418604651163
新闻	14	18	11	43	0.418604651163
电动	53	59	29	141	0.418439716312
把	46	39	25	110	0.418181818182
不是	66	65	27	158	0.417721518987
都	185	191	82	458	0.417030567686
肯定	9	10	5	24	0.416666666667
拘留	10	7	7	24	0.416666666667
内	10	6	8	24	0.416666666667
先	10	10	4	24	0.416666666667
系列	3	4	5	12	0.416666666667
米	4	5	3	12	0.416666666667
生命	5	4	3	12	0.416666666667
正月	5	4	3	12	0.416666666667
曾	3	5	4	12	0.416666666667
晚	5	2	5	12	0.416666666667
开车	5	4	3	12	0.416666666667
开展	4	3	5	12	0.416666666667
员	4	3	5	12	0.416666666667
同样	5	4	3	12	0.416666666667
厂商	5	4	3	12	0.416666666667
卡	5	4	3	12	0.416666666667
写	2	5	5	12	0.416666666667
内部	3	5	4	12	0.416666666667
入手	5	4	3	12	0.416666666667
不同	4	3	5	12	0.416666666667
三个	3	4	5	12	0.416666666667
一步	3	4	5	12	0.416666666667
一份	4	5	3	12	0.416666666667
动车	49	51	23	123	0.414634146341
多少	17	15	9	41	0.414634146341
北京	8	16	17	41	0.414634146341
大	70	51	48	169	0.414201183432
不少	6	12	11	29	0.413793103448
是	328	339	153	820	0.413414634146
中国	61	74	44	179	0.413407821229
他	31	26	18	75	0.413333333333
出	19	19	8	46	0.413043478261
看	63	48	42	153	0.411764705882
选择	13	14	7	34	0.411764705882
真正	7	7	3	17	0.411764705882
气氛	7	5	5	17	0.411764705882
成为	4	6	7	17	0.411764705882
张	7	5	5	17	0.411764705882
大学	6	7	4	17	0.411764705882
让	61	67	35	163	0.411042944785
配置	16	16	7	39	0.410256410256
请	12	18	14	44	0.409090909091
称	6	9	7	22	0.409090909091
找	9	7	6	22	0.409090909091
实际	6	9	7	22	0.409090909091
万	9	7	6	22	0.409090909091
得	38	40	20	98	0.408163265306
自	8	8	11	27	0.407407407407
美	11	8	8	27	0.407407407407
情况	10	6	11	27	0.407407407407
可能	24	21	14	59	0.406779661017
这	126	122	62	310	0.406451612903
上	76	72	39	187	0.406417112299
前	12	13	7	32	0.40625
http	8	11	13	32	0.40625
自己	54	50	29	133	0.406015037594
一	44	58	41	143	0.405594405594
习俗	15	11	11	37	0.405405405405
其实	19	18	10	47	0.404255319149
苹果	24	41	37	102	0.401960784314
你	117	109	66	292	0.400684931507
点	23	28	19	70	0.4
出来	19	20	11	50	0.4
地	17	18	10	45	0.4
天	16	10	14	40	0.4
问	9	14	12	35	0.4
连	8	10	7	25	0.4
目前	8	7	10	25	0.4
刚	10	9	6	25	0.4
三轮	8	10	7	25	0.4
路	8	7	5	20	0.4
话	8	8	4	20	0.4
治理	8	8	4	20	0.4
正在	8	6	6	20	0.4
最后	6	8	6	20	0.4
关注	6	8	6	20	0.4
空气质量	4	6	5	15	0.4
积极	6	5	4	15	0.4
相信	5	6	4	15	0.4
每个	5	6	4	15	0.4
期待	6	5	4	15	0.4
显示	4	5	6	15	0.4
才能	5	6	4	15	0.4
工人	3	6	6	15	0.4
咋	6	6	3	15	0.4
传统习俗	5	6	4	15	0.4
不住	6	4	5	15	0.4
马上	3	4	3	10	0.4
面对	2	4	4	10	0.4
进	3	3	4	10	0.4
购买	4	4	2	10	0.4
范围	4	2	4	10	0.4
约	4	3	3	10	0.4
情	4	2	4	10	0.4
往	2	4	4	10	0.4
形成	3	4	3	10	0.4
年轻	3	3	4	10	0.4
年初	3	4	3	10	0.4
尽管	4	3	3	10	0.4
声	3	4	3	10	0.4
回来	4	2	4	10	0.4
单	4	4	2	10	0.4
分钟	4	4	2	10	0.4
分	4	2	4	10	0.4
下降	2	4	4	10	0.4
d	3	4	3	10	0.4
首先	2	2	1	5	0.4
飞	1	2	2	5	0.4
预测	1	2	2	5	0.4
集团	2	1	2	5	0.4
难怪	1	2	2	5	0.4
阵线	2	2	1	5	0.4
银行	2	2	1	5	0.4
钟爱	2	2	1	5	0.4
重大	1	2	2	5	0.4
遭	1	2	2	5	0.4
违法行为	2	1	2	5	0.4
过于	2	1	2	5	0.4
迅速	1	2	2	5	0.4
路口	2	1	2	5	0.4
趋势	2	2	1	5	0.4
读	1	2	2	5	0.4
触	2	1	2	5	0.4
解释	2	2	1	5	0.4
西北	2	1	2	5	0.4
莫	2	2	1	5	0.4
英雄	1	2	2	5	0.4
致	1	2	2	5	0.4
缓解	2	2	1	5	0.4
继	2	1	2	5	0.4
级	2	2	1	5	0.4
紧急	2	1	2	5	0.4
竹	2	2	1	5	0.4
立马	2	2	1	5	0.4
空袭	2	2	1	5	0.4
禁令	2	2	1	5	0.4
真相	1	2	2	5	0.4
看见	2	2	1	5	0.4
皮	2	1	2	5	0.4
现代	2	1	2	5	0.4
独	1	2	2	5	0.4
爱好	2	1	2	5	0.4
爆炸	2	1	2	5	0.4
源头	2	1	2	5	0.4
淘汰	2	2	1	5	0.4
浓	2	2	1	5	0.4
派出	2	1	2	5	0.4
正月初	2	2	1	5	0.4
欺负	2	2	1	5	0.4
有效	1	2	2	5	0.4
月初	2	2	1	5	0.4
更新	2	2	1	5	0.4
暖	2	1	2	5	0.4
晚会	2	2	1	5	0.4
推动	2	1	2	5	0.4
按照	1	2	2	5	0.4
感	1	2	2	5	0.4
恐怕	2	2	1	5	0.4
忘	2	2	1	5	0.4
忍	2	1	2	5	0.4
德国	2	2	1	5	0.4
弥漫	1	2	2	5	0.4
开发	1	2	2	5	0.4
建立	2	2	1	5	0.4
广播	2	1	2	5	0.4
年前	2	2	1	5	0.4
市区	1	2	2	5	0.4
已有	2	2	1	5	0.4
少不了	2	1	2	5	0.4
对了	2	2	1	5	0.4
学院	2	1	2	5	0.4
姑娘	2	2	1	5	0.4
失败	2	1	2	5	0.4
大爷	2	2	1	5	0.4
多久	1	2	2	5	0.4
增添	1	2	2	5	0.4
坟场	2	1	2	5	0.4
地点	2	1	2	5	0.4
回应	1	2	2	5	0.4
喊	2	2	1	5	0.4
呐	2	1	2	5	0.4
后者	1	2	2	5	0.4
口	2	1	2	5	0.4
变得	2	1	2	5	0.4
取得	2	2	1	5	0.4
原	2	1	2	5	0.4
危机	1	2	2	5	0.4
南海	2	2	1	5	0.4
华人	2	1	2	5	0.4
具体	1	2	2	5	0.4
全城	1	2	2	5	0.4
住	2	2	1	5	0.4
低端	1	2	2	5	0.4
伤亡	1	2	2	5	0.4
他人	2	1	2	5	0.4
从小	2	2	1	5	0.4
人行道	2	2	1	5	0.4
主动	2	1	2	5	0.4
主任	2	1	2	5	0.4
专项	2	2	1	5	0.4
不着	2	1	2	5	0.4
万辆	1	2	2	5	0.4
一辆	2	1	2	5	0.4
一块	1	2	2	5	0.4
一周	2	1	2	5	0.4
一台	1	2	2	5	0.4
p	2	1	2	5	0.4
ios9	1	2	2	5	0.4
买	41	49	33	123	0.39837398374
s	48	43	30	121	0.396694214876
太	42	44	25	111	0.396396396396
该	17	15	11	43	0.395348837209
博	17	16	10	43	0.395348837209
有点	15	13	10	38	0.394736842105
cn	7	13	13	33	0.393939393939
iphone	62	49	72	183	0.393442622951
行动	24	23	14	61	0.393442622951
怀孕	11	7	10	28	0.392857142857
发现	11	8	9	28	0.392857142857
发	11	9	8	28	0.392857142857
东西	11	11	6	28	0.392857142857
将	22	26	31	79	0.392405063291
在	215	196	137	548	0.392335766423
应该	40	39	23	102	0.392156862745
通过	6	8	9	23	0.391304347826
秒	9	5	9	23	0.391304347826
被	58	61	37	156	0.391025641026
时间	25	18	21	64	0.390625
认为	15	10	16	41	0.390243902439
人们	16	15	10	41	0.390243902439
个人	14	10	12	36	0.388888888889
非常	7	4	7	18	0.388888888889
车道	7	7	4	18	0.388888888889
网	5	7	6	18	0.388888888889
最大	6	7	5	18	0.388888888889
因	5	7	6	18	0.388888888889
不该	4	7	7	18	0.388888888889
叫	12	9	10	31	0.387096774194
下	32	30	21	83	0.385542168675
其	9	7	10	26	0.384615384615
关于	10	7	9	26	0.384615384615
过来	4	5	4	13	0.384615384615
赞	5	5	3	13	0.384615384615
行驶	4	5	4	13	0.384615384615
站	4	5	4	13	0.384615384615
由于	4	4	5	13	0.384615384615
环卫工人	3	5	5	13	0.384615384615
我国	4	5	4	13	0.384615384615
弄	5	4	4	13	0.384615384615
左右	4	4	5	13	0.384615384615
只要	4	5	4	13	0.384615384615
使	4	4	5	13	0.384615384615
有	149	153	96	398	0.384422110553
时	20	23	17	60	0.383333333333
快	12	13	9	34	0.382352941176
高	21	19	15	55	0.381818181818
微	21	20	14	55	0.381818181818
热	6	7	8	21	0.380952380952
年	59	52	44	155	0.38064516129
进行	10	8	11	29	0.379310344828
与	39	35	29	103	0.378640776699
最近	14	11	12	37	0.378378378378
拍	12	11	14	37	0.378378378378
但	56	49	44	149	0.375838926174
走	12	15	13	40	0.375
换	11	12	9	32	0.375
如何	11	9	12	32	0.375
乱	9	8	7	24	0.375
之前	9	8	7	24	0.375
不了	9	7	8	24	0.375
电视	6	6	4	16	0.375
甚至	5	5	6	16	0.375
消息	5	6	5	16	0.375
来自	6	5	5	16	0.375
居然	4	6	6	16	0.375
联盟	3	2	3	8	0.375
羊	3	2	3	8	0.375
电子	3	3	2	8	0.375
没什么	3	3	2	8	0.375
毕业	3	3	2	8	0.375
比亚	3	3	2	8	0.375
查处	3	2	3	8	0.375
机型	2	3	3	8	0.375
机动车道	2	3	3	8	0.375
有关	3	3	2	8	0.375
日本	2	3	3	8	0.375
文章	3	3	2	8	0.375
库尔德	3	2	3	8	0.375
库尔	3	2	3	8	0.375
即	2	3	3	8	0.375
半夜	3	2	3	8	0.375
儿童	3	2	3	8	0.375
保持	3	2	3	8	0.375
电	23	29	26	78	0.371794871795
一样	26	26	18	70	0.371428571429
朋友	11	11	13	35	0.371428571429
se	82	70	69	221	0.371040723982
质量	8	10	9	27	0.37037037037
它	14	13	11	38	0.368421052632
环卫工	6	7	6	19	0.368421052632
是否	7	7	5	19	0.368421052632
几天	7	7	5	19	0.368421052632
主要	5	7	7	19	0.368421052632
新	19	22	19	60	0.366666666667
日	22	20	24	66	0.363636363636
早	8	7	7	22	0.363636363636
风俗	4	4	3	11	0.363636363636
远	3	4	4	11	0.363636363636
红	3	4	4	11	0.363636363636
等等	4	3	4	11	0.363636363636
的	4	3	4	11	0.363636363636
由	4	3	4	11	0.363636363636
售价	3	4	4	11	0.363636363636
受	4	3	4	11	0.363636363636
即将	4	4	3	11	0.363636363636
人行	4	4	3	11	0.363636363636
事实	4	4	3	11	0.363636363636
一方	4	4	3	11	0.363636363636
手机	45	39	40	124	0.362903225806
iphonese	25	22	22	69	0.36231884058
有人	16	17	14	47	0.36170212766
难民	4	5	5	14	0.357142857143
日报	5	4	5	14	0.357142857143
好像	4	5	5	14	0.357142857143
似乎	5	5	4	14	0.357142857143
仍	5	4	5	14	0.357142857143
NUMBER	187	187	153	527	0.354838709677
影响	16	15	17	48	0.354166666667
战机	6	5	6	17	0.352941176471
升级	7	6	7	20	0.35
存在	7	7	7	21	0.333333333333
达到	5	5	5	15	0.333333333333
十多	4	4	4	12	0.333333333333
三轮车	4	4	4	12	0.333333333333
空间	3	3	3	9	0.333333333333
永远	3	3	3	9	0.333333333333
水平	3	3	3	9	0.333333333333
无论	3	3	3	9	0.333333333333
懂	3	3	3	9	0.333333333333
广州	3	3	3	9	0.333333333333
尔德	3	3	3	9	0.333333333333
佳节	3	3	3	9	0.333333333333
距离	2	2	2	6	0.333333333333
观念	2	2	2	6	0.333333333333
行道	2	2	2	6	0.333333333333
若	2	2	2	6	0.333333333333
群	2	2	2	6	0.333333333333
现实	2	2	2	6	0.333333333333
潮流	2	2	2	6	0.333333333333
杭州	2	2	2	6	0.333333333333
新手机	2	2	2	6	0.333333333333
新手	2	2	2	6	0.333333333333
改	2	2	2	6	0.333333333333
接	2	2	2	6	0.333333333333
当今世界	2	2	2	6	0.333333333333
帝国	2	2	2	6	0.333333333333
壳	2	2	2	6	0.333333333333
咯	2	2	2	6	0.333333333333
可怕	2	2	2	6	0.333333333333
十年	2	2	2	6	0.333333333333
刚才	2	2	2	6	0.333333333333
分别	2	2	2	6	0.333333333333
今世	2	2	2	6	0.333333333333
一致	2	2	2	6	0.333333333333
一堆	2	2	2	6	0.333333333333
齐鸣	1	1	1	3	0.333333333333
骗	1	1	1	3	0.333333333333
驾照	1	1	1	3	0.333333333333
首	1	1	1	3	0.333333333333
顿	1	1	1	3	0.333333333333
雨	1	1	1	3	0.333333333333
陷入	1	1	1	3	0.333333333333
陋习	1	1	1	3	0.333333333333
阵痛	1	1	1	3	0.333333333333
锣鼓	1	1	1	3	0.333333333333
野蛮	1	1	1	3	0.333333333333
采用	1	1	1	3	0.333333333333
那边	1	1	1	3	0.333333333333
迫切	1	1	1	3	0.333333333333
这项	1	1	1	3	0.333333333333
运气	1	1	1	3	0.333333333333
躺	1	1	1	3	0.333333333333
踏	1	1	1	3	0.333333333333
路边	1	1	1	3	0.333333333333
越界	1	1	1	3	0.333333333333
越来越少	1	1	1	3	0.333333333333
越少	1	1	1	3	0.333333333333
起到	1	1	1	3	0.333333333333
负	1	1	1	3	0.333333333333
说法	1	1	1	3	0.333333333333
证实	1	1	1	3	0.333333333333
虐	1	1	1	3	0.333333333333
营业	1	1	1	3	0.333333333333
苏	1	1	1	3	0.333333333333
至极	1	1	1	3	0.333333333333
职工	1	1	1	3	0.333333333333
而来	1	1	1	3	0.333333333333
美国佬	1	1	1	3	0.333333333333
统一战线	1	1	1	3	0.333333333333
绝不	1	1	1	3	0.333333333333
红旗	1	1	1	3	0.333333333333
索尼	1	1	1	3	0.333333333333
粤	1	1	1	3	0.333333333333
第二胎	1	1	1	3	0.333333333333
移动	1	1	1	3	0.333333333333
真真是	1	1	1	3	0.333333333333
真真	1	1	1	3	0.333333333333
直	1	1	1	3	0.333333333333
环境保护	1	1	1	3	0.333333333333
犯	1	1	1	3	0.333333333333
物	1	1	1	3	0.333333333333
爷爷	1	1	1	3	0.333333333333
父亲	1	1	1	3	0.333333333333
焦虑	1	1	1	3	0.333333333333
激烈	1	1	1	3	0.333333333333
漂亮	1	1	1	3	0.333333333333
满城	1	1	1	3	0.333333333333
清	1	1	1	3	0.333333333333
海	1	1	1	3	0.333333333333
流入	1	1	1	3	0.333333333333
河北	1	1	1	3	0.333333333333
汉	1	1	1	3	0.333333333333
水果	1	1	1	3	0.333333333333
步行	1	1	1	3	0.333333333333
正规	1	1	1	3	0.333333333333
核心	1	1	1	3	0.333333333333
朝	1	1	1	3	0.333333333333
有所	1	1	1	3	0.333333333333
月经	1	1	1	3	0.333333333333
显摆	1	1	1	3	0.333333333333
时尚	1	1	1	3	0.333333333333
早晨	1	1	1	3	0.333333333333
早日	1	1	1	3	0.333333333333
早恋	1	1	1	3	0.333333333333
斗争	1	1	1	3	0.333333333333
放到	1	1	1	3	0.333333333333
改善	1	1	1	3	0.333333333333
撞死	1	1	1	3	0.333333333333
搜索	1	1	1	3	0.333333333333
掀起	1	1	1	3	0.333333333333
捍卫	1	1	1	3	0.333333333333
指定	1	1	1	3	0.333333333333
扰	1	1	1	3	0.333333333333
戴	1	1	1	3	0.333333333333
战线	1	1	1	3	0.333333333333
战火	1	1	1	3	0.333333333333
意	1	1	1	3	0.333333333333
愉快	1	1	1	3	0.333333333333
惨	1	1	1	3	0.333333333333
情绪	1	1	1	3	0.333333333333
怎么回事	1	1	1	3	0.333333333333
得不到	1	1	1	3	0.333333333333
强人	1	1	1	3	0.333333333333
开战	1	1	1	3	0.333333333333
差异	1	1	1	3	0.333333333333
屑	1	1	1	3	0.333333333333
尚未	1	1	1	3	0.333333333333
尊严	1	1	1	3	0.333333333333
寓意	1	1	1	3	0.333333333333
嫌疑	1	1	1	3	0.333333333333
妹子	1	1	1	3	0.333333333333
如同	1	1	1	3	0.333333333333
头条	1	1	1	3	0.333333333333
大雾	1	1	1	3	0.333333333333
大陆	1	1	1	3	0.333333333333
大妈	1	1	1	3	0.333333333333
大于	1	1	1	3	0.333333333333
多名	1	1	1	3	0.333333333333
外界	1	1	1	3	0.333333333333
基础	1	1	1	3	0.333333333333
回头	1	1	1	3	0.333333333333
四寸	1	1	1	3	0.333333333333
喜爱	1	1	1	3	0.333333333333
唐人	1	1	1	3	0.333333333333
吋	1	1	1	3	0.333333333333
各方	1	1	1	3	0.333333333333
可否	1	1	1	3	0.333333333333
反感	1	1	1	3	0.333333333333
反思	1	1	1	3	0.333333333333
办公室	1	1	1	3	0.333333333333
前年	1	1	1	3	0.333333333333
前天	1	1	1	3	0.333333333333
利	1	1	1	3	0.333333333333
初二	1	1	1	3	0.333333333333
刘	1	1	1	3	0.333333333333
分给	1	1	1	3	0.333333333333
几	1	1	1	3	0.333333333333
准	1	1	1	3	0.333333333333
决心	1	1	1	3	0.333333333333
军备	1	1	1	3	0.333333333333
内地	1	1	1	3	0.333333333333
兴	1	1	1	3	0.333333333333
关闭	1	1	1	3	0.333333333333
共识	1	1	1	3	0.333333333333
公室	1	1	1	3	0.333333333333
免费	1	1	1	3	0.333333333333
光明	1	1	1	3	0.333333333333
元旦	1	1	1	3	0.333333333333
做成	1	1	1	3	0.333333333333
假如	1	1	1	3	0.333333333333
保安	1	1	1	3	0.333333333333
依法	1	1	1	3	0.333333333333
佛	1	1	1	3	0.333333333333
何时	1	1	1	3	0.333333333333
众生	1	1	1	3	0.333333333333
价钱	1	1	1	3	0.333333333333
以下	1	1	1	3	0.333333333333
人情	1	1	1	3	0.333333333333
产	1	1	1	3	0.333333333333
举报	1	1	1	3	0.333333333333
为此	1	1	1	3	0.333333333333
严打	1	1	1	3	0.333333333333
两位	1	1	1	3	0.333333333333
不要脸	1	1	1	3	0.333333333333
不用说	1	1	1	3	0.333333333333
不服	1	1	1	3	0.333333333333
不曾	1	1	1	3	0.333333333333
不怕	1	1	1	3	0.333333333333
三分	1	1	1	3	0.333333333333
一身	1	1	1	3	0.333333333333
一时	1	1	1	3	0.333333333333
一帮	1	1	1	3	0.333333333333
一对	1	1	1	3	0.333333333333
一套	1	1	1	3	0.333333333333
vs	1	1	1	3	0.333333333333
nfc	1	1	1	3	0.333333333333
